cum_ret,short,long,short1,long2,lg-sh,lg2-sh2
34.08752139752700,2,5,70,225,3,155
34.06328643618260,2,5,50,275,3,225
33.714698418263200,2,5,170,200,3,30
33.692419006606100,2,5,50,225,3,175
33.639534361098000,2,5,50,350,3,300
33.636693910011300,2,5,150,225,3,75
33.49142548454470,2,5,50,375,3,325
33.0682843482605,2,5,160,200,3,40
32.98117471660690,2,5,170,175,3,5
32.88347606049330,2,5,150,200,3,50
32.84623323349290,2,5,130,225,3,95
32.82442505583940,2,5,50,400,3,350
32.79749931394830,2,5,60,325,3,265
32.74847167608700,2,5,50,250,3,200
32.7375745699257,2,5,80,250,3,170
32.639531546939500,2,5,90,250,3,160
32.55685577264490,2,5,120,225,3,105
32.47680385208800,2,5,60,225,3,165
32.44434327455920,2,5,60,350,3,290
32.38232675399980,2,5,70,200,3,130
32.34312147781850,2,5,60,300,3,240
32.25367474139630,2,5,60,375,3,315
32.219416931431500,2,5,140,225,3,85
32.2075546863963,2,5,50,425,3,375
32.11682745589540,2,5,50,300,3,250
32.08291957565040,2,5,50,175,3,125
32.01796278962560,2,5,70,250,3,180
31.969374067067300,2,5,90,225,3,135
31.748053006045800,2,5,170,225,3,55
31.55944994034250,2,5,60,250,3,190
31.54802868574430,2,5,50,200,3,150
31.48834614929540,2,5,160,225,3,65
31.431754802888700,2,5,50,325,3,275
31.391733067408600,2,5,80,225,3,145
31.36244890331900,2,5,50,500,3,450
31.30074420328030,2,5,180,225,3,45
31.3003855534016,2,5,60,275,3,215
31.273548944501800,2,5,60,200,3,140
31.224941092484700,2,5,100,225,3,125
31.177236589792700,2,5,70,275,3,205
31.063647164799200,2,5,50,475,3,425
31.062639065532700,2,5,90,300,3,210
31.017360950908600,2,5,50,450,3,400
30.99626030667290,2,5,80,275,3,195
30.942623837079800,2,5,180,200,3,20
30.91625299934350,2,5,200,500,3,300
30.828728439605700,2,5,60,425,3,365
30.693790721645400,2,5,60,175,3,115
30.568835286386400,2,5,130,250,3,120
30.524451965870400,2,5,160,175,3,15
30.419792848509200,2,5,200,475,3,275
30.363032600841500,2,5,70,375,3,305
30.351393336282100,2,5,60,400,3,340
30.321887253907300,2,5,120,250,3,130
30.3120054322842,2,5,140,250,3,110
30.27953859865540,2,5,160,325,3,165
30.25759545463790,2,5,50,150,3,100
30.250569127087600,2,5,90,275,3,185
30.22171846016690,2,5,70,350,3,280
30.202831650858200,2,5,90,350,3,260
30.119314179126900,2,5,170,325,3,155
30.0801850770308,2,5,70,300,3,230
30.057417124307000,2,5,190,475,3,285
29.977781178597500,2,5,100,250,3,150
29.950982734538700,2,5,190,500,3,310
29.928689358444900,2,5,190,200,3,10
29.926712522004500,2,5,70,325,3,255
29.905911191401100,2,5,50,100,3,50
29.753003137515600,2,5,80,350,3,270
29.72502156675910,2,5,110,175,3,65
29.70235943677260,2,5,140,275,3,135
29.6712923467544,2,5,170,350,3,180
29.634644274836200,2,5,160,300,3,140
29.627411157393600,2,5,110,225,3,115
29.618670355735600,2,5,100,300,3,200
29.60731267796650,2,5,120,450,3,330
29.59325800662810,2,5,180,500,3,320
29.55819118068380,2,5,170,400,3,230
29.544933855270500,2,5,100,450,3,350
29.515532790946600,2,5,70,175,3,105
29.488612235647200,2,5,160,350,3,190
29.44371907475090,2,5,90,400,3,310
29.43057835643900,2,5,200,300,3,100
29.413334240477600,2,5,110,250,3,140
29.409095440968300,2,5,140,200,3,60
29.405730815685800,2,5,170,300,3,130
29.390572141673600,2,5,90,500,3,410
29.381497909802100,2,5,170,250,3,80
29.36077562772290,2,5,70,500,3,430
29.304456125846100,2,5,100,500,3,400
29.253614647955900,2,5,90,475,3,385
29.228873830502600,2,5,100,275,3,175
29.1530547501377,2,5,60,150,3,90
29.147484997178600,2,5,80,300,3,220
29.089234388664400,2,5,100,325,3,225
29.012047524524800,2,5,160,500,3,340
28.990832498997000,2,5,100,475,3,375
28.989093711851800,2,5,80,375,3,295
28.98248567317470,2,5,200,450,3,250
28.95980199353480,2,5,160,425,3,265
28.946076879082600,2,5,150,350,3,200
28.94180796296950,2,5,110,200,3,90
28.937363701582400,2,5,190,225,3,35
28.853639781137500,2,5,120,275,3,155
28.80545054327980,2,5,80,200,3,120
28.80406159141060,2,5,70,475,3,405
28.79471178753960,2,5,90,325,3,235
28.775303656135400,2,5,90,450,3,360
28.773469929776200,2,5,90,375,3,285
28.765744408993400,2,5,160,400,3,240
28.758344947605500,2,5,50,125,3,75
28.752376980446600,2,5,70,450,3,380
28.744912322820800,2,5,170,375,3,205
28.74451539896670,2,5,130,200,3,70
28.739376336383300,2,5,130,400,3,270
28.721006375593300,2,5,120,150,3,30
28.699540312230800,2,5,180,325,3,145
28.605399133127700,2,5,130,150,3,20
28.595169534038800,2,5,60,500,3,440
28.58872193055920,2,5,170,500,3,330
28.546386011876300,2,5,70,425,3,355
28.541182143584900,2,5,200,325,3,125
28.537836029572200,2,5,200,225,3,25
28.529858707384000,2,5,150,325,3,175
28.52810000622160,2,5,110,275,3,165
28.48487587174060,2,5,170,475,3,305
28.48186759639410,2,5,160,275,3,115
28.47334184631070,2,5,60,475,3,415
28.46137563381960,2,5,190,450,3,260
28.456160432223600,2,5,190,325,3,135
28.45386326181970,2,5,100,425,3,325
28.437948816260000,2,5,120,200,3,80
28.41869805172640,2,5,80,450,3,370
28.410150457975800,2,5,120,500,3,380
28.408998272679400,2,5,150,250,3,100
28.408938782194200,2,5,180,475,3,295
28.40563618417290,2,5,180,300,3,120
28.331818062112800,2,5,160,250,3,90
28.308683353964300,2,5,120,475,3,355
28.28407328190580,2,5,80,325,3,245
28.277465120214700,2,5,70,400,3,330
28.254576972120200,2,5,120,425,3,305
28.240594829267100,2,5,110,500,3,390
28.224757834678300,2,5,150,500,3,350
28.215006408732600,2,5,110,450,3,340
28.177753272358700,2,5,170,425,3,255
28.14488982125640,2,5,80,500,3,420
28.088679891810000,2,5,100,400,3,300
28.071687844168000,2,5,120,400,3,280
28.065543410347600,2,5,150,400,3,250
28.052086342876300,2,5,130,450,3,320
28.01500310863860,2,5,140,300,3,160
28.012915810146500,2,5,100,150,3,50
27.995886884589900,2,5,130,375,3,245
27.95103968297140,2,5,140,400,3,260
27.933920877352100,2,5,110,475,3,365
27.925458970203300,2,5,100,200,3,100
27.9222461840928,2,5,180,425,3,245
27.91459118871190,2,5,150,300,3,150
27.910152260563700,2,5,110,300,3,190
27.88416373945390,2,5,150,275,3,125
27.86990926383220,2,5,60,450,3,390
27.735730108752100,2,5,200,400,3,200
27.731180999063300,2,5,130,500,3,370
27.720127368749200,2,5,140,500,3,360
27.699277436470100,2,5,80,175,3,95
27.68908361465090,2,5,80,400,3,320
27.67174029404850,2,5,180,350,3,170
27.6713956965514,2,5,180,400,3,220
27.62704237318140,2,5,190,350,3,160
27.626129120693200,2,5,80,425,3,345
27.62555287204100,2,5,190,425,3,235
27.60555641103710,2,5,130,275,3,145
27.60468128575920,2,5,160,475,3,315
27.583589808251400,2,5,100,350,3,250
27.564082971212400,2,5,130,425,3,295
27.56261833971920,2,5,110,325,3,215
27.55888526977950,2,5,130,475,3,345
27.547007958312900,2,5,100,375,3,275
27.511030667241100,2,5,140,175,3,35
27.49569792156150,2,5,180,250,3,70
27.484413208812400,2,5,70,150,3,80
27.4810625335819,2,5,190,300,3,110
27.473957377082600,2,5,160,375,3,215
27.454419609240100,2,5,170,450,3,280
27.444337997808700,2,5,180,450,3,270
27.439066128164400,2,5,110,150,3,40
27.423555454506600,2,5,140,425,3,285
27.415674102064100,2,5,90,425,3,335
27.407299531947900,2,5,80,475,3,395
27.40246851159300,2,5,90,175,3,85
27.377820428428100,2,5,130,350,3,220
27.37571425574770,2,5,150,450,3,300
27.3573784983164,2,5,140,350,3,210
27.34657602522110,2,5,180,375,3,195
27.34261245918240,2,5,200,425,3,225
27.333236204210100,2,5,200,350,3,150
27.327721601554800,2,5,140,450,3,310
27.312355695650300,2,5,110,425,3,315
27.255163282990900,2,5,150,425,3,275
27.25180863137270,2,5,110,350,3,240
27.240394671476400,2,5,150,175,3,25
27.239916550684800,2,5,140,375,3,235
27.239025829716400,2,5,90,200,3,110
27.207369846799000,2,5,90,100,3,10
27.197749702605700,2,5,120,350,3,230
27.176910575050200,2,5,110,400,3,290
27.13505439676400,2,5,150,475,3,325
26.917807996881,2,5,190,400,3,210
26.882939103096300,2,5,60,100,3,40
26.863576983886000,2,5,100,175,3,75
26.843113596091100,2,5,120,175,3,55
26.830031266997900,2,5,130,300,3,170
26.65954780972900,2,5,110,375,3,265
26.577077011331600,2,5,170,275,3,105
26.57271682269960,2,5,140,475,3,335
26.56979847488230,2,5,180,275,3,95
26.562008273443200,2,5,200,275,3,75
26.51209526516190,2,5,160,450,3,290
26.48469309579680,2,5,190,375,3,185
26.429705481881800,2,5,120,300,3,180
26.39705445635570,2,5,120,375,3,255
26.38723194836190,2,5,200,375,3,175
26.201668944999100,2,5,130,325,3,195
26.14427977469460,2,5,120,325,3,205
25.96018595216800,2,5,150,375,3,225
25.92741139784520,2,5,140,325,3,185
25.880313460503900,2,5,90,150,3,60
25.83879530480840,2,5,190,250,3,60
25.740390042446500,2,5,80,150,3,70
25.612293834870900,2,5,110,125,3,15
25.472958541289800,2,5,60,125,3,65
25.443028420182100,2,5,190,275,3,85
25.40815590830160,2,5,90,125,3,35
25.394534253562400,2,5,70,125,3,55
25.364456073402100,2,5,140,150,3,10
25.30814811916310,2,5,70,100,3,30
25.030254091343700,2,5,130,175,3,45
24.80260411172560,2,5,200,250,3,50
24.42123563019070,2,5,100,125,3,25
23.973334292257100,2,5,80,125,3,45
23.7423925674985,2,5,120,125,3,5
23.17630047835070,2,5,80,100,3,20
5.41854711755855,2,10,70,225,8,155
5.381650528083370,2,10,50,275,8,225
5.304979946849520,2,10,50,350,8,300
5.296128324186500,2,10,150,225,8,75
5.276431108448670,2,10,50,225,8,175
5.2664806874696400,2,10,50,375,8,325
5.149486269518080,2,10,170,200,8,30
5.074277400387000,2,10,60,325,8,265
5.0696949743608900,2,10,130,225,8,95
5.058471753961610,2,10,50,400,8,350
5.058178559589010,2,10,80,250,8,170
5.039885065712320,2,10,90,250,8,160
5.037451325200530,2,10,160,200,8,40
5.021394854896790,2,10,150,200,8,50
4.99582302117841,2,10,120,225,8,105
4.989593705124940,2,10,50,250,8,200
4.956553294821120,2,10,60,350,8,290
4.8960442624540700,2,10,50,425,8,375
4.890346814893460,2,10,60,225,8,165
4.8859786000145800,2,10,60,375,8,315
4.885710270771490,2,10,60,300,8,240
4.877098902436520,2,10,70,200,8,130
4.834310727134430,2,10,140,225,8,85
4.801249767048160,2,10,50,300,8,250
4.799866083479960,2,10,90,225,8,135
4.784237618409370,2,10,70,250,8,180
4.7288633511968600,2,10,50,175,8,125
4.677143784742400,2,10,170,225,8,55
4.65358083480459,2,10,50,200,8,150
4.64779415760621,2,10,50,500,8,450
4.637530891720640,2,10,60,250,8,190
4.63361799788869,2,10,80,225,8,145
4.6086779343336300,2,10,160,225,8,65
4.596173787694600,2,10,50,325,8,275
4.579556087466650,2,10,200,500,8,300
4.568297313678600,2,10,100,225,8,125
4.559873401024150,2,10,70,275,8,205
4.559399626394820,2,10,60,275,8,215
4.5278370184345300,2,10,50,475,8,425
4.526687789302520,2,10,50,450,8,400
4.522305625505320,2,10,180,225,8,45
4.5211255143262000,2,10,90,300,8,210
4.511992512922400,2,10,80,275,8,195
4.492134396904170,2,10,60,200,8,140
4.485973818345120,2,10,60,425,8,365
4.438384312096600,2,10,170,175,8,5
4.409926846970490,2,10,200,475,8,275
4.396706480667340,2,10,130,250,8,120
4.339008631992120,2,10,70,375,8,305
4.324999353761120,2,10,140,250,8,110
4.319700038345650,2,10,60,400,8,340
4.310438093516140,2,10,160,325,8,165
4.306746527137110,2,10,60,175,8,115
4.304810832956950,2,10,90,350,8,260
4.296030217891540,2,10,120,250,8,130
4.287965534209100,2,10,70,350,8,280
4.287150648525420,2,10,190,475,8,285
4.282776612870150,2,10,170,325,8,155
4.2761565424674300,2,10,190,500,8,310
4.265531517578240,2,10,90,275,8,185
4.2301331223470900,2,10,180,200,8,20
4.229634049982680,2,10,100,250,8,150
4.226463578016090,2,10,70,300,8,230
4.187249747840240,2,10,70,325,8,255
4.1713017740518200,2,10,170,350,8,180
4.152331703208700,2,10,180,500,8,320
4.150617454020350,2,10,140,275,8,135
4.1497989898208600,2,10,80,350,8,270
4.148976999286980,2,10,50,150,8,100
4.147889617467460,2,10,120,450,8,330
4.139393962338020,2,10,170,400,8,230
4.124210658251670,2,10,160,300,8,140
4.109233755868120,2,10,100,450,8,350
4.102453760091640,2,10,160,350,8,190
4.092967333771750,2,10,90,500,8,410
4.0846324324796700,2,10,110,225,8,115
4.077867986898840,2,10,100,500,8,400
4.077828618403450,2,10,110,175,8,65
4.063522102101820,2,10,100,300,8,200
4.061423408934090,2,10,200,300,8,100
4.061393330200930,2,10,170,300,8,130
4.0579334804463,2,10,90,400,8,310
4.055779677242060,2,10,110,250,8,140
4.049934009006930,2,10,90,475,8,385
4.049328662128530,2,10,70,500,8,430
4.008685463135770,2,10,160,175,8,15
4.006056458720700,2,10,100,275,8,175
4.006049431386510,2,10,170,250,8,80
3.985648853601820,2,10,160,500,8,340
3.973299735242740,2,10,100,475,8,375
3.971918721692460,2,10,70,175,8,105
3.962770797805150,2,10,200,450,8,250
3.961562922177200,2,10,140,200,8,60
3.94139209678063,2,10,160,425,8,265
3.935333161194940,2,10,80,375,8,295
3.931923766521600,2,10,80,300,8,220
3.9233474540721500,2,10,100,325,8,225
3.9124692304391100,2,10,150,350,8,200
3.903216818807170,2,10,90,450,8,360
3.8981657312564300,2,10,90,325,8,235
3.895125622884040,2,10,70,475,8,405
3.894971814779200,2,10,160,400,8,240
3.8782612060224300,2,10,170,375,8,205
3.8677229725072600,2,10,130,400,8,270
3.858612013966050,2,10,50,100,8,50
3.855760217993460,2,10,180,325,8,145
3.851510268546440,2,10,120,275,8,155
3.8497231325510600,2,10,170,500,8,330
3.8492722141188600,2,10,90,375,8,285
3.8427693366349800,2,10,70,450,8,380
3.834925784724880,2,10,110,200,8,90
3.829296317583560,2,10,60,500,8,440
3.825145941593140,2,10,60,150,8,90
3.812066297772390,2,10,190,200,8,10
3.8102640695447500,2,10,80,200,8,120
3.8099029707734500,2,10,70,425,8,355
3.8017081752099600,2,10,110,275,8,165
3.800960250782700,2,10,170,475,8,305
3.7985123799410700,2,10,190,450,8,260
3.7960933832802000,2,10,180,475,8,295
3.792883909044400,2,10,150,325,8,175
3.785511881313560,2,10,120,500,8,380
3.7846147434417900,2,10,200,325,8,125
3.7805173920671000,2,10,130,200,8,70
3.7798830542366300,2,10,100,425,8,325
3.7761055166731400,2,10,60,475,8,415
3.767259014495390,2,10,190,325,8,135
3.7615533893989600,2,10,80,450,8,370
3.7612490074322500,2,10,150,500,8,350
3.760589914358960,2,10,180,300,8,120
3.754643694222500,2,10,160,275,8,115
3.7543482328107800,2,10,190,225,8,35
3.7438824397805500,2,10,110,500,8,390
3.74100746311883,2,10,120,475,8,355
3.740937010635490,2,10,120,425,8,305
3.732484570310260,2,10,150,250,8,100
3.7179784146687300,2,10,160,250,8,90
3.715572501021540,2,10,170,425,8,255
3.714647977580610,2,10,110,450,8,340
3.7082282894532600,2,10,120,200,8,80
3.7009863007577100,2,10,70,400,8,330
3.6995492538484500,2,10,80,325,8,245
3.690424344953550,2,10,80,500,8,420
3.68361524173271,2,10,100,400,8,300
3.681022643335020,2,10,130,450,8,320
3.6726734321932500,2,10,150,400,8,250
3.666597244841410,2,10,120,400,8,280
3.6442336919125700,2,10,110,475,8,365
3.6423044982564000,2,10,130,375,8,245
3.6391856141790400,2,10,180,425,8,245
3.623866420940520,2,10,140,400,8,260
3.6173215530736800,2,10,50,125,8,75
3.61464132378892,2,10,140,300,8,160
3.5995116610185200,2,10,60,450,8,390
3.5955675967143100,2,10,150,300,8,150
3.5942233756768900,2,10,130,500,8,370
3.5867152222788000,2,10,150,275,8,125
3.586164744423860,2,10,110,300,8,190
3.585292314536970,2,10,120,150,8,30
3.582132702085860,2,10,140,500,8,360
3.5806829069017800,2,10,200,400,8,200
3.56026922125813,2,10,200,225,8,25
3.5569243177009300,2,10,190,350,8,160
3.5540612243356700,2,10,180,400,8,220
3.548654675152890,2,10,100,200,8,100
3.545056480543290,2,10,160,475,8,315
3.545045258332910,2,10,180,350,8,170
3.539727861354360,2,10,80,400,8,320
3.5365320425514900,2,10,80,425,8,345
3.5258233650035800,2,10,130,475,8,345
3.52239517863757,2,10,190,425,8,235
3.509427864147690,2,10,130,425,8,295
3.503936684710040,2,10,180,450,8,270
3.5031647132578800,2,10,100,350,8,250
3.502920386921780,2,10,80,475,8,395
3.501394974968150,2,10,130,275,8,145
3.499638802836860,2,10,100,375,8,275
3.4950163462959900,2,10,170,450,8,280
3.4809905237726300,2,10,90,425,8,335
3.475936296894580,2,10,160,375,8,215
3.475654780602110,2,10,140,425,8,285
3.469304570909460,2,10,110,325,8,215
3.4690920655059100,2,10,140,450,8,310
3.4673529203869200,2,10,80,175,8,95
3.4637675009750600,2,10,150,450,8,300
3.460091718845980,2,10,180,375,8,195
3.4596913050148600,2,10,130,150,8,20
3.4586800209213100,2,10,190,300,8,110
3.4451838849521800,2,10,200,425,8,225
3.443687786931990,2,10,140,350,8,210
3.440851423872940,2,10,110,425,8,315
3.4406054875514300,2,10,100,150,8,50
3.434938194018950,2,10,200,350,8,150
3.4345810896576300,2,10,130,350,8,220
3.422019960262090,2,10,150,425,8,275
3.4136516701589700,2,10,180,250,8,70
3.403645289009330,2,10,140,375,8,235
3.3994089006448200,2,10,120,350,8,230
3.396317818353000,2,10,110,400,8,290
3.394016235553260,2,10,110,350,8,240
3.3939822954794200,2,10,150,475,8,325
3.361203521149140,2,10,90,200,8,110
3.3471935860692800,2,10,190,400,8,210
3.33985396437434,2,10,90,175,8,85
3.306213991502600,2,10,140,175,8,35
3.270483164970630,2,10,70,150,8,80
3.2563491652129600,2,10,130,300,8,170
3.2419873299931500,2,10,110,150,8,40
3.2214007191049200,2,10,140,475,8,335
3.216868027059200,2,10,190,375,8,185
3.211352124963830,2,10,110,375,8,265
3.1927145079289900,2,10,160,450,8,290
3.1781329720071500,2,10,200,375,8,175
3.1752993785678900,2,10,170,275,8,105
3.1749341587381800,2,10,200,275,8,75
3.1678137348058300,2,10,100,175,8,75
3.1620097119179400,2,10,120,375,8,255
3.161539735656310,2,10,180,275,8,95
3.1401798269126300,2,10,150,175,8,25
3.131978758208640,2,10,120,175,8,55
3.1252268683457700,2,10,120,300,8,180
3.05648893332973,2,10,130,325,8,195
3.044550125019330,2,10,120,325,8,205
3.0393057940676400,2,10,150,375,8,225
3.0048569350741100,2,10,140,325,8,185
2.9216579864863100,2,10,60,100,8,40
2.896550829009590,2,10,190,250,8,60
2.827219376463970,2,10,190,275,8,85
2.7876314009645500,2,10,90,100,8,10
2.7853830194458100,2,10,80,150,8,70
2.7741120695228600,2,10,90,150,8,60
2.6262629106529000,2,10,60,125,8,65
2.600538051974680,2,10,70,125,8,55
2.5562968641488900,2,10,130,175,8,45
2.5463638362054600,2,10,90,125,8,35
2.538828253824760,2,10,200,250,8,50
2.4389831864317200,2,10,70,100,8,30
2.4011685574919200,2,10,110,125,8,15
2.303399194289550,2,10,140,150,8,10
2.199367236472310,2,10,100,125,8,25
2.1310855194538600,2,10,80,125,8,45
1.7683359619368600,2,10,80,100,8,20
1.494257499309700,2,10,120,125,8,5
-1.6506316353136400,76,85,200,500,9,300
-1.6627020020673000,96,105,200,500,9,300
-1.6752752407371300,96,105,190,500,9,310
-1.6800846133339600,96,105,180,500,9,320
-1.6805905673450800,96,105,200,475,9,275
-1.687374753155610,96,105,190,475,9,285
-1.6876221452212700,76,85,190,500,9,310
-1.6894631457393800,76,85,200,475,9,275
-1.6933758847931200,76,85,190,475,9,285
-1.693390638665970,86,95,200,500,9,300
-1.6967780164825600,96,105,160,500,9,340
-1.6969054308815700,96,105,120,450,9,330
-1.697979990099820,86,95,190,475,9,285
-1.6991934962111400,96,105,90,500,9,410
-1.7019689090248600,76,85,120,450,9,330
-1.7034313609294100,96,105,200,450,9,250
-1.7034743491091600,76,85,180,500,9,320
-1.704170577674740,96,105,100,500,9,400
-1.7052094664664800,86,95,200,475,9,275
-1.7065833908688900,96,105,170,500,9,330
-1.7097575814774300,96,105,180,475,9,295
-1.7097759435879300,76,85,160,500,9,340
-1.70993438527203,86,95,190,500,9,310
-1.7114553904945300,96,105,150,500,9,350
-1.712636375137870,96,105,120,500,9,380
-1.712663272263450,76,85,90,500,9,410
-1.7127523464286400,96,105,170,350,9,180
-1.713844850706610,76,85,100,500,9,400
-1.7149594648532000,76,85,170,500,9,330
-1.7151646319702600,96,105,90,475,9,385
-1.7156311420216100,96,105,160,425,9,265
-1.7168949169898400,96,105,190,450,9,260
-1.7186838210533400,96,105,170,475,9,305
-1.7186925173124300,86,95,180,500,9,320
-1.7188581208149900,96,105,140,500,9,360
-1.7206065190147800,76,85,200,450,9,250
-1.7208303074241500,76,85,150,500,9,350
-1.7221317672671300,96,105,170,400,9,230
-1.7226256194606900,96,105,160,475,9,315
-1.7226823366984500,96,105,50,375,9,325
-1.7230054403552900,76,85,90,475,9,385
-1.723103002233310,96,105,130,500,9,370
-1.7235681509295100,96,105,100,450,9,350
-1.7237101743349600,76,85,190,450,9,260
-1.725360704661420,76,85,170,400,9,230
-1.725728487197150,76,85,170,350,9,180
-1.7257621187029700,96,105,100,475,9,375
-1.7260477671287200,76,85,50,375,9,325
-1.7274665568043500,96,105,70,500,9,430
-1.727622611332340,96,105,110,500,9,390
-1.7276900146567500,96,105,170,375,9,205
-1.7277490175468900,76,85,140,500,9,360
-1.72846129477032,96,105,130,475,9,345
-1.729299203906270,86,95,160,500,9,340
-1.7302659264353900,96,105,50,425,9,375
-1.7307364192922900,76,85,180,475,9,295
-1.7319022013923600,96,105,160,350,9,190
-1.7319801003091400,76,85,130,500,9,370
-1.7320041592640700,96,105,170,425,9,255
-1.7324357726285300,96,105,120,475,9,355
-1.7327394797937400,96,105,100,425,9,325
-1.733143518739620,86,95,170,500,9,330
-1.7332264104325700,86,95,120,450,9,330
-1.7332690504271300,96,105,160,400,9,240
-1.7333715286446400,76,85,120,500,9,380
-1.733455020906370,76,85,170,475,9,305
-1.7336432245698000,96,105,180,450,9,270
-1.7344753281981500,76,85,100,450,9,350
-1.7348031472921000,76,85,110,500,9,390
-1.735007323576970,96,105,130,450,9,320
-1.7353012681073000,86,95,90,500,9,410
-1.735405047789850,76,85,50,425,9,375
-1.7359886516554000,96,105,50,500,9,450
-1.7363138640331500,86,95,100,500,9,400
-1.737951672224240,86,95,200,450,9,250
-1.7380052015466600,96,105,60,425,9,365
-1.7380658479924700,96,105,170,325,9,155
-1.7383779433627900,76,85,100,475,9,375
-1.7384080734296700,76,85,50,350,9,300
-1.738756202577520,76,85,160,425,9,265
-1.7392144095381200,86,95,170,350,9,180
-1.7394334792359400,96,105,150,475,9,325
-1.739472867498650,76,85,50,500,9,450
-1.740232751621440,96,105,130,400,9,270
-1.7409548592234800,76,85,160,400,9,240
-1.7419249437938000,92,100,200,500,8,300
-1.7425610167886300,96,105,180,425,9,245
-1.7431599031944800,96,105,110,475,9,365
-1.7432632243688300,96,105,50,400,9,350
-1.743509037428170,96,105,170,450,9,280
-1.7435385900147800,76,85,170,425,9,255
-1.7436850227818000,96,105,50,475,9,425
-1.7439313864272200,96,105,90,250,9,160
-1.744324807580290,86,95,180,475,9,295
-1.7444937614289200,96,105,150,400,9,250
-1.7450953230119700,76,85,60,425,9,365
-1.7457016960292400,96,105,50,350,9,300
-1.745748407440320,96,105,60,375,9,315
-1.7459473237579900,76,85,160,475,9,315
-1.7464355790511300,96,105,50,450,9,400
-1.7465098130032100,76,85,50,400,9,350
-1.7465533023052100,96,105,80,250,9,170
-1.7468946401530100,96,105,150,450,9,300
-1.7469529570765800,96,105,200,400,9,200
-1.747139395269480,76,85,70,500,9,430
-1.7472902172440200,86,95,90,475,9,385
-1.7476030262181000,76,85,160,350,9,190
-1.7476786672012300,76,85,70,225,9,155
-1.7478708494381200,76,85,130,475,9,345
-1.7479259064332800,86,95,150,500,9,350
-1.7479772132456000,96,105,90,450,9,360
-1.7480496853028800,96,105,200,425,9,225
-1.7481973101158800,96,105,70,225,9,155
-1.7486057581103500,96,105,60,350,9,290
-1.7487586479680500,76,85,130,450,9,320
-1.748846756860620,96,105,140,400,9,260
-1.7489352256275500,96,105,60,400,9,340
-1.7490140532121700,76,85,90,250,9,160
-1.749023876791170,76,85,50,450,9,400
-1.7492272097439400,76,85,100,425,9,325
-1.7493928452365600,96,105,60,325,9,265
-1.7494896565945200,76,85,170,375,9,205
-1.7496815392422900,96,105,70,475,9,405
-1.7499223455858700,76,85,170,325,9,155
-1.7502560266952700,76,85,150,400,9,250
-1.7506618154112500,96,105,120,400,9,280
-1.7510006241574800,96,105,70,375,9,305
-1.7510211616791700,96,105,80,475,9,395
-1.7511947263603300,86,95,50,375,9,325
-1.75123746273916,76,85,110,475,9,365
-1.7512514820576700,86,95,170,475,9,305
-1.7514203643783800,96,105,120,425,9,305
-1.7516848976648300,76,85,80,250,9,170
-1.7517397345210900,96,105,150,350,9,200
-1.7518408150040800,96,105,90,400,9,310
-1.7524698739599800,96,105,160,325,9,165
-1.75268859169804,86,95,50,425,9,375
-1.752850993380940,96,105,130,225,9,95
-1.7530003341963500,86,95,120,500,9,380
-1.7534429280335300,76,85,120,475,9,355
-1.7534850806800200,76,85,200,400,9,200
-1.7538104055886700,96,105,180,375,9,195
-1.7538599450878200,96,105,130,425,9,295
-1.7540562029114100,96,105,140,450,9,310
-1.754058334624870,96,105,110,450,9,340
-1.7544521759136000,96,105,70,450,9,380
-1.754498696454000,96,105,70,425,9,355
-1.755130080055250,96,105,180,400,9,220
-1.7553010396840500,86,95,140,500,9,360
-1.755484161902370,96,105,130,375,9,245
-1.7556064918322700,96,105,190,400,9,210
-1.7556847371210600,86,95,100,450,9,350
-1.7557747581796700,76,85,130,400,9,270
-1.7561434366553300,76,85,50,475,9,425
-1.7565730388560600,96,105,190,425,9,235
-1.7568834868389500,76,85,180,425,9,245
-1.7570348811477200,76,85,90,400,9,310
-1.7575026666443000,86,95,130,500,9,370
-1.7576685773392300,76,85,160,325,9,165
-1.7576885107886300,76,85,60,400,9,340
-1.7580805883259000,92,100,200,475,8,275
-1.7580997073097900,86,95,160,425,9,265
-1.758156211815680,86,95,170,375,9,205
-1.7582642398286900,76,85,130,225,9,95
-1.7584991806362400,76,85,60,375,9,315
-1.7585926694963200,76,85,190,350,9,160
-1.758620498424980,86,95,170,400,9,230
-1.7589513503403000,96,105,120,225,9,105
-1.759206063855310,76,85,120,225,9,105
-1.7594461535783400,86,95,190,450,9,260
-1.7595045919879800,76,85,180,450,9,270
-1.7598340998219800,76,85,200,425,9,225
-1.7598806255268300,86,95,100,475,9,375
-1.7599512806481100,96,105,160,300,9,140
-1.7599639503708900,86,95,110,500,9,390
-1.760258358872900,76,85,120,400,9,280
-1.7603333065437300,96,105,140,425,9,285
-1.7608146388344900,86,95,130,475,9,345
-1.7608729667223100,76,85,160,300,9,140
-1.760904201290740,96,105,200,300,9,100
-1.7609108717907700,76,85,60,350,9,290
-1.7610899371215000,92,100,190,500,8,310
-1.7612599359618500,76,85,90,450,9,360
-1.7612859180403700,76,85,170,450,9,280
-1.7614250320734800,96,105,150,325,9,175
-1.7618361822805700,76,85,180,375,9,195
-1.7619689766770700,96,105,190,350,9,160
-1.761978279577630,96,105,180,350,9,170
-1.7620056657524200,96,105,140,475,9,335
-1.7620537652680700,76,85,140,450,9,310
-1.7623381440657100,96,105,80,375,9,295
-1.7624213374687200,76,85,60,325,9,265
-1.7625082000829100,76,85,140,250,9,110
-1.762649697741240,96,105,80,450,9,370
-1.7628421554804600,76,85,150,450,9,300
-1.7629264437443400,96,105,160,375,9,215
-1.7631354004185100,86,95,160,475,9,315
-1.7632715057699800,96,105,80,500,9,420
-1.763276204687760,76,85,110,450,9,340
-1.7636023464063200,96,105,190,375,9,185
-1.7637076377146600,96,105,150,425,9,275
-1.7645483508081900,76,85,120,425,9,305
-1.7647092983974300,96,105,110,425,9,315
-1.7653214288230600,86,95,130,450,9,320
-1.765469928462380,86,95,110,475,9,365
-1.7655618951455500,76,85,70,375,9,305
-1.7657930778934900,76,85,190,425,9,235
-1.7658170595291300,76,85,200,300,9,100
-1.76652038386332,86,95,160,350,9,190
-1.7669754543180500,76,85,70,475,9,405
-1.767149810579070,96,105,130,250,9,120
-1.7676899354868600,86,95,70,500,9,430
-1.7680525431984700,76,85,150,425,9,275
-1.768205362595100,86,95,50,350,9,300
-1.7686785489300300,86,95,50,450,9,400
-1.7687859611011100,86,95,120,475,9,355
-1.7690832978276900,76,85,130,425,9,295
-1.7691169725263700,96,105,90,350,9,260
-1.7691333868825900,86,95,140,400,9,260
-1.769465072684580,96,105,140,275,9,135
-1.7695391082411900,96,105,140,375,9,235
-1.7695683137357700,96,105,60,300,9,240
-1.7700618653920900,76,85,180,400,9,220
-1.7701231174857400,96,105,100,400,9,300
-1.770128199277220,76,85,150,475,9,325
-1.7704718927096300,96,105,170,300,9,130
-1.7709087321958200,86,95,100,425,9,325
-1.7710465605128000,96,105,90,425,9,335
-1.7716125201570100,86,95,50,400,9,350
-1.771613840189210,96,105,200,350,9,150
-1.7718741440880400,96,105,90,375,9,285
-1.771889803001790,76,85,90,350,9,260
-1.7720593239466800,76,85,70,450,9,380
-1.7724745319313000,86,95,170,425,9,255
-1.7725581921831800,76,85,90,425,9,335
-1.7726542995911400,76,85,80,475,9,395
-1.7726802452936100,76,85,110,425,9,315
-1.7730928358962100,92,100,190,475,8,285
-1.773141140030830,96,105,160,450,9,290
-1.7732057784862000,96,105,60,500,9,440
-1.773705130045400,86,95,160,400,9,240
-1.7739288190698200,86,95,50,475,9,425
-1.7740900514253000,86,95,90,450,9,360
-1.7741369530663000,76,85,90,225,9,135
-1.774220943857120,86,95,50,500,9,450
-1.7746426201576400,86,95,70,225,9,155
-1.7747908284824400,86,95,170,325,9,155
-1.7747991755525700,96,105,100,225,9,125
-1.774882250833200,76,85,140,400,9,260
-1.7750421914955500,86,95,180,425,9,245
-1.7751141885934500,96,105,200,375,9,175
-1.7752424761641000,76,85,130,375,9,245
-1.7753076534499200,96,105,80,425,9,345
-1.7755607797673600,96,105,60,475,9,415
-1.7757188085929600,96,105,180,325,9,145
-1.7759674988724900,76,85,150,325,9,175
-1.7760132319878300,76,85,140,425,9,285
-1.776159115430140,86,95,180,450,9,270
-1.776172764863270,96,105,190,325,9,135
-1.7764921908463200,86,95,130,400,9,270
-1.7775785006286200,86,95,120,225,9,105
-1.7777644029282500,96,105,80,225,9,145
-1.7781560498172700,76,85,170,300,9,130
-1.7781581015019500,96,105,80,350,9,270
-1.778174504465460,86,95,60,425,9,365
-1.778357469345240,76,85,140,475,9,335
-1.7784504409111500,76,85,80,500,9,420
-1.7786525745471800,76,85,180,350,9,170
-1.7787751608184900,96,105,120,350,9,230
-1.7788468552172400,86,95,150,400,9,250
-1.7788730790466600,96,105,80,275,9,195
-1.7789953471203700,86,95,200,400,9,200
-1.7792092751284300,76,85,80,450,9,370
-1.7793126060390400,76,85,130,250,9,120
-1.7795274402535300,76,85,100,400,9,300
-1.7795814467768600,96,105,140,250,9,110
-1.7796742695282100,56,65,200,500,9,300
-1.779677574107950,96,105,50,275,9,225
-1.7796784248083300,76,85,140,375,9,235
-1.7798302463829100,76,85,160,450,9,290
-1.7801280525467300,76,85,150,225,9,75
-1.7806048883818800,76,85,190,400,9,210
-1.7807404569652600,76,85,150,350,9,200
-1.7809152809726800,96,105,90,225,9,135
-1.7810977085550100,96,105,90,300,9,210
-1.7811080350138100,96,105,100,250,9,150
-1.7811600445089100,76,85,60,500,9,440
-1.7814056234281700,96,105,140,350,9,210
-1.781490749295460,76,85,50,275,9,225
-1.7818222186917600,86,95,70,475,9,405
-1.782008140032800,86,95,90,400,9,310
-1.782109802889310,92,100,180,500,8,320
-1.7821915346437100,86,95,200,425,9,225
-1.7824526633081300,76,85,100,225,9,125
-1.7824836213121900,76,85,190,325,9,135
-1.7826071671802600,76,85,200,350,9,150
-1.7827769636757400,86,95,80,250,9,170
-1.7829007673567600,86,95,120,400,9,280
-1.783054557484710,76,85,80,375,9,295
-1.7831138538360800,86,95,160,325,9,165
-1.7832802035947700,86,95,80,475,9,395
-1.7833618755385100,86,95,150,450,9,300
-1.7836087835814800,96,105,180,300,9,120
-1.783888780947490,76,85,190,375,9,185
-1.7838990646592500,86,95,90,250,9,160
-1.7839799038274600,86,95,170,450,9,280
-1.7840490971824400,96,105,70,250,9,180
-1.784216333218450,76,85,60,300,9,240
-1.7849415773296100,86,95,60,350,9,290
-1.785141967272880,96,105,70,275,9,205
-1.7851824602167000,96,105,150,225,9,75
-1.7856521603715600,96,105,80,400,9,320
-1.7857334884892700,86,95,120,425,9,305
-1.785887958854200,86,95,150,475,9,325
-1.7865107213387300,76,85,160,375,9,215
-1.78659841587008,96,105,60,450,9,390
-1.7866010130471900,96,105,110,400,9,290
-1.786800155578400,76,85,70,425,9,355
-1.7870094638422100,96,105,200,325,9,125
-1.7870748830938100,76,85,90,375,9,285
-1.7873203373223700,86,95,90,350,9,260
-1.7879741553166500,96,105,120,250,9,130
-1.7880197749387600,86,95,60,375,9,315
-1.7881760683543200,86,95,130,425,9,295
-1.7882493678754800,96,105,90,275,9,185
-1.788366216725890,76,85,100,275,9,175
-1.7884137843311100,86,95,140,450,9,310
-1.7885813286647800,76,85,80,350,9,270
-1.7887560530443900,86,95,70,450,9,380
-1.7889850836532800,86,95,190,425,9,235
-1.7890772477011000,92,100,160,500,8,340
-1.789240852473280,96,105,70,400,9,330
-1.7893084060186700,76,85,180,325,9,145
-1.7895723797701300,76,85,200,375,9,175
-1.7896390309898100,86,95,190,375,9,185
-1.7896796547541400,86,95,190,400,9,210
-1.7897420376731000,86,95,130,375,9,245
-1.7903606636068000,86,95,110,450,9,340
-1.7903992190691700,76,85,100,250,9,150
-1.7904349770638400,76,85,140,275,9,135
-1.7907934731249600,76,85,120,250,9,130
-1.7911045395442600,76,85,140,350,9,210
-1.7912001123427600,76,85,80,275,9,195
-1.7912674236187700,96,105,120,375,9,255
-1.791522606562190,86,95,180,400,9,220
-1.792102292235490,86,95,150,425,9,275
-1.792184833969790,86,95,180,375,9,195
-1.7927561015019800,96,105,100,275,9,175
-1.7928348939785100,76,85,110,400,9,290
-1.7931076283604800,92,100,90,500,8,410
-1.7932794713834400,86,95,70,375,9,305
-1.7936741764444400,96,105,140,225,9,85
-1.7938080469530900,96,105,100,375,9,275
-1.7938911967914400,76,85,60,475,9,415
-1.793968677795530,96,105,190,300,9,110
-1.7942764919216700,76,85,80,425,9,345
-1.7946778603290400,86,95,140,425,9,285
-1.7947766915293600,96,105,110,250,9,140
-1.7949167920805200,76,85,80,225,9,145
-1.7950360900684300,76,85,120,350,9,230
-1.7950683710612700,76,85,90,300,9,210
-1.7952347851088700,96,105,70,350,9,280
-1.7952646795514600,86,95,60,400,9,340
-1.7953628602242800,96,105,110,350,9,240
-1.795409026102530,86,95,80,500,9,420
-1.7956121673682500,96,105,100,325,9,225
-1.7958523206436500,92,100,200,450,8,250
-1.7960895844723000,86,95,150,350,9,200
-1.7962007297269000,76,85,70,350,9,280
-1.7965063899911900,96,105,70,325,9,255
-1.7966628291866500,96,105,120,275,9,155
-1.7969066112962800,86,95,80,450,9,370
-1.7981131920885300,92,100,100,500,8,400
-1.7982832000306100,86,95,100,400,9,300
-1.7983991890051200,76,85,200,325,9,125
-1.798593605066050,86,95,160,300,9,140
-1.798803521207690,86,95,70,425,9,355
-1.7988756949128500,92,100,120,450,8,330
-1.7989666626961400,76,85,140,225,9,85
-1.7990656411954500,86,95,200,375,9,175
-1.7992125110837700,86,95,90,425,9,335
-1.7992288106139300,76,85,70,275,9,205
-1.7993302048185700,86,95,160,375,9,215
-1.799351609146690,56,65,190,500,9,310
-1.799560410331700,86,95,60,325,9,265
-1.7995908308216000,86,95,130,225,9,95
-1.7996607789458600,76,85,70,250,9,180
-1.7998177289775500,86,95,140,375,9,235
-1.7998485919889000,66,75,200,500,9,300
-1.8004772899986400,86,95,80,350,9,270
-1.8005898738817800,86,95,80,375,9,295
-1.8006602274985600,86,95,200,300,9,100
-1.800766406100250,76,85,90,275,9,185
-1.8007748928370600,56,65,200,475,9,275
-1.8009974951068200,86,95,110,425,9,315
-1.8010918601141400,86,95,200,350,9,150
-1.8011020438199400,86,95,170,300,9,130
-1.8011757400737100,92,100,170,500,8,330
-1.8014839766159400,96,105,160,275,9,115
-1.801608526964510,86,95,160,450,9,290
-1.801838716844860,76,85,100,325,9,225
-1.8019248232345300,86,95,190,350,9,160
-1.8022386671685800,92,100,150,500,8,350
-1.8023790231729500,86,95,140,475,9,335
-1.8027615415867000,76,85,60,450,9,390
-1.8030213692070100,96,105,150,375,9,225
-1.8031444581107900,92,100,90,475,8,385
-1.8032507899426400,96,105,90,325,9,235
-1.803379073999000,96,105,110,275,9,165
-1.8034067541559600,86,95,60,500,9,440
-1.8041750875673200,86,95,140,250,9,110
-1.8044004603545100,96,105,110,375,9,265
-1.8047168440924400,92,100,170,350,8,180
-1.8052749242879900,96,105,100,350,9,250
-1.8057338320012500,86,95,130,250,9,120
-1.8057349502022200,86,95,60,475,9,415
-1.8058181224873400,96,105,50,300,9,250
-1.8059474325059000,76,85,110,250,9,140
-1.8059590627784800,96,105,110,300,9,190
-1.8060054204467300,86,95,180,350,9,170
-1.8060139022713500,96,105,150,300,9,150
-1.806038622221650,86,95,90,375,9,285
-1.806060623940120,86,95,150,325,9,175
-1.8060936390799100,86,95,140,275,9,135
-1.8061742367472600,76,85,70,400,9,330
-1.806188812916650,76,85,180,300,9,120
-1.8074176495006900,96,105,110,225,9,115
-1.8082532746951000,76,85,80,400,9,320
-1.808405205260020,96,105,130,350,9,220
-1.809096856025390,96,105,50,250,9,200
-1.8093535197343800,92,100,170,475,8,305
-1.8098213260189600,76,85,120,375,9,255
-1.8098903002871700,76,85,120,275,9,155
-1.8103961758405300,86,95,190,325,9,135
-1.8107061297409700,62,70,200,500,8,300
-1.8107641475587900,86,95,100,225,9,125
-1.8108484244142100,96,105,100,300,9,200
-1.8112657562538700,76,85,190,300,9,110
-1.8113062425892100,76,85,110,275,9,165
-1.8113160169361500,92,100,120,500,8,380
-1.8113575423566400,92,100,100,450,8,350
-1.8114567676314200,76,85,50,300,9,250
-1.8118638641827600,86,95,180,300,9,120
-1.8122984316895200,76,85,150,300,9,150
-1.8127072542466700,76,85,100,375,9,275
-1.812891090746660,86,95,90,225,9,135
-1.8133580133626300,76,85,110,350,9,240
-1.8134783767049200,56,65,180,500,9,320
-1.8134885464281900,76,85,60,225,9,165
-1.813540410680680,86,95,80,425,9,345
-1.8135825302985000,92,100,190,450,8,260
-1.8136983442432700,86,95,140,350,9,210
-1.813914661491100,76,85,110,225,9,115
-1.8139334205411900,86,95,60,300,9,240
-1.8139771995812100,76,85,130,350,9,220
-1.8144576445316600,92,100,180,475,8,295
-1.8149143707593700,56,65,190,475,9,285
-1.8149403823859900,86,95,110,250,9,140
-1.8150774818845500,86,95,100,250,9,150
-1.8151824924648600,76,85,100,300,9,200
-1.8152938755139700,72,80,200,500,8,300
-1.815312161430270,92,100,50,400,8,350
-1.8158570912796000,86,95,80,225,9,145
-1.8159988093147000,86,95,180,325,9,145
-1.8161290575793000,92,100,160,350,8,190
-1.8161377381844200,92,100,170,400,8,230
-1.8163182286899300,76,85,90,325,9,235
-1.8164132640481800,96,105,170,250,9,80
-1.8166146731064200,86,95,200,325,9,125
-1.8166998527504100,96,105,50,225,9,175
-1.8168274954928600,86,95,110,400,9,290
-1.816839005837550,96,105,80,325,9,245
-1.8168962027701700,86,95,80,275,9,195
-1.8170374525928800,96,105,60,225,9,165
-1.8171154789485000,86,95,120,350,9,230
-1.8177838941876000,76,85,50,225,9,175
-1.817885371909080,92,100,100,475,8,375
-1.8179405395779900,92,100,140,500,8,360
-1.818002107213460,92,100,160,425,8,265
-1.8180053187735,66,75,200,475,9,275
-1.8181265643385900,82,90,200,500,8,300
-1.818144937011120,76,85,100,350,9,250
-1.8182493326005600,86,95,50,275,9,225
-1.8182834916473900,96,105,50,325,9,275
-1.8184781242192800,92,100,50,375,8,325
-1.8194593587846000,86,95,70,275,9,205
-1.8196387823169100,96,105,140,300,9,160
-1.8197146330875900,96,105,70,300,9,230
-1.8201069891954300,96,105,60,275,9,215
-1.8201904978988300,92,100,130,500,8,370
-1.8203496698812900,96,105,150,275,9,125
-1.8203897732046100,92,100,110,500,8,390
-1.8204350177450500,76,85,70,325,9,255
-1.8208864300689700,76,85,50,250,9,200
-1.8210565917790400,86,95,90,300,9,210
-1.8214083423134600,92,100,70,500,8,430
-1.8214519422114000,96,105,60,250,9,190
-1.8217468221160600,66,75,190,500,9,310
-1.8217734612124100,92,100,160,475,8,315
-1.821812917616100,76,85,50,325,9,275
-1.8219400366467200,86,95,150,225,9,75
-1.8219686987873500,86,95,100,375,9,275
-1.8222017168395200,92,100,170,375,8,205
-1.8224745431527800,86,95,120,250,9,130
-1.823183392640250,76,85,150,375,9,225
-1.8236591401010400,86,95,110,350,9,240
-1.8241175953463500,76,85,160,275,9,115
-1.8242146747178000,76,85,170,250,9,80
-1.8242799634573900,56,65,160,500,9,340
-1.824417147741200,86,95,70,250,9,180
-1.8247028009443100,92,100,50,425,8,375
-1.824740499700810,86,95,100,275,9,175
-1.8249996656651900,88,95,200,500,7,300
-1.8250606900003800,92,100,60,425,8,365
-1.8254781474282000,86,95,120,375,9,255
-1.8255617358381700,66,75,190,475,9,285
-1.825753924811540,92,100,160,400,8,240
-1.825904834812010,86,95,80,400,9,320
-1.8259275969778700,56,65,120,450,9,330
-1.8261296968219800,76,85,110,375,9,265
-1.8261834545001400,92,100,150,450,8,300
-1.82624501344442,86,95,90,275,9,185
-1.8267616541545600,86,95,60,450,9,390
-1.8270272830497200,76,85,70,300,9,230
-1.827349266134010,86,95,150,375,9,225
-1.8275027033536300,96,105,120,325,9,205
-1.8275328876457100,86,95,70,350,9,280
-1.8277590170489300,76,85,110,300,9,190
-1.8280073190427100,96,105,130,275,9,145
-1.8283454607317600,96,105,80,300,9,220
-1.828455383077980,96,105,150,250,9,100
-1.8288385093693000,92,100,170,425,8,255
-1.8291969867315000,66,75,180,500,9,320
-1.8294943798613300,86,95,100,350,9,250
-1.8295939509957200,72,80,200,475,8,275
-1.8296524340930400,92,100,130,475,8,345
-1.8296637424964700,96,105,160,250,9,90
-1.8296985513245600,76,85,140,300,9,160
-1.82989228049835,92,100,130,450,8,320
-1.830217842130680,86,95,190,300,9,110
-1.830699848481600,92,100,130,400,8,270
-1.8307010864764500,76,85,60,250,9,190
-1.8308523868480000,56,65,90,500,9,410
-1.831224524837370,76,85,150,250,9,100
-1.8313503656596400,92,100,100,425,8,325
-1.8314294055759800,92,100,50,450,8,400
-1.8315518488352600,92,100,180,425,8,245
-1.831588452068480,76,85,80,325,9,245
-1.8317259045061400,96,105,130,300,9,170
-1.8317734991071400,86,95,100,325,9,225
-1.8320579561761900,92,100,200,400,8,200
-1.8321079896691000,56,65,100,500,9,400
-1.83211039145929,92,100,110,475,8,365
-1.8323585308762000,62,70,190,500,8,310
-1.8325290891951300,96,105,70,200,9,130
-1.8327482798089900,92,100,50,500,8,450
-1.8328558156468700,96,105,140,325,9,185
-1.8329713040519600,66,75,160,500,9,340
-1.8332896628931900,92,100,50,350,8,300
-1.833343875803210,72,80,190,500,8,310
-1.8334828659872800,86,95,70,400,9,330
-1.833529663572990,92,100,70,225,8,155
-1.8337072064985800,62,70,200,475,8,275
-1.83392542335144,62,70,190,475,8,285
-1.8342447354594300,92,100,90,450,8,360
-1.834488081279120,76,85,70,200,9,130
-1.8345944686275900,86,95,110,375,9,265
-1.834933001185920,92,100,180,450,8,270
-1.8351242068323700,86,95,120,275,9,155
-1.8351385221307200,56,65,200,450,9,250
-1.835170135282250,92,100,120,475,8,355
-1.8352240231748900,88,95,200,475,7,275
-1.8357411232564600,92,100,90,250,8,160
-1.8359801991548,82,90,200,475,8,275
-1.835981759968580,92,100,170,325,8,155
-1.836147904993210,86,95,110,300,9,190
-1.8364096741311100,86,95,50,300,9,250
-1.8364332284360000,86,95,140,225,9,85
-1.8366409746947200,92,100,50,475,8,425
-1.836679618087550,82,90,190,500,8,310
-1.8367738379082200,86,95,130,350,9,220
-1.8368018328464400,86,95,100,300,9,200
-1.8375269949932400,92,100,120,400,8,280
-1.837879275407520,76,85,60,275,9,215
-1.8380029418192300,76,85,160,225,9,65
-1.8385505695891700,92,100,80,250,8,170
-1.8387600223483500,86,95,70,325,9,255
-1.83879308326255,92,100,170,450,8,280
-1.8388717608700600,76,85,150,275,9,125
-1.8393675866691000,92,100,150,400,8,250
-1.839405365907650,86,95,90,325,9,235
-1.8394236468131800,86,95,110,225,9,115
-1.8397380276594300,66,75,120,450,9,330
-1.8397966373205500,66,75,200,450,9,250
-1.839797797286200,96,105,130,325,9,195
-1.839839136199570,92,100,90,400,8,310
-1.8399714233663400,56,65,150,500,9,350
-1.840428131550470,92,100,60,400,8,340
-1.8405405498364300,96,105,170,275,9,105
-1.8405734474670100,96,105,110,325,9,215
-1.8408448034482200,86,95,50,325,9,275
-1.8412960795403500,76,85,130,275,9,145
-1.8413807362548600,92,100,140,450,8,310
-1.8417960927300600,92,100,140,400,8,260
-1.8418030365118500,56,65,170,500,9,330
-1.8418661758037500,56,65,170,350,9,180
-1.841920698182530,92,100,80,500,8,420
-1.8419504479621700,92,100,70,475,8,405
-1.8421999074677100,86,95,160,275,9,115
-1.8422190552146700,66,75,90,500,9,410
-1.84228623045023,76,85,80,300,9,220
-1.8425548214728900,56,65,100,450,9,350
-1.8426024300144100,56,65,50,375,9,325
-1.8427004992565000,86,95,150,300,9,150
-1.8427579500292400,82,90,190,475,8,285
-1.8428396638447900,92,100,60,350,8,290
-1.8428705979659300,92,100,150,475,8,325
-1.8432632032813700,56,65,90,475,9,385
-1.8432712838634300,76,85,130,300,9,170
-1.8436741657698700,56,65,180,475,9,295
-1.8442664032840800,92,100,180,400,8,220
-1.84504822929107,86,95,80,325,9,245
-1.845169560639960,72,80,190,475,8,285
-1.8453680685664100,92,100,120,225,8,105
-1.8453851116824700,56,65,160,425,9,265
-1.8454556982758600,92,100,200,425,8,225
-1.8455130723701700,86,95,110,275,9,165
-1.8458451353261200,86,95,70,300,9,230
-1.8460886127300300,92,100,60,375,8,315
-1.8463708080517200,56,65,170,475,9,305
-1.8464977037590700,62,70,180,500,8,320
-1.8465332568110600,92,100,70,375,8,305
-1.8466604981081000,92,100,200,300,8,100
-1.8468861263282900,76,85,120,325,9,205
-1.8472181805853100,92,100,60,325,8,265
-1.8477677839236700,92,100,190,425,8,235
-1.8481508770375600,56,65,120,500,9,380
-1.848190599382430,92,100,120,425,8,305
-1.8482676857078200,88,95,190,500,7,310
-1.8486889595433100,56,65,190,450,9,260
-1.8487419306179100,76,85,160,250,9,90
-1.848919965878540,76,85,140,325,9,185
-1.8491655421423900,92,100,180,375,8,195
-1.8492164756640500,56,65,50,425,9,375
-1.8493960290814700,66,75,100,500,9,400
-1.8495361889437800,86,95,60,225,9,165
-1.8496937320309100,66,75,170,500,9,330
-1.850246332623770,92,100,80,475,8,395
-1.8503034197812600,92,100,160,325,8,165
-1.8503234770647200,86,95,140,300,9,160
-1.8505832475723100,86,95,130,275,9,145
-1.8508386302887400,72,80,180,500,8,320
-1.8508418347529800,92,100,110,450,8,340
-1.8509118814618200,56,65,50,350,9,300
-1.8510366233967400,92,100,130,425,8,295
-1.8510802052934300,92,100,150,425,8,275
-1.851574340397820,76,85,110,325,9,215
-1.8517635585831800,56,65,110,500,9,390
-1.8519735385253500,56,65,130,450,9,320
-1.8529012352855200,92,100,70,450,8,380
-1.852908784497170,56,65,100,475,9,375
-1.8531213640689000,92,100,130,225,8,95
-1.853218844476850,92,100,190,400,8,210
-1.8533091619791600,88,95,180,500,7,320
-1.8536900385724000,86,95,50,250,9,200
-1.8537823237399800,66,75,120,500,9,380
-1.8541452657187100,92,100,160,300,8,140
-1.8542549904667500,88,95,190,475,7,285
-1.8544163034133600,92,100,130,375,8,245
-1.8544730148262900,66,75,90,475,9,385
-1.8545164547584100,96,105,160,225,9,65
-1.8550550011097300,86,95,150,275,9,125
-1.8550866548873200,92,100,190,350,8,160
-1.8551125709513400,72,80,100,500,8,400
-1.8554560931835800,66,75,140,500,9,360
-1.8554953328280500,56,65,170,400,9,230
-1.8555953686381400,92,100,140,425,8,285
-1.855753291349220,56,65,50,400,9,350
-1.8558990835257900,56,65,160,350,9,190
-1.8560289003500200,92,100,110,425,8,315
-1.856906990368860,92,100,100,400,8,300
-1.857034495908830,76,85,130,325,9,195
-1.8570378966796200,56,65,70,225,9,155
-1.857076774974760,62,70,120,450,8,330
-1.8571492880194700,56,65,70,500,9,430
-1.8572165804913000,66,75,150,500,9,350
-1.8573002893166100,62,70,160,500,8,340
-1.857429534981690,82,90,180,500,8,320
-1.8574733600467600,92,100,190,375,8,185
-1.8576881708686400,66,75,170,350,9,180
-1.8580457601288600,66,75,160,425,9,265
-1.858143296415870,92,100,150,350,8,200
-1.858621100856220,72,80,160,500,8,340
-1.858755881632150,86,95,70,200,9,130
-1.8587940318238300,92,100,170,300,8,130
-1.8588308260093100,86,95,110,325,9,215
-1.859042352641780,86,95,150,250,9,100
-1.8590843907655300,92,100,70,425,8,355
-1.8591094383761900,56,65,140,500,9,360
-1.859267445245300,92,100,140,250,8,110
-1.8592788690420300,92,100,80,450,8,370
-1.859312710891820,56,65,130,500,9,370
-1.859354192365630,96,105,120,300,9,180
-1.859670634925200,56,65,160,475,9,315
-1.8597505550611800,66,75,50,375,9,325
-1.8597768574483900,92,100,140,475,8,335
-1.8597863367820900,86,95,120,325,9,205
-1.8598284709888500,96,105,80,200,9,120
-1.8600087452630600,82,90,160,500,8,340
-1.860030926918900,86,95,60,250,9,190
-1.8603227791279500,96,105,180,275,9,95
-1.8603779684389200,56,65,170,375,9,205
-1.8606218434905900,92,100,90,350,8,260
-1.8606910930918500,62,70,180,475,8,295
-1.8612414642923900,62,70,100,500,8,400
-1.861317002253480,86,95,50,225,9,175
-1.861608182132940,92,100,60,500,8,440
-1.8617081805177500,56,65,170,325,9,155
-1.861952724843960,56,65,60,425,9,365
-1.8620800390970400,56,65,50,500,9,450
-1.8620985658523500,66,75,170,475,9,305
-1.8621231926848300,56,65,100,425,9,325
-1.862179916172340,92,100,160,375,8,215
-1.8623462798077300,66,75,100,450,9,350
-1.862547201198290,86,95,60,275,9,215
-1.8626910734651900,92,100,130,250,8,120
-1.8627232893821000,92,100,140,350,8,210
-1.8628330386595700,56,65,170,425,9,255
-1.8628778716957700,76,85,170,275,9,105
-1.8633149157723300,66,75,180,475,9,295
-1.863399026917390,72,80,120,450,8,330
-1.8637753062759100,56,65,160,400,9,240
-1.863950244454810,72,80,90,500,8,410
-1.864014139071390,56,65,90,250,9,160
-1.8640434035950000,92,100,60,475,8,415
-1.864274796505890,86,95,130,300,9,170
-1.8643865981480900,56,65,130,400,9,270
-1.8644037971480000,66,75,190,450,9,260
-1.8646533023781500,82,90,150,500,8,350
-1.864936654150130,92,100,140,375,8,235
-1.8649379757281400,92,100,200,375,8,175
-1.8649987897857800,92,100,160,450,8,290
-1.865128931880230,86,95,170,250,9,80
-1.8652460457102900,66,75,170,400,9,230
-1.8656272791079900,82,90,90,500,8,410
-1.8659029840541900,82,90,120,450,8,330
-1.865937875880280,62,70,90,500,8,410
-1.8662548741445500,92,100,90,425,8,335
-1.866339850133050,88,95,160,500,7,340
-1.8663529920303200,56,65,120,475,9,355
-1.8663551711219600,62,70,90,475,8,385
-1.866414236811450,56,65,180,425,9,245
-1.8664657292681700,92,100,180,325,8,145
-1.8667441185741300,82,90,200,450,8,250
-1.8668091506530800,62,70,170,350,8,180
-1.8671249773155600,66,75,110,500,9,390
-1.867140379734970,92,100,180,350,8,170
-1.8678485425527500,56,65,50,450,9,400
-1.8679091975292000,56,65,60,375,9,315
-1.8679587310905600,66,75,50,425,9,375
-1.8681314896647800,56,65,120,225,9,105
-1.8683286000182100,92,100,150,325,8,175
-1.868415353895020,92,100,200,350,8,150
-1.8684593288332500,92,100,80,425,8,345
-1.8686322693684600,82,90,100,500,8,400
-1.8686908099880300,92,100,80,375,8,295
-1.8693899364902200,72,80,170,500,8,330
-1.8694371373977300,92,100,60,450,8,390
-1.869633545801390,66,75,100,475,9,375
-1.8696766950728800,66,75,130,500,9,370
-1.8697236257551200,92,100,80,275,8,195
-1.8698381618397500,92,100,90,300,8,210
-1.8698503742232900,92,100,60,300,8,240
-1.8701544282759500,86,95,130,325,9,195
-1.870296175449230,92,100,90,375,8,285
-1.870439756170620,56,65,80,250,9,170
-1.870547411677940,76,85,170,225,9,55
-1.8709785890661300,96,105,200,275,9,75
-1.871003022383660,56,65,130,225,9,95
-1.871181293773170,92,100,90,225,8,135
-1.8713738653560200,88,95,100,500,7,400
-1.871388110486700,56,65,160,325,9,165
-1.871439368672940,56,65,120,400,9,280
-1.8714493223364100,56,65,130,475,9,345
-1.8714973041408900,92,100,100,225,8,125
-1.871557182989650,92,100,140,275,8,135
-1.871676196253240,66,75,50,400,9,350
-1.8717905240478800,66,75,160,475,9,315
-1.8718839319454100,88,95,120,450,7,330
-1.8719804096549200,66,75,170,425,9,255
-1.8720277578993400,92,100,80,350,8,270
-1.872398003055270,86,95,80,300,9,220
-1.8724191655720900,66,75,50,350,9,300
-1.8728059783369000,62,70,170,500,8,330
-1.8730293878198100,62,70,150,500,8,350
-1.87319692654973,86,95,140,325,9,185
-1.8732165462825300,56,65,170,450,9,280
-1.8732553638982400,66,75,110,475,9,365
-1.8732809605567700,56,65,150,350,9,200
-1.8733960578558200,72,80,200,450,8,250
-1.8734695826523200,56,65,150,400,9,250
-1.8739563506090100,56,65,90,450,9,360
-1.8740245998208500,56,65,60,350,9,290
-1.8741089216792800,62,70,200,450,8,250
-1.874188543543970,92,100,120,350,8,230
-1.8742452276264800,96,105,190,275,9,85
-1.8743242443908200,88,95,90,500,7,410
-1.8743280011913300,66,75,90,450,9,360
-1.8744892301746500,88,95,170,500,7,330
-1.8745239574750100,92,100,180,300,8,120
-1.8750216691750700,92,100,190,325,8,135
-1.875222348363330,92,100,200,325,8,125
-1.8752416382808300,72,80,50,375,8,325
-1.8756400816290200,82,90,120,500,8,380
-1.8756665189326300,82,90,90,475,8,385
-1.8757016279607500,62,70,100,450,8,350
-1.8758782791587100,82,90,170,500,8,330
-1.8758976937156500,56,65,140,450,9,310
-1.875987066157210,82,90,170,350,8,180
-1.876209759228620,72,80,90,475,8,385
-1.8763187378734900,86,95,160,250,9,90
-1.8763763707508000,66,75,50,450,9,400
-1.876504079327560,66,75,170,375,9,205
-1.8765298828555900,92,100,100,250,8,150
-1.8765738586157600,78,85,200,500,7,300
-1.8768979119139700,56,65,90,400,9,310
-1.876906183608460,72,80,150,500,8,350
-1.8770077714366700,92,100,50,275,8,225
-1.8772841210469900,62,70,120,500,8,380
-1.8776090072503300,92,100,120,250,8,130
-1.877786841713450,72,80,170,475,8,305
-1.8779314440043100,96,105,170,225,9,55
-1.8779686958736100,62,70,50,375,8,325
-1.8779822235036500,92,100,110,400,8,290
-1.8780499003623800,72,80,100,450,8,350
-1.8781266872377900,92,100,70,275,8,205
-1.8783021133156900,56,65,110,450,9,340
-1.8784536923314500,92,100,80,225,8,145
-1.8784811598593800,62,70,170,400,8,230
-1.8784834846136800,56,65,110,475,9,365
-1.8786668315590600,66,75,130,400,9,270
-1.878818235603710,72,80,170,400,8,230
-1.8789503787472300,96,105,60,200,9,140
-1.8789532727923800,56,65,50,475,9,425
-1.8789682387999300,96,105,180,250,9,70
-1.8789715348505600,66,75,130,450,9,320
-1.8792360500281100,72,80,170,350,8,180
-1.8793828758576500,56,65,180,450,9,270
-1.879441508299180,82,90,50,375,8,325
-1.8794838622292200,66,75,130,475,9,345
-1.8796172431860400,56,65,120,425,9,305
-1.8797722695848200,88,95,170,350,7,180
-1.8797958958401200,66,75,100,425,9,325
-1.8798145165027300,66,75,120,475,9,355
-1.8799492419761800,76,85,120,300,9,180
-1.880017145943140,82,90,170,475,8,305
-1.8802278791253600,66,75,60,425,9,365
-1.880247544429160,82,90,190,450,8,260
-1.8803093734704100,92,100,140,225,8,85
-1.880406124428210,62,70,160,425,8,265
-1.8804765505224800,62,70,50,425,8,375
-1.8805517701870500,92,100,70,250,8,180
-1.8806295998748600,56,65,60,400,9,340
-1.8806304080796100,66,75,70,500,9,430
-1.880724434694970,56,65,130,425,9,295
-1.8811240724722000,92,100,120,375,8,255
-1.8811685606811400,66,75,50,500,9,450
-1.8812261153369200,66,75,180,450,9,270
-1.8812377034956200,56,65,200,400,9,200
-1.8812669466659000,86,95,160,225,9,65
-1.8813794266355400,62,70,170,475,8,305
-1.881891161773050,56,65,180,375,9,195
-1.8820361301845500,76,85,80,200,9,120
-1.8820445221028600,82,90,100,450,8,350
-1.882275951658570,96,105,150,200,9,50
-1.8823284051099500,82,90,110,500,8,390
-1.8823891000569400,88,95,90,475,7,385
-1.8824557323767900,66,75,80,250,9,170
-1.8824960871915300,56,65,70,450,9,380
-1.8827576089904000,92,100,80,400,8,320
-1.8828035286139300,66,75,130,425,9,295
-1.8829865972472700,92,100,150,225,8,75
-1.8829959960795700,72,80,180,475,8,295
-1.883011522358230,88,95,200,450,7,250
-1.8831616852846900,88,95,160,425,7,265
-1.883542996017840,88,95,150,500,7,350
-1.883568636615880,72,80,120,500,8,380
-1.8836590985911300,62,70,190,450,8,260
-1.8838271177532200,56,65,200,425,9,225
-1.8839137837732500,72,80,50,350,8,300
-1.8840116833682600,66,75,160,400,9,240
-1.8842500654586400,56,65,80,475,9,395
-1.8842689666020800,82,90,100,475,8,375
-1.8845431672036300,76,85,180,275,9,95
-1.8846214446609300,92,100,100,275,8,175
-1.8846291166401700,56,65,150,450,9,300
-1.8846400320419800,62,70,160,475,8,315
-1.8848422997835300,62,70,160,350,8,190
-1.884898038261270,62,70,110,500,8,390
-1.8851561752364000,86,95,170,275,9,105
-1.8851723860409400,66,75,130,225,9,95
-1.8852198641557000,56,65,60,325,9,265
-1.885413636576860,66,75,160,350,9,190
-1.885420241098040,76,85,150,200,9,50
-1.8854936650397000,66,75,50,475,9,425
-1.8854991889082700,66,75,200,400,9,200
-1.8855205416298200,92,100,90,275,8,185
-1.885523188221230,72,80,50,425,8,375
-1.8856631611196500,66,75,70,225,9,155
-1.8857304406605800,86,95,120,300,9,180
-1.8857792570897300,66,75,90,250,9,160
-1.8858043338687700,56,65,180,400,9,220
-1.8859402328297700,56,65,200,300,9,100
-1.8859756846878000,92,100,70,400,8,330
-1.8859784121878800,96,105,90,200,9,110
-1.8862840300300700,56,65,150,475,9,325
-1.8864029118671300,56,65,70,375,9,305
-1.8864281207368700,66,75,170,325,9,155
-1.8866360205022800,56,65,190,375,9,185
-1.8866888198550200,92,100,110,350,8,240
-1.8866904499003200,92,100,110,250,8,140
-1.8867780088282800,92,100,70,350,8,280
-1.8868712412629300,82,90,160,425,8,265
-1.886927391877510,56,65,160,300,9,140
-1.8869323546864700,92,100,100,375,8,275
-1.8870608643071800,88,95,50,375,7,325
-1.8870843030246800,66,75,180,425,9,245
-1.8871351599530800,82,90,180,475,8,295
-1.8871650400363600,92,100,150,375,8,225
-1.8871913871263600,92,100,120,275,8,155
-1.887371030585970,72,80,100,475,8,375
-1.887399256005400,82,90,170,400,8,230
-1.887516575624170,56,65,70,475,9,405
-1.887792630368540,88,95,180,475,7,295
-1.8879931783659500,62,70,100,475,8,375
-1.8880431887134600,72,80,190,450,8,260
-1.8881660779904600,62,70,140,500,8,360
-1.8881807977364000,82,90,130,500,8,370
-1.8883102786917200,76,85,200,275,9,75
-1.8883866325526200,62,70,50,350,8,300
-1.8884824421054400,66,75,150,400,9,250
-1.8885941887636600,56,65,130,375,9,245
-1.888675863741740,88,95,170,475,7,305
-1.888759326952450,72,80,50,500,8,450
-1.8889801696336900,82,90,50,425,8,375
-1.8889881220058400,72,80,160,350,8,190
-1.889015893098780,66,75,170,450,9,280
-1.8890939112096400,62,70,50,400,8,350
-1.889215702118260,72,80,50,400,8,350
-1.8892273738428600,88,95,170,400,7,230
-1.889281660085970,62,70,170,375,8,205
-1.889412374264880,66,75,200,425,9,225
-1.8894303625701500,66,75,180,375,9,195
-1.8895164037212600,66,75,140,450,9,310
-1.8895497840165600,76,85,190,275,9,85
-1.8895675632741900,72,80,100,425,8,325
-1.889568298688940,72,80,120,475,8,355
-1.8896282617402800,72,80,160,400,8,240
-1.8900424813363400,82,90,140,500,8,360
-1.8901158169220600,66,75,60,400,9,340
-1.8903799638776400,56,65,190,350,9,160
-1.8904273624845000,92,100,100,300,8,200
-1.8904517643648000,76,85,50,200,9,150
-1.8904770215194100,66,75,160,325,9,165
-1.8905077844555600,66,75,120,400,9,280
-1.8905187974431400,88,95,120,500,7,380
-1.8905720497592800,66,75,90,400,9,310
-1.8908773819052400,88,95,190,450,7,260
-1.8908856775966000,72,80,110,500,8,390
-1.8909810977888900,66,75,120,425,9,305
-1.8910587502072400,56,65,90,350,9,260
-1.8911360585599000,56,65,80,375,9,295
-1.8912200302122400,62,70,100,425,8,325
-1.8914787655702500,56,65,190,425,9,235
-1.8915181968670700,56,65,90,225,9,135
-1.8915334612833200,72,80,130,500,8,370
-1.891643290697120,72,80,160,425,8,265
-1.8920939436798000,82,90,130,450,8,320
-1.8921920558602500,56,65,140,400,9,260
-1.8923486556253900,66,75,150,450,9,300
-1.8923847015426100,62,70,130,500,8,370
-1.89255606145151,88,95,100,450,7,350
-1.8925925331933900,62,70,130,225,8,95
-1.8926645502437600,56,65,100,225,9,125
-1.8928236865927000,62,70,70,225,8,155
-1.8928646963759800,66,75,60,375,9,315
-1.8928994127354300,96,105,50,200,9,150
-1.8929581642910400,82,90,170,375,8,205
-1.8930673512769900,62,70,130,450,8,320
-1.893289192296580,88,95,140,500,7,360
-1.8933854596577600,56,65,70,425,9,355
-1.8934703905969300,82,90,120,475,8,355
-1.8934789150918700,72,80,160,475,8,315
-1.8935422656234700,62,70,110,475,8,365
-1.893546419498430,66,75,150,475,9,325
-1.8935507598089800,66,75,190,425,9,235
-1.8935626937468000,56,65,140,250,9,110
-1.8935971018065200,56,65,80,500,9,420
-1.8937455665838200,92,100,100,325,8,225
-1.8937643585278100,62,70,170,425,8,255
-1.893807751014850,56,65,140,425,9,285
-1.8939086659682100,82,90,160,475,8,315
-1.8939618562504500,66,75,70,475,9,405
-1.8940132870399100,82,90,70,500,8,430
-1.8940384050323200,62,70,80,250,8,170
-1.894083831854700,88,95,50,350,7,300
-1.8941677273017100,56,65,130,250,9,120
-1.894324802425270,56,65,150,225,9,75
-1.8944455533125300,82,90,50,350,8,300
-1.8944863489083200,92,100,50,300,8,250
-1.894646170259210,56,65,80,225,9,145
-1.8947507516088100,96,105,110,200,9,90
-1.8951576000774300,88,95,100,475,7,375
-1.8952543418864600,62,70,50,500,8,450
-1.895312051114990,72,80,140,500,8,360
-1.895381021422610,92,100,190,300,8,110
-1.8955036817111300,88,95,130,500,7,370
-1.8955662100243400,62,70,90,250,8,160
-1.8955788471808900,92,100,90,325,8,235
-1.895634506330670,72,80,170,425,8,255
-1.8961437792491500,72,80,170,375,8,205
-1.896330427698270,62,70,70,500,8,430
-1.8963423035378300,92,100,160,275,8,115
-1.8964900064646600,56,65,110,425,9,315
-1.8966224458868700,76,85,60,200,9,140
-1.8967317576848800,62,70,170,325,8,155
-1.8968873174069400,66,75,70,450,9,380
-1.8969535214342900,78,85,200,475,7,275
-1.8969657370840500,82,90,180,450,8,270
-1.897082388651690,76,85,110,200,9,90
-1.8972513518326700,92,100,150,300,8,150
-1.897291742658170,82,90,170,425,8,255
-1.8973553710728400,66,75,60,350,9,290
-1.897468548692310,62,70,120,475,8,355
-1.8975244680051600,82,90,170,325,8,155
-1.8976014558471200,88,95,110,500,7,390
-1.8976909203085300,92,100,130,350,8,220
-1.8977018770397700,66,75,120,225,9,105
-1.8978011146592300,46,55,200,500,9,300
-1.897850321938290,66,75,70,375,9,305
-1.897873074385700,82,90,180,425,8,245
-1.897901774393290,86,95,80,200,9,120
-1.8979748075067600,56,65,150,425,9,275
-1.8979801039218100,56,65,80,450,9,370
-1.897996499961650,72,80,50,450,8,400
-1.8980464168509300,66,75,130,250,9,120
-1.8983726930025800,92,100,100,350,8,250
-1.898412063834400,56,65,180,350,9,170
-1.898474904091440,88,95,100,425,7,325
-1.8984966918500100,82,90,160,400,8,240
-1.8985581438001400,78,85,190,475,7,285
-1.8986912855149100,76,85,90,200,9,110
-1.8987655146728700,56,65,140,475,9,335
-1.8988801019159600,86,95,180,275,9,95
-1.8988919193722900,56,65,150,325,9,175
-1.89895364937682,88,95,130,475,7,345
-1.8992141498023400,62,70,60,425,8,365
-1.8992161003917500,88,95,160,350,7,190
-1.8992319795083400,82,90,130,400,8,270
-1.8995103897305700,62,70,130,400,8,270
-1.8995840742144200,82,90,130,475,8,345
-1.8998064679895900,92,100,110,275,8,165
-1.8998787782070800,82,90,50,400,8,350
-1.9000484901522100,56,65,140,275,9,135
-1.900069035310070,66,75,180,400,9,220
-1.9001089032080700,66,75,80,475,9,395
-1.900111834168250,88,95,50,400,7,350
-1.9001930946913200,56,65,90,425,9,335
-1.900291051710110,72,80,80,250,8,170
-1.9003335853097200,62,70,180,450,8,270
-1.9003624563806000,56,65,170,300,9,130
-1.9003749638939700,72,80,130,400,8,270
-1.9004211185944600,72,80,70,500,8,430
-1.9005049562996500,82,90,50,500,8,450
-1.9005448357768400,56,65,160,450,9,290
-1.9007352387040300,62,70,160,400,8,240
-1.9007905002416900,66,75,80,500,9,420
-1.9008365304234600,56,65,190,400,9,210
-1.9010514096192000,62,70,50,450,8,400
-1.9011044532714700,72,80,50,475,8,425
-1.9013062958217600,82,90,100,425,8,325
-1.9013723155860400,88,95,170,375,7,205
-1.90147628509634,56,65,90,375,9,285
-1.9016264748337800,66,75,140,425,9,285
-1.9016292359501800,66,75,110,450,9,340
-1.9016774276184300,62,70,120,225,8,105
-1.901834177750840,82,90,200,400,8,200
-1.9019016922727600,82,90,110,475,8,365
-1.9020868443746500,92,100,110,375,8,265
-1.9021475292650100,66,75,110,425,9,315
-1.9022760432960000,78,85,180,500,7,320
-1.9025222547490800,62,70,130,475,8,345
-1.90253121058448,86,95,200,275,9,75
-1.902569900213140,96,105,180,225,9,45
-1.902587165876450,56,65,100,400,9,300
-1.902716371724370,92,100,170,250,8,80
-1.9027205462279800,78,85,190,500,7,310
-1.9027287858298600,88,95,70,500,7,430
-1.902768112021560,92,100,140,300,8,160
-1.9029946440367100,66,75,140,400,9,260
-1.9030633250124300,92,100,110,225,8,115
-1.9031654075679600,72,80,200,400,8,200
-1.9033101663174000,66,75,60,325,9,265
-1.9033277928974900,82,90,160,350,8,190
-1.903488716342690,66,75,130,375,9,245
-1.9035671109660800,56,65,80,275,9,195
-1.9036353829250400,88,95,50,425,7,375
-1.9038268080771200,76,85,50,175,9,125
-1.9038990840897400,56,65,60,500,9,440
-1.9039365954700700,72,80,170,325,8,155
-1.9039532487049600,56,65,120,250,9,130
-1.904017401542390,66,75,80,375,9,295
-1.9040951644629000,88,95,170,425,7,255
-1.9041923867381200,92,100,70,325,8,255
-1.9042385078202200,72,80,150,400,8,250
-1.9043069029291800,92,100,50,225,8,175
-1.9045058588131100,82,90,60,425,8,365
-1.9045403857712200,66,75,190,350,9,160
-1.9046348748111900,66,75,190,375,9,185
-1.9048945338533900,72,80,180,450,8,270
-1.9050345756307500,86,95,150,200,9,50
-1.905080396429600,88,95,130,450,7,320
-1.9050939897009000,62,70,90,450,8,360
-1.9051889803690900,88,95,160,475,7,315
-1.905274481735700,72,80,130,475,8,345
-1.9053648370494400,56,65,70,275,9,205
-1.905387000631490,72,80,140,425,8,285
-1.9054532414511300,56,65,50,275,9,225
-1.9055084052794900,72,80,70,225,8,155
-1.9055700626126900,56,65,190,325,9,135
-1.9055835648274000,72,80,90,250,8,160
-1.9056908823078400,96,105,50,175,9,125
-1.9059026429725000,72,80,60,425,8,365
-1.9059331141317400,66,75,150,350,9,200
-1.9061238855426000,78,85,160,500,7,340
-1.906141312431550,62,70,170,450,8,280
-1.906273877538140,66,75,160,375,9,215
-1.9063691340686200,88,95,120,475,7,355
-1.906403863285400,56,65,160,375,9,215
-1.9064466442584600,62,70,150,400,8,250
-1.90666755402526,56,65,200,350,9,150
-1.9068787791080000,66,75,160,300,9,140
-1.906988493297980,66,75,140,250,9,110
-1.9072173661656700,82,90,140,450,8,310
-1.9072533239450600,62,70,60,375,8,315
-1.907297512940540,66,75,120,250,9,130
-1.907301197840470,66,75,190,325,9,135
-1.9073865574757800,72,80,110,450,8,340
-1.9074670196186800,66,75,150,425,9,275
-1.907491234566140,92,100,80,325,8,245
-1.9074994636804500,62,70,60,350,8,290
-1.907635415933200,56,65,140,375,9,235
-1.9076744727114600,66,75,190,400,9,210
-1.907679664830630,62,70,70,375,8,305
-1.9076924479307000,82,90,120,400,8,280
-1.9077493423578500,56,65,100,250,9,150
-1.9078203502077800,66,75,50,275,9,225
-1.9081288293873700,62,70,200,400,8,200
-1.908210138108980,86,95,190,275,9,85
-1.9082455489064600,56,65,180,325,9,145
-1.908489902128150,88,95,50,450,7,400
-1.9087187153467500,72,80,130,450,8,320
-1.9087791743175400,92,100,110,300,8,190
-1.9088077740003900,82,90,170,450,8,280
-1.9088419857823800,88,95,180,425,7,245
-1.9089717168756000,56,65,140,350,9,210
-1.9090216710071800,66,75,140,475,9,335
-1.909162090284330,92,100,70,300,8,230
-1.909300627548380,62,70,180,425,8,245
-1.909323053933100,92,100,50,325,8,275
-1.9093658731064500,56,65,60,300,9,240
-1.9094107918892200,66,75,70,425,9,355
-1.9095062331915600,66,75,200,300,9,100
-1.9097725443384200,76,85,100,200,9,100
-1.9097911302584300,88,95,50,500,7,450
-1.9098746013529300,56,65,80,350,9,270
-1.9098927733328500,56,65,90,275,9,185
-1.9100760990759700,72,80,90,450,8,360
-1.9101124754825000,62,70,50,475,8,425
-1.9101228775035900,88,95,60,425,7,365
-1.9101327688990600,98,105,200,500,7,300
-1.9102362097633400,82,90,50,475,8,425
-1.9102535802097800,66,75,90,350,9,260
-1.9102540420841000,72,80,120,400,8,280
-1.9103055923003200,76,85,180,250,9,70
-1.910315423384660,88,95,180,450,7,270
-1.9103430296331100,94,100,200,500,6,300
-1.9103768650523800,92,100,60,250,8,190
-1.9104078799004500,62,70,160,325,8,165
-1.9105419256160500,96,105,100,200,9,100
-1.9106258743128700,62,70,70,475,8,405
-1.9106258842995500,92,100,70,200,8,130
-1.910660291159780,82,90,150,475,8,325
-1.9106719660243200,88,95,140,450,7,310
-1.9107374716859900,72,80,180,425,8,245
-1.9109018761026400,62,70,60,325,8,265
-1.910907797210460,88,95,160,400,7,240
-1.910948003066020,88,95,200,400,7,200
-1.9109930051800400,82,90,50,450,8,400
-1.9110303476541600,72,80,110,475,8,365
-1.911036971705150,88,95,170,325,7,155
-1.9110967047277800,56,65,70,350,9,280
-1.9111029514465900,72,80,200,425,8,225
-1.9111329954158300,66,75,140,375,9,235
-1.9112924236069100,72,80,140,450,8,310
-1.9113857580258900,96,105,60,175,9,115
-1.9115514825499000,92,100,150,275,8,125
-1.9116935596929200,96,105,160,200,9,40
-1.9117070582457900,62,70,130,375,8,245
-1.9117257528655700,66,75,80,450,9,370
-1.9117977584424300,62,70,130,425,8,295
-1.9118333934591300,66,75,170,300,9,130
-1.9118466637904100,72,80,60,400,8,340
-1.9120505458752900,88,95,120,225,7,105
-1.9121012719303800,66,75,90,425,9,335
-1.9122262029051600,82,90,70,475,8,405
-1.9122771278938100,66,75,200,375,9,175
-1.912347702129610,82,90,180,400,8,220
-1.9124644781856500,82,90,90,400,8,310
-1.9124735213100900,82,90,90,450,8,360
-1.912486149142910,72,80,60,375,8,315
-1.9126661979874900,62,70,80,500,8,420
-1.9127092759700100,66,75,140,350,9,210
-1.9127101051957300,72,80,120,425,8,305
-1.9127202572566700,62,70,200,425,8,225
-1.9127242891788600,62,70,180,400,8,220
-1.9127554701918300,66,75,150,325,9,175
-1.9127598861909300,56,65,60,475,9,415
-1.9127755244871500,82,90,110,450,8,340
-1.912889192188650,62,70,140,450,8,310
-1.913058123973930,72,80,60,350,8,290
-1.9132218275810600,82,90,60,350,8,290
-1.9133182323403200,88,95,110,475,7,365
-1.9133784082876600,56,65,90,300,9,210
-1.9135800558915,62,70,150,450,8,300
-1.9136123616986700,56,65,80,425,9,345
-1.913768466148520,66,75,100,400,9,300
-1.914321736273370,72,80,90,400,8,310
-1.9145625492305800,88,95,150,400,7,250
-1.9146107304222600,66,75,180,350,9,170
-1.9147343892858600,72,80,140,400,8,260
-1.9149369920764700,56,65,70,250,9,180
-1.9149443236341400,88,95,140,400,7,260
-1.9150956398210400,82,90,70,225,8,155
-1.9152067190707400,72,80,150,475,8,325
-1.915225296027210,62,70,100,250,8,150
-1.9152396718126600,62,70,140,400,8,260
-1.9152398478614700,88,95,160,325,7,165
-1.9152624490012100,62,70,150,475,8,325
-1.9152855252919700,92,100,150,250,8,100
-1.915318305802270,62,70,80,475,8,395
-1.9153618777902200,92,100,60,225,8,165
-1.915529527516760,88,95,90,450,7,360
-1.9155688548883500,88,95,150,450,7,300
-1.9156030378085000,82,90,60,400,8,340
-1.9157293185014400,82,90,80,475,8,395
-1.9159234341531400,66,75,90,375,9,285
-1.9160914381600900,62,70,90,400,8,310
-1.9161164405503700,56,65,60,450,9,390
-1.9161363092989700,82,90,150,450,8,300
-1.9161761187165100,56,65,100,375,9,275
-1.9162520673778000,88,95,70,225,7,155
-1.9162822491293100,66,75,140,275,9,135
-1.9163637222660300,82,90,90,250,8,160
-1.916431148647100,56,65,200,375,9,175
-1.9164641387615800,56,65,100,275,9,175
-1.9165085757148900,82,90,120,425,8,305
-1.9165141942135400,88,95,90,250,7,160
-1.9165231139217000,82,90,130,375,8,245
-1.916577861098390,66,75,160,450,9,290
-1.9165782308209300,86,95,170,225,9,55
-1.9166439387048300,88,95,120,400,7,280
-1.9166739148155200,46,55,200,475,9,275
-1.916675931871610,72,80,170,450,8,280
-1.916871311258520,78,85,120,450,7,330
-1.917046866526780,92,100,60,275,8,215
-1.917245755773660,82,90,80,250,8,170
-1.9173789273249300,56,65,180,300,9,120
-1.9174115041234600,56,65,200,325,9,125
-1.9174983589099800,72,80,120,225,8,105
-1.9176492405545300,82,90,150,400,8,250
-1.917716474212230,88,95,50,475,7,425
-1.9177350375897200,72,80,70,475,8,405
-1.9178132238080700,82,90,190,425,8,235
-1.9178915184272800,82,90,160,325,8,165
-1.9179385589343700,72,80,160,325,8,165
-1.9179502578396100,72,80,90,350,8,260
-1.9179780192518200,62,70,160,300,8,140
-1.9181015275338500,82,90,120,225,8,105
-1.9181045620953400,76,85,160,200,9,40
-1.9181205195291900,96,105,120,200,9,80
-1.9181224780038900,76,85,180,225,9,45
-1.9181323356270700,88,95,170,450,7,280
-1.9182575739855400,56,65,140,225,9,85
-1.9182921428063500,94,100,200,475,6,275
-1.9182924347148900,82,90,60,375,8,315
-1.9183005773800700,66,75,200,350,9,150
-1.9183673673624000,62,70,90,350,8,260
-1.9185414854072400,62,70,120,400,8,280
-1.9187603002712300,62,70,180,375,8,195
-1.9188594729721,46,55,180,500,9,320
-1.9189069731389400,82,90,150,425,8,275
-1.9189538032478400,46,55,190,500,9,310
-1.9189576748943500,82,90,130,425,8,295
-1.9189864825294400,82,90,200,425,8,225
-1.9191726549343800,96,105,130,200,9,70
-1.9191767619284200,82,90,140,475,8,335
-1.9192461373351900,88,95,70,475,7,405
-1.9193017526597200,82,90,80,450,8,370
-1.9193460122484000,88,95,80,250,7,170
-1.9193891908234100,82,90,200,300,8,100
-1.919583555804610,88,95,60,350,7,290
-1.9197044779272400,62,70,190,400,8,210
-1.919746598620440,88,95,130,400,7,270
-1.9197601249500600,66,75,100,225,9,125
-1.9197861999033500,72,80,130,250,8,120
-1.9198213148384300,88,95,130,225,7,95
-1.9198585179491900,56,65,110,250,9,140
-1.919898444499530,56,65,100,325,9,225
-1.9199107514390000,82,90,140,400,8,260
-1.9199498229247200,82,90,60,325,8,265
-1.9199737853726900,62,70,60,400,8,340
-1.9200896117111200,66,75,90,225,9,135
-1.9201361910725100,72,80,150,450,8,300
-1.920253119731520,66,75,80,275,9,195
-1.9205609749788300,72,80,130,425,8,295
-1.9206045151036400,66,75,60,475,9,415
-1.9206761695427200,56,65,110,400,9,290
-1.9208326869404700,88,95,90,400,7,310
-1.920881016317630,72,80,130,225,8,95
-1.9208868355671700,82,90,150,350,8,200
-1.9209622519963900,62,70,150,425,8,275
-1.9210962963490900,72,80,60,325,8,265
-1.921153164595020,72,80,180,375,8,195
-1.9211595824009600,62,70,50,275,8,225
-1.9211910678768600,88,95,150,350,7,200
-1.9212085316627000,72,80,130,375,8,245
-1.9212823195654000,66,75,200,325,9,125
-1.9213333610084700,78,85,90,500,7,410
-1.9213580382042800,88,95,120,425,7,305
-1.9214094722171100,62,70,110,450,8,340
-1.9214266176246900,56,65,70,325,9,255
-1.9215083193414600,62,70,190,375,8,185
-1.9215675864349100,62,70,110,425,8,315
-1.9216137495458400,82,90,70,375,8,305
-1.9216738434880700,56,65,150,300,9,150
-1.921732359184210,72,80,180,400,8,220
-1.9222101637228200,88,95,190,400,7,210
-1.9222238306596600,66,75,80,350,9,270
-1.9222792832426700,88,95,150,475,7,325
-1.9224501096800500,66,75,180,325,9,145
-1.9225398963606200,66,75,100,250,9,150
-1.9225867936162300,46,55,190,475,9,285
-1.92260425228335,82,90,140,375,8,235
-1.9226886669195200,72,80,70,450,8,380
-1.9227185993485000,86,95,110,200,9,90
-1.9227203186274100,62,70,120,425,8,305
-1.922801814252890,88,95,60,375,7,315
-1.9229691826410400,62,70,200,300,8,100
-1.923020168046970,82,90,180,375,8,195
-1.9230752399413200,62,70,80,275,8,195
-1.9231511548616400,82,90,70,450,8,380
-1.9233219228802000,92,100,130,275,8,145
-1.9233560313150100,82,90,160,300,8,140
-1.923526240137750,72,80,190,400,8,210
-1.9236511730545300,62,70,70,450,8,380
-1.9238340685412400,66,75,100,275,9,175
-1.9239512593684600,72,80,80,475,8,395
-1.9241415615891000,76,85,120,200,9,80
-1.9242268699373800,66,75,80,225,9,145
-1.9242978115239900,92,100,80,300,8,220
-1.924347056344400,62,70,150,350,8,200
-1.924438625461810,88,95,200,425,7,225
-1.9244580904011100,78,85,100,500,7,400
-1.9245129415084100,82,90,190,375,8,185
-1.9246396429570800,66,75,60,300,9,240
-1.9248341667696200,56,65,120,350,9,230
-1.9248433403709100,62,70,140,425,8,285
-1.9249604778060400,78,85,170,500,7,330
-1.925012072431040,56,65,190,300,9,110
-1.9252703406649200,62,70,190,350,8,160
-1.9254230519458900,56,65,80,400,9,320
-1.9254713029183900,82,90,140,425,8,285
-1.9255519394145400,72,80,100,400,8,300
-1.9255704231508000,88,95,90,350,7,260
-1.925650884833960,72,80,70,375,8,305
-1.9256565987862900,96,105,70,175,9,105
-1.9258097845506700,82,90,80,500,8,420
-1.9259362767611000,72,80,110,425,8,315
-1.9260060471964100,88,95,110,450,7,340
-1.926063863649150,88,95,60,325,7,265
-1.9261610993584100,56,65,150,375,9,225
-1.926180024225900,66,75,90,300,9,210
-1.9265373813327800,82,90,190,400,8,210
-1.9270030165783500,92,100,140,325,8,185
-1.9271965766320100,66,75,90,275,9,185
-1.927232716933430,62,70,180,325,8,145
-1.9273368445469100,72,80,190,425,8,235
-1.9273936783385700,88,95,70,375,7,305
-1.9274256761650900,88,95,60,400,7,340
-1.92749701924097,88,95,180,400,7,220
-1.9275427640888100,88,95,130,375,7,245
-1.9275608493624600,88,95,80,475,7,395
-1.9277611845147000,86,95,90,200,9,110
-1.9279046261964000,66,75,80,425,9,345
-1.9279913899748500,66,75,60,500,9,440
-1.9281066937171400,82,90,130,225,8,95
-1.9281874076266200,62,70,100,225,8,125
-1.9282273524335600,72,80,190,350,8,160
-1.9282844223918200,88,95,130,425,7,295
-1.928380480335820,56,65,120,375,9,255
-1.9284188504125200,88,95,180,375,7,195
-1.9284953188193400,72,80,160,300,8,140
-1.9286030117206100,72,80,80,500,8,420
-1.928862972077100,82,90,150,325,8,175
-1.9288635827825400,88,95,140,425,7,285
-1.9289306545764800,78,85,200,450,7,250
-1.928982404312530,82,90,140,275,8,135
-1.929017975118700,88,95,190,425,7,235
-1.929032247366810,62,70,60,300,8,240
-1.929069788486600,62,70,90,225,8,135
-1.9291642360920200,88,95,160,300,7,140
-1.9291748792929300,72,80,200,300,8,100
-1.9292392855847500,92,100,50,250,8,200
-1.9292518380600400,86,95,60,200,9,140
-1.9292544792934200,72,80,150,425,8,275
-1.9292818146408100,88,95,80,500,7,420
-1.9292862532022600,98,105,190,475,7,285
-1.9294186373638400,86,95,180,250,9,70
-1.9294964293544700,72,80,170,300,8,130
-1.9295040932384600,92,100,120,325,8,205
-1.9295185476781100,72,80,80,450,8,370
-1.9296547364661400,92,100,110,325,8,215
-1.929681087418450,62,70,130,250,8,120
-1.9297162149805600,62,70,100,400,8,300
-1.9297441048831900,82,90,110,425,8,315
-1.9298628044056700,82,90,170,300,8,130
-1.9299370275752000,66,75,150,225,9,75
-1.9299402524573300,72,80,90,425,8,335
-1.9299408379735400,82,90,200,350,8,150
-1.9300002233218200,56,65,70,300,9,230
-1.9301580220321100,88,95,140,375,7,235
-1.930327008363230,62,70,190,425,8,235
-1.9303843118325700,66,75,120,350,9,230
-1.9304679907469600,88,95,80,450,7,370
-1.9305109527167300,66,75,70,275,9,205
-1.9305404676281200,78,85,150,500,7,350
-1.9305407704178900,92,100,160,250,8,90
-1.930600173352380,78,85,180,475,7,295
-1.9306211557103000,96,105,140,200,9,60
-1.9308814134728200,56,65,70,400,9,330
-1.9308981862131300,66,75,60,450,9,390
-1.93095982948608,56,65,160,275,9,115
-1.9310535137557300,94,100,190,500,6,310
-1.9311146992933000,62,70,80,450,8,370
-1.9312974464305900,88,95,110,425,7,315
-1.9313231697509400,46,55,160,500,9,340
-1.931380380119860,88,95,200,300,7,100
-1.9314796808229200,72,80,50,275,8,225
-1.9315351280993900,92,100,130,300,8,170
-1.9315704427143600,62,70,200,350,8,150
-1.931620491299910,72,80,150,350,8,200
-1.931753148265820,92,100,130,325,8,195
-1.9318132984334200,72,80,80,375,8,295
-1.9319293014697400,88,95,190,350,7,160
-1.9322980027920300,82,90,130,250,8,120
-1.9323736555777600,66,75,70,350,9,280
-1.9323936750574200,66,75,100,375,9,275
-1.9323965798446300,72,80,190,375,8,185
-1.9324046430767000,56,65,110,375,9,265
-1.9324201183054800,88,95,150,425,7,275
-1.9324326098520200,72,80,100,250,8,150
-1.9324615728047000,76,85,130,200,9,70
-1.9324793393045600,88,95,190,375,7,185
-1.9325607851956800,62,70,70,425,8,355
-1.93266205496979,78,85,170,350,7,180
-1.9327407861559700,72,80,140,250,8,110
-1.9327442244359600,56,65,100,300,9,200
-1.9327556510420800,82,90,190,350,8,160
-1.9329017080151500,86,95,180,225,9,45
-1.9330193179243900,56,65,110,350,9,240
-1.9330661004748800,62,70,140,250,8,110
-1.9331209455859600,98,105,200,475,7,275
-1.9331260076017800,56,65,50,300,9,250
-1.9332186019538000,82,90,70,425,8,355
-1.9332197137224400,78,85,120,500,7,380
-1.9333034926347600,62,70,200,375,8,175
-1.9333365416585800,62,70,180,350,8,170
-1.9334008917224800,62,70,120,250,8,130
-1.9334255714674900,62,70,160,450,8,290
-1.93352323294302,56,65,110,225,9,115
-1.933523923117520,56,65,100,350,9,250
-1.933736012732430,82,90,90,350,8,260
-1.9338016764021700,88,95,190,325,7,135
-1.9338651630284400,62,70,140,225,8,85
-1.9339271713251800,62,70,150,225,8,75
-1.9339553816200200,66,75,80,400,9,320
-1.9340055089352600,88,95,180,350,7,170
-1.9340739415930800,88,95,70,450,7,380
-1.9341813307327700,66,75,110,400,9,290
-1.9342403074232600,62,70,80,225,8,145
-1.934308861455380,72,80,160,450,8,290
-1.934354788722200,62,70,80,375,8,295
-1.9344525697347000,88,95,160,450,7,290
-1.9344672200054200,72,80,150,325,8,175
-1.9344692650908700,72,80,60,300,8,240
-1.9344993942112800,62,70,190,325,8,135
-1.934763159459190,82,90,140,250,8,110
-1.934890218042800,72,80,140,375,8,235
-1.9350091425710400,66,75,180,300,9,120
-1.9350185694740800,98,105,190,500,7,310
-1.9350435891505200,72,80,140,225,8,85
-1.935243504494870,46,55,100,500,9,400
-1.9352890979061000,62,70,90,425,8,335
-1.935363533086610,78,85,170,475,7,305
-1.9353751245517100,62,70,170,300,8,130
-1.9356146731653900,78,85,90,475,7,385
-1.9356521164073000,72,80,100,225,8,125
-1.935719333940740,56,65,130,350,9,220
-1.9357943064507700,62,70,140,475,8,335
-1.9358241964398600,88,95,170,300,7,130
-1.9359092110166600,62,70,150,325,8,175
-1.9359434036740300,82,90,200,375,8,175
-1.9359628706996700,72,80,160,375,8,215
-1.9361688726149100,82,90,160,375,8,215
-1.936287382154960,72,80,180,350,8,170
-1.9365382547280800,92,100,170,275,8,105
-1.9366580257498000,62,70,90,375,8,285
-1.936723566199350,62,70,140,375,8,235
-1.9367432421455500,66,75,110,350,9,240
-1.9368058138353600,82,90,100,400,8,300
-1.9368345777740300,82,90,180,350,8,170
-1.9369066986861000,76,85,60,175,9,115
-1.936973602729290,88,95,60,500,7,440
-1.9370501111395700,56,65,70,200,9,130
-1.9370705472827900,66,75,100,325,9,225
-1.9371930209688500,82,90,190,325,8,135
-1.9372994310881700,88,95,200,350,7,150
-1.9373513922818600,82,90,90,225,8,135
-1.9373700903936500,46,55,120,450,9,330
-1.9375433206087200,62,70,140,275,8,135
-1.937592205916900,92,100,160,225,8,65
-1.9375968983035800,66,75,110,250,9,140
-1.9376300573224500,88,95,130,250,7,120
-1.9376360218906100,82,90,90,425,8,335
-1.937664012238060,66,75,70,250,9,180
-1.9378407377629000,56,65,50,225,9,175
-1.937882976147940,66,75,100,350,9,250
-1.937896888877450,62,70,100,275,8,175
-1.9379618953231400,88,95,200,375,7,175
-1.9380017977999200,46,55,90,500,9,410
-1.9380126841919900,72,80,200,375,8,175
-1.938275319509080,56,65,120,275,9,155
-1.9382773426021400,88,95,70,425,7,355
-1.9383603090380300,66,75,120,375,9,255
-1.9383763558666800,72,80,60,475,8,415
-1.9384565534341000,82,90,160,450,8,290
-1.9385686988852400,78,85,110,500,7,390
-1.9385986073106500,46,55,170,500,9,330
-1.9385986163572300,56,65,90,325,9,235
-1.93885701257153,72,80,140,475,8,335
-1.939061131565610,82,90,80,375,8,295
-1.9390687209512100,62,70,60,500,8,440
-1.939190817282220,88,95,140,475,7,335
-1.9392308611839100,72,80,70,425,8,355
-1.9393178760909800,62,70,160,375,8,215
-1.939342121988990,66,75,140,225,9,85
-1.9393574152070800,78,85,100,450,7,350
-1.9395713074478900,86,95,50,200,9,150
-1.9396602401367900,76,85,140,200,9,60
-1.9397567621413800,82,90,60,500,8,440
-1.9398705400369400,62,70,60,475,8,415
-1.939991717113890,72,80,90,225,8,135
-1.9400548377113300,88,95,100,400,7,300
-1.9401383783908400,72,80,80,275,8,195
-1.9401438198309700,82,90,60,475,8,415
-1.9401908248969700,56,65,50,325,9,275
-1.9403117568887300,62,70,200,325,8,125
-1.9404463544659100,72,80,140,350,8,210
-1.940488127224940,66,75,70,400,9,330
-1.940504481500990,82,90,140,350,8,210
-1.9405129986391600,82,90,90,375,8,285
-1.940645845186180,88,95,140,275,7,135
-1.9409255019396700,98,105,160,500,7,340
-1.9409276860910300,66,75,120,275,9,155
-1.9409399846148700,62,70,70,275,8,205
-1.9409513857965500,66,75,100,300,9,200
-1.9411110097187000,78,85,160,425,7,265
-1.9412088546949100,62,70,80,350,8,270
-1.941372871121790,62,70,90,275,8,185
-1.9413864842367600,88,95,60,475,7,415
-1.9416191315333000,78,85,190,450,7,260
-1.9417724013835000,72,80,60,500,8,440
-1.9418069147446800,66,75,50,300,9,250
-1.9419808029244600,72,80,200,350,8,150
-1.9420326101722200,72,80,140,275,8,135
-1.9420515937754700,78,85,50,375,7,325
-1.9420756738272500,72,80,80,350,8,270
-1.942184673113250,72,80,80,225,8,145
-1.9422426620646700,88,95,140,250,7,110
-1.9423509602773400,82,90,60,300,8,240
-1.94241313979265,62,70,180,300,8,120
-1.9425639902542600,62,70,70,250,8,180
-1.942902303698520,72,80,200,325,8,125
-1.9430398977887800,82,90,120,250,8,130
-1.9432071012092100,98,105,180,500,7,320
-1.9432809956084900,78,85,130,500,7,370
-1.9432994382718800,66,75,150,375,9,225
-1.943420972067410,82,90,80,275,8,195
-1.9434838729861300,88,95,150,325,7,175
-1.9434939570944000,88,95,90,425,7,335
-1.9435738818743600,72,80,150,225,8,75
-1.9436684448506500,66,75,50,325,9,275
-1.943691219991950,72,80,90,375,8,285
-1.9437754505379,76,85,70,175,9,105
-1.9437842160065000,96,105,80,175,9,95
-1.9438254469418400,88,95,50,275,7,225
-1.943903853172550,94,100,180,500,6,320
-1.9439726903157300,56,65,110,275,9,165
-1.9440055299190600,82,90,120,350,8,230
-1.9441393890318600,56,65,80,325,9,245
-1.9446055222019800,46,55,150,500,9,350
-1.9446130793443800,82,90,50,275,8,225
-1.944775683098710,82,90,180,325,8,145
-1.944783319590300,56,65,140,300,9,160
-1.9448803592299800,62,70,90,300,8,210
-1.9449279088645100,82,90,80,350,8,270
-1.9450264956691500,66,75,190,300,9,110
-1.9450569390672300,78,85,140,500,7,360
-1.9450774074548900,72,80,120,250,8,130
-1.945260817624580,92,100,120,300,8,180
-1.9454535332888700,88,95,160,375,7,215
-1.9456392084302400,82,90,100,250,8,150
-1.9456961325553100,88,95,80,375,7,295
-1.9460265948541800,68,75,200,500,7,300
-1.9460360135158800,72,80,180,325,8,145
-1.946091447788320,72,80,90,300,8,210
-1.946171917707190,46,55,200,450,9,250
-1.9462333100450800,78,85,170,400,7,230
-1.9463453209565200,46,55,90,475,9,385
-1.9464281553387500,88,95,100,225,7,125
-1.9465379271574600,66,75,150,300,9,150
-1.946578690381740,72,80,180,300,8,120
-1.9467278681365100,62,70,80,425,8,345
-1.9468155480817200,56,65,110,300,9,190
-1.946928911284720,72,80,190,325,8,135
-1.9472845543396900,82,90,100,225,8,125
-1.9472983919061700,62,70,110,250,8,140
-1.947636423791370,66,75,50,225,9,175
-1.9476761239076300,82,90,110,400,8,290
-1.9477645609167800,62,70,110,400,8,290
-1.9480039835453200,66,75,110,275,9,165
-1.9480178012884500,88,95,90,225,7,135
-1.9483143812322900,86,95,100,200,9,100
-1.9483248487013600,86,95,50,175,9,125
-1.9483676924853300,86,95,120,200,9,80
-1.9484209348872000,56,65,60,250,9,190
-1.9486207847544400,82,90,180,300,8,120
-1.9487228808768000,88,95,80,275,7,195
-1.9487663720594600,52,60,200,500,8,300
-1.9487884902265800,82,90,90,275,8,185
-1.94891156968939,66,75,110,375,9,265
-1.9490806868644100,72,80,90,275,8,185
-1.949136145176830,94,100,190,475,6,285
-1.9492276912263400,66,75,90,325,9,235
-1.9492703750378800,78,85,170,425,7,255
-1.9492825572562200,88,95,90,375,7,285
-1.9494237413436900,46,55,170,350,9,180
-1.9494928377447500,72,80,110,250,8,140
-1.9499275272894600,66,75,140,300,9,160
-1.9499569613183800,82,90,80,425,8,345
-1.9499875488933700,72,80,110,400,8,290
-1.949997969174250,82,90,70,275,8,205
-1.9501611660672000,66,75,70,325,9,255
-1.9502234016386900,78,85,50,475,7,425
-1.9502244926250600,56,65,170,250,9,80
-1.9502974818716200,56,65,60,225,9,165
-1.9503418297773400,82,90,80,225,8,145
-1.9504056468520100,72,80,70,275,8,205
-1.9504121607600600,78,85,50,425,7,375
-1.9504993753999100,82,90,110,350,8,240
-1.950811698276920,78,85,100,475,7,375
-1.950914421054570,66,75,160,275,9,115
-1.9510078651566400,88,95,80,350,7,270
-1.9510757411691000,46,55,170,475,9,305
-1.9514057657049400,82,90,200,325,8,125
-1.951559912637660,72,80,70,250,8,180
-1.951587030770870,82,90,90,300,8,210
-1.951604168317940,88,95,100,250,7,150
-1.9516295712319000,66,75,130,350,9,220
-1.9517596474439800,66,75,110,225,9,115
-1.9520100215210000,62,70,140,350,8,210
-1.952067248978990,88,95,100,375,7,275
-1.9521220614406500,92,100,80,200,8,120
-1.9521672345371400,72,80,120,350,8,230
-1.9523236996905000,92,100,180,275,8,95
-1.952468745620570,62,70,70,350,8,280
-1.9524990784490600,82,90,100,375,8,275
-1.9528329909930100,88,95,60,450,7,390
-1.952934665746360,82,90,70,250,8,180
-1.9530251038415100,78,85,130,475,7,345
-1.9531669161025400,78,85,160,475,7,315
-1.953389618811440,88,95,80,225,7,145
-1.9535165224717400,86,95,130,200,9,70
-1.953630416555160,88,95,80,425,7,345
-1.9536312799644200,46,55,130,500,9,370
-1.9537531895022800,72,80,80,425,8,345
-1.9538230444619800,66,75,80,325,9,245
-1.9538505691018200,98,105,90,500,7,410
-1.9538510751283100,88,95,110,250,7,140
-1.9539575117998900,88,95,140,350,7,210
-1.9539762947827500,56,65,60,275,9,215
-1.9540545131416300,62,70,120,350,8,230
-1.9542167796577400,72,80,70,350,8,280
-1.9543698137050100,96,105,110,175,9,65
-1.954430386015840,82,90,80,400,8,320
-1.954554162570990,78,85,50,350,7,300
-1.9545804529027200,96,105,190,250,9,60
-1.95459483971893,62,70,80,400,8,320
-1.9545953804819600,88,95,90,275,7,185
-1.9546093124757400,88,95,120,250,7,130
-1.954667305057210,94,100,160,500,6,340
-1.954702000132480,62,70,50,300,8,250
-1.9547332621014700,88,95,60,300,7,240
-1.9547421395330100,68,75,200,475,7,275
-1.9547873413964500,72,80,190,300,8,110
-1.954800638451460,88,95,100,325,7,225
-1.9548263377195800,62,70,130,350,8,220
-1.955084737226420,46,55,90,250,9,160
-1.9551562101595700,78,85,160,325,7,165
-1.955168464793270,78,85,160,400,7,240
-1.9552042166420400,82,90,60,450,8,390
-1.9552184016698500,62,70,100,325,8,225
-1.9552348728865000,88,95,180,325,7,145
-1.9553378056390700,82,90,100,275,8,175
-1.9557232330713800,72,80,100,275,8,175
-1.955725962759410,86,95,60,175,9,115
-1.9558760611497300,46,55,100,450,9,350
-1.9559513801108900,78,85,120,400,7,280
-1.956020572602200,98,105,170,500,7,330
-1.956420869086800,82,90,120,375,8,255
-1.9567977884873800,82,90,150,225,8,75
-1.9569973963000500,78,85,60,425,7,365
-1.9572029120729800,78,85,170,325,7,155
-1.9572607104093300,62,70,60,450,8,390
-1.957324403991840,62,70,100,375,8,275
-1.9574965261531700,88,95,120,350,7,230
-1.9575268862557800,82,90,110,250,8,140
-1.9577704854767000,78,85,70,500,7,430
-1.9578016859889300,78,85,50,500,7,450
-1.957854206912130,56,65,50,250,9,200
-1.9578653112007000,56,65,150,250,9,100
-1.9579582403425000,98,105,120,450,7,330
-1.9579600883728900,88,95,110,350,7,240
-1.9579815802862800,82,90,70,350,8,280
-1.9579839026523600,56,65,150,275,9,125
-1.9583841751108700,78,85,130,450,7,320
-1.9584368518022200,78,85,160,350,7,190
-1.9584990988535600,92,100,150,200,8,50
-1.9585679732169800,88,95,150,375,7,225
-1.9587093672845600,72,80,60,450,8,390
-1.9588594279991800,46,55,120,500,9,380
-1.9590190913989800,46,55,170,400,9,230
-1.9591400542981900,88,95,70,275,7,205
-1.9591647637515100,96,105,90,175,9,85
-1.9591951023937500,88,95,110,400,7,290
-1.9593364266612600,88,95,180,300,7,120
-1.959512691271220,98,105,200,450,7,250
-1.9596818253788000,78,85,170,375,7,205
-1.9598186793511000,66,75,150,250,9,100
-1.959825420873340,72,80,80,400,8,320
-1.9598524288841000,66,75,110,300,9,190
-1.959894383138100,82,90,70,400,8,330
-1.960024288631520,82,90,100,350,8,250
-1.9601156994329700,98,105,190,450,7,260
-1.9601813485980600,52,60,200,475,8,275
-1.9601899154735700,78,85,70,225,7,155
-1.9602460128606500,62,70,110,350,8,240
-1.9603530876169400,46,55,180,475,9,295
-1.9606874869502200,56,65,130,275,9,145
-1.9607149516797600,94,100,120,450,6,330
-1.9607456403817600,98,105,100,500,7,400
-1.9607955876646900,88,95,90,300,7,210
-1.9607997504014700,62,70,150,300,8,150
-1.9608288750373800,66,75,70,200,9,130
-1.9608425885683400,82,90,50,300,8,250
-1.9608460225055700,72,80,100,325,8,225
-1.960846174741150,94,100,90,500,6,410
-1.9613003613679500,82,90,140,225,8,85
-1.961419201878620,46,55,190,450,9,260
-1.9615568364000400,62,70,50,225,8,175
-1.9615779014547600,88,95,150,225,7,75
-1.961668297457090,62,70,120,275,8,155
-1.9618090712081000,88,95,100,275,7,175
-1.9618477059680000,46,55,100,475,9,375
-1.9618821241746200,82,90,90,325,8,235
-1.961897977768350,56,65,160,225,9,65
-1.9619189497153300,46,55,50,375,9,325
-1.9619518418510600,88,95,200,325,7,125
-1.9619792921913600,78,85,50,400,7,350
-1.9620022017042000,66,75,60,225,9,165
-1.9620267801564700,62,70,190,300,8,110
-1.9620887140583200,62,70,70,400,8,330
-1.9621322542773400,56,65,80,300,9,220
-1.9621756687034500,62,70,100,300,8,200
-1.9622113263060900,72,80,120,375,8,255
-1.9622627252270200,98,105,150,500,7,350
-1.9623380984976600,72,80,70,400,8,330
-1.9624144862310500,78,85,180,425,7,245
-1.9624320718387800,86,95,160,200,9,40
-1.9625369805403000,46,55,160,425,9,265
-1.962608873531820,78,85,180,450,7,270
-1.9627410959667000,72,80,120,275,8,155
-1.962857179357310,78,85,200,400,7,200
-1.9629771941578900,52,60,190,500,8,310
-1.9630134253998100,82,90,190,300,8,110
-1.9630759602968100,78,85,50,450,7,400
-1.9630829707859600,78,85,110,450,7,340
-1.9631873307107000,78,85,100,425,7,325
-1.9632556332782200,78,85,120,475,7,355
-1.9633715706858400,72,80,130,350,8,220
-1.963422191899420,66,75,80,300,9,220
-1.9634472328655600,62,70,120,375,8,255
-1.9636441134070500,62,70,50,325,8,275
-1.9637440217888000,86,95,70,175,9,105
-1.9638555865621100,72,80,110,275,8,165
-1.9639197457051200,62,70,90,325,8,235
-1.9639229609510200,88,95,80,400,7,320
-1.9641399549660500,82,90,110,275,8,165
-1.9641904188347500,72,80,100,375,8,275
-1.9642264922615700,82,90,150,375,8,225
-1.9643306299576400,88,95,190,300,7,110
-1.9644281065060800,66,75,60,250,9,190
-1.9645789245532600,72,80,110,350,8,240
-1.9646885045066400,68,75,190,475,7,285
-1.9647541066391300,72,80,110,375,8,265
-1.9648224287827500,78,85,110,475,7,365
-1.9648406728535700,78,85,200,425,7,225
-1.9649095827264300,66,75,150,275,9,125
-1.9651082871953000,78,85,140,450,7,310
-1.9651410151823900,88,95,70,400,7,330
-1.9651719352204900,72,80,150,375,8,225
-1.9652759215060400,98,105,170,350,7,180
-1.9653945844202900,66,75,60,275,9,215
-1.9654100393618700,82,90,100,300,8,200
-1.9654384486451800,56,65,160,250,9,90
-1.9654964354824100,88,95,70,250,7,180
-1.965561714950750,56,65,120,325,9,205
-1.9657948999609200,46,55,50,425,9,375
-1.9658235667033000,78,85,90,400,7,310
-1.9658276772168200,94,100,100,500,6,400
-1.9659065654162100,78,85,150,400,7,250
-1.9662707701245700,82,90,100,325,8,225
-1.9664060921683700,78,85,90,250,7,160
-1.9665332243303900,88,95,150,300,7,150
-1.9665751986066500,76,85,80,175,9,95
-1.966592977843540,72,80,160,275,8,115
-1.9668306954802700,94,100,90,475,6,385
-1.9668959389652400,62,70,70,325,8,255
-1.9669632602495100,68,75,190,500,7,310
-1.9669694026800600,82,90,160,275,8,115
-1.96707194358055,66,75,70,300,9,230
-1.9672598796506700,76,85,110,175,9,65
-1.9673497877045900,82,90,70,325,8,255
-1.9673608444372800,62,70,110,275,8,165
-1.9674478674324100,46,55,170,425,9,255
-1.9674501521388700,46,55,140,500,9,360
-1.9674609546388900,82,90,110,375,8,265
-1.9675076620215600,82,90,150,300,8,150
-1.9675151979524300,78,85,90,450,7,360
-1.9676439046341600,98,105,90,475,7,385
-1.967760077548580,88,95,70,350,7,280
-1.9678476798305300,56,65,140,325,9,185
-1.9678571122393600,66,75,170,250,9,80
-1.967956034841310,78,85,130,400,7,270
-1.9682571608933900,72,80,150,300,8,150
-1.9683533070372400,46,55,110,500,9,390
-1.9684156074351000,88,95,120,375,7,255
-1.9685848696662600,94,100,170,350,6,180
-1.9688011311084600,62,70,70,200,8,130
-1.968809686625690,98,105,140,500,7,360
-1.9689968550829200,88,95,130,350,7,220
-1.9690687383289400,66,75,130,275,9,145
-1.969121218684850,62,70,150,375,8,225
-1.9691469800053100,78,85,80,250,7,170
-1.9694648152629200,94,100,150,500,6,350
-1.9695422387449000,46,55,80,250,9,170
-1.9695599965934100,82,90,130,350,8,220
-1.9695725326822200,72,80,50,300,8,250
-1.9696843010074500,72,80,100,350,8,250
-1.9697488908571300,82,90,120,275,8,155
-1.9699278169093400,98,105,170,475,7,305
-1.9699409257634900,66,75,50,250,9,200
-1.970019692954280,78,85,150,325,7,175
-1.9701100729378300,62,70,60,250,8,190
-1.9701673071719400,62,70,160,275,8,115
-1.970428659825270,78,85,170,450,7,280
-1.9704942958694900,52,60,190,475,8,285
-1.970532183508170,78,85,120,225,7,105
-1.970578753745830,46,55,130,450,9,320
-1.970682661514810,92,100,190,275,8,85
-1.9707866087404900,56,65,110,325,9,215
-1.9708768934166600,72,80,100,300,8,200
-1.9709087849358500,86,95,190,250,9,60
-1.9712532086078900,82,90,140,300,8,160
-1.9713681307029800,94,100,200,450,6,250
-1.9713759494538300,56,65,130,300,9,170
-1.9714134901038900,78,85,180,400,7,220
-1.9715328388565500,62,70,70,300,8,230
-1.9717078885664900,98,105,120,500,7,380
-1.9717390871577100,52,60,120,450,8,330
-1.9720056434052000,82,90,110,225,8,115
-1.972033260736160,62,70,60,225,8,165
-1.9720443590285800,46,55,70,500,9,430
-1.972097381620540,46,55,50,500,9,450
-1.9722697449718100,92,100,200,275,8,75
-1.9724719350948400,46,55,50,350,9,300
-1.9725468358950600,94,100,170,500,6,330
-1.9727066958520800,76,85,190,250,9,60
-1.972746794533800,62,70,100,350,8,250
-1.9727666597015100,92,100,170,225,8,55
-1.9728979671581900,78,85,180,375,7,195
-1.9729453596522400,88,95,110,275,7,165
-1.9730138621746400,72,80,90,325,8,235
-1.973231889432960,72,80,50,325,8,275
-1.9733787615632800,46,55,160,350,9,190
-1.9734205383522200,88,95,50,300,7,250
-1.973459032065450,94,100,100,475,6,375
-1.9734980200180100,62,70,110,375,8,265
-1.9735204305165300,78,85,60,375,7,315
-1.9735759579830900,88,95,100,350,7,250
-1.9736103600862500,46,55,170,325,9,155
-1.9736663584995800,72,80,110,225,8,115
-1.9737213793869000,72,80,110,300,8,190
-1.9738379357034600,78,85,130,225,7,95
-1.9738582382683100,46,55,160,475,9,315
-1.973894645817670,78,85,60,325,7,265
-1.9740685519593900,78,85,60,350,7,290
-1.9743860631155500,78,85,120,425,7,305
-1.9745355590961200,98,105,170,400,7,230
-1.9746130931415400,94,100,120,500,6,380
-1.9746531210204500,88,95,90,325,7,235
-1.9746769960188900,46,55,50,400,9,350
-1.9749009602714000,98,105,180,475,7,295
-1.9749547623169800,86,95,140,200,9,60
-1.9749922191476400,98,105,160,425,7,265
-1.9750247803365400,62,70,110,225,8,115
-1.9751005460898500,88,95,140,225,7,85
-1.9751872646345700,94,100,100,450,6,350
-1.9751940489397200,78,85,60,400,7,340
-1.975229961381480,66,75,120,325,9,205
-1.9752412006107400,66,75,160,250,9,90
-1.9753426794290200,88,95,110,375,7,265
-1.9754934307740900,46,55,180,450,9,270
-1.9757365540200200,46,55,60,425,9,365
-1.9758979938330700,78,85,150,450,7,300
-1.9761748111940500,72,80,70,325,8,255
-1.9762776969422700,46,55,60,325,9,265
-1.9764118603279000,98,105,160,475,7,315
-1.9765623549086300,98,105,100,450,7,350
-1.9766693721907200,94,100,170,475,6,305
-1.9766823178855500,98,105,170,375,7,205
-1.9768073261220100,46,55,70,225,9,155
-1.9768631349797400,46,55,60,350,9,290
-1.9768711662852500,78,85,130,375,7,245
-1.9770127439927000,46,55,120,475,9,355
-1.9770309241757500,98,105,130,500,7,370
-1.977181214557200,82,90,50,325,8,275
-1.977211966521750,78,85,70,475,7,405
-1.977292742524860,52,60,180,500,8,320
-1.9773419823483400,78,85,190,400,7,210
-1.9773934124335300,46,55,170,375,9,205
-1.9775429129598600,88,95,100,300,7,200
-1.9775481251287700,94,100,160,425,6,265
-1.9776027409013700,88,95,160,275,7,115
-1.977662577459230,46,55,130,475,9,345
-1.9776861364963200,92,100,60,200,8,140
-1.977705279206910,46,55,50,450,9,400
-1.9777587668752100,72,80,80,325,8,245
-1.9783267935400900,66,75,130,300,9,170
-1.9785233777885200,78,85,200,300,7,100
-1.9787682368824800,98,105,170,425,7,255
-1.978768602402330,92,100,110,200,8,90
-1.9788044929499000,82,90,110,300,8,190
-1.9788286410709400,68,75,180,500,7,320
-1.9788781672169600,46,55,110,475,9,365
-1.978970352414480,78,85,150,475,7,325
-1.9790614695895800,72,80,70,300,8,230
-1.9790717349019000,78,85,70,375,7,305
-1.9791477168649700,78,85,140,425,7,285
-1.9791928209253000,88,95,70,325,7,255
-1.9793001772905400,78,85,90,350,7,260
-1.9793848538367400,68,75,120,450,7,330
-1.9794111971083900,72,80,50,225,8,175
-1.9794261895740800,56,65,170,275,9,105
-1.9794383956912300,46,55,160,325,9,165
-1.9794663679367300,94,100,60,425,6,365
-1.979475591908060,62,70,50,250,8,200
-1.9795270213574200,46,55,130,400,9,270
-1.979655396370930,56,65,130,325,9,195
-1.9797519521783900,94,100,180,475,6,295
-1.9797662049195200,78,85,110,425,7,315
-1.9799378218539200,82,90,150,275,8,125
-1.9799476674596500,88,95,110,300,7,190
-1.9802146462367900,62,70,110,300,8,190
-1.9802519668117800,88,95,120,275,7,155
-1.980309233253330,88,95,70,300,7,230
-1.9803223219171900,78,85,130,425,7,295
-1.9804318684567900,78,85,140,400,7,260
-1.9808351885209300,46,55,160,400,9,240
-1.9808499964892200,46,55,100,425,9,325
-1.98107989521969,78,85,190,425,7,235
-1.9811475418386800,66,75,140,325,9,185
-1.9811688581799400,66,75,110,325,9,215
-1.9814617278017800,62,70,80,325,8,245
-1.9816155762919000,94,100,110,500,6,390
-1.981719513195750,94,100,50,425,6,375
-1.9817716731500500,72,80,140,300,8,160
-1.981782935725420,76,85,50,150,9,100
-1.9818239109559900,98,105,100,475,7,375
-1.981861514999960,78,85,160,300,7,140
-1.9820035931931800,82,90,150,250,8,100
-1.982110536388890,62,70,140,300,8,160
-1.9824237605311600,98,105,110,500,7,390
-1.9825751851780800,82,90,60,250,8,190
-1.9826039126634000,94,100,50,400,6,350
-1.9826886094035500,52,60,90,500,8,410
-1.9828250125033900,46,55,90,450,9,360
-1.9828303331737200,46,55,90,350,9,260
-1.982877885352540,46,55,180,425,9,245
-1.9828889259272900,88,95,150,275,7,125
-1.982899484859430,94,100,190,450,6,260
-1.9829359323371500,94,100,140,500,6,360
-1.9832118466355500,68,75,160,500,7,340
-1.9834663109905600,46,55,120,225,9,105
-1.9834674003608600,62,70,170,250,8,80
-1.9835650234326900,82,90,80,325,8,245
-1.9835826356304000,46,55,200,400,9,200
-1.983654993365040,86,95,80,175,9,95
-1.9837833951605800,78,85,80,475,7,395
-1.984019101102820,78,85,140,250,7,110
-1.9840733790523000,94,100,50,375,6,325
-1.9840933644911000,98,105,70,500,7,430
-1.9841669971474100,46,55,120,400,9,280
-1.9841983938734700,88,95,110,225,7,115
-1.9842924561245900,72,80,60,250,8,190
-1.9843055649189200,46,55,120,425,9,305
-1.9843902283900700,52,60,160,500,8,340
-1.9847250074966600,94,100,160,475,6,315
-1.9847468173663600,72,80,150,275,8,125
-1.9849107893085400,98,105,180,425,7,245
-1.984937916218070,92,100,90,200,8,110
-1.9850201617042600,78,85,150,425,7,275
-1.985030910474320,98,105,170,450,7,280
-1.9851631910249500,78,85,150,350,7,200
-1.9853687576762200,78,85,140,275,7,135
-1.9854935741363500,98,105,130,450,7,320
-1.9856671133080700,72,80,150,250,8,100
-1.9856886483010300,72,80,50,250,8,200
-1.9858069810379900,98,105,100,425,7,325
-1.9858116537945100,82,90,50,225,8,175
-1.9858757189773500,72,80,60,225,8,165
-1.985914604911330,78,85,190,350,7,160
-1.9859810153955600,52,60,100,500,8,400
-1.986036837738740,94,100,170,425,6,255
-1.9860850909126100,98,105,130,475,7,345
-1.9860915107434400,46,55,70,475,9,405
-1.9861464525098400,92,100,180,250,8,70
-1.9865215566276300,46,55,130,225,9,95
-1.9866712232455200,88,95,80,325,7,245
-1.986691083751160,78,85,100,225,7,125
-1.9867986749106600,46,55,50,475,9,425
-1.98697710260373,98,105,50,425,7,375
-1.9871613103169200,88,95,50,225,7,175
-1.9871690046318400,78,85,80,450,7,370
-1.9871788941277400,94,100,130,500,6,370
-1.987309571855450,82,90,160,250,8,90
-1.9873524932425200,62,70,150,275,8,125
-1.9875104840153000,88,95,70,200,7,130
-1.987722570623230,78,85,90,425,7,335
-1.987768566062520,92,100,50,200,8,150
-1.9877718296853700,96,105,100,175,9,75
-1.9879045078413300,82,90,170,250,8,80
-1.9879711132232200,94,100,170,325,6,155
-1.9879716421055500,94,100,170,400,6,230
-1.9881076476866300,62,70,130,275,8,145
-1.9881399080851900,98,105,160,350,7,190
-1.9881864566780800,78,85,80,500,7,420
-1.9882007046466200,46,55,60,400,9,340
-1.988273321199460,56,65,170,225,9,55
-1.9882837823124300,78,85,70,450,7,380
-1.9883027389683900,98,105,160,400,7,240
-1.988528475782910,46,55,60,375,9,315
-1.9886551561569500,76,85,90,175,9,85
-1.988674508184230,78,85,140,375,7,235
-1.9889745471052500,94,100,50,350,6,300
-1.9891158502539800,56,65,180,275,9,95
-1.989234258064430,72,80,60,275,8,215
-1.9892486947119500,78,85,100,400,7,300
-1.9893237762013500,46,55,170,450,9,280
-1.9893389654509000,98,105,120,475,7,355
-1.9894743365452300,62,70,160,225,8,65
-1.9895021931810200,66,75,130,325,9,195
-1.9895646638386500,62,70,60,275,8,215
-1.9896722447621600,66,75,160,225,9,65
-1.9897512740342400,66,75,170,275,9,105
-1.9898622823068700,88,95,170,250,7,80
-1.9898972377090000,94,100,50,450,6,400
-1.9900005910192300,96,105,50,150,9,100
-1.9900435653924800,88,95,140,300,7,160
-1.9900597247514700,82,90,60,225,8,165
-1.9900876386747500,46,55,90,400,9,310
-1.9901344689016600,86,95,110,175,9,65
-1.9902135093139500,72,80,130,300,8,170
-1.99021626802009,78,85,160,450,7,290
-1.990278575273600,78,85,190,375,7,185
-1.9904303265920800,82,90,70,300,8,230
-1.9907446110792000,82,90,120,325,8,205
-1.9907469725080700,78,85,140,475,7,335
-1.9907531642235800,72,80,70,200,8,130
-1.9908385140447200,46,55,140,400,9,260
-1.9908474701206100,78,85,70,425,7,355
-1.9908983611706100,46,55,110,450,9,340
-1.9909011201063300,88,95,120,325,7,205
-1.991024817006350,98,105,150,400,7,250
-1.9911549466031100,98,105,180,450,7,270
-1.991264653118400,82,90,70,200,8,130
-1.9912664044155400,98,105,50,500,7,450
-1.9913541439688000,68,75,100,500,7,400
-1.9913929568704400,88,95,60,250,7,190
-1.991480018040690,98,105,50,375,7,325
-1.9915132171598700,82,90,130,275,8,145
-1.9915637848039200,62,70,80,300,8,220
-1.991883848430940,78,85,200,375,7,175
-1.991914709543060,94,100,160,350,6,190
-1.9919364962391400,46,55,200,425,9,225
-1.992116129401470,68,75,90,500,7,410
-1.992131378581790,46,55,150,400,9,250
-1.9921688721376400,88,95,50,250,7,200
-1.9922046602132200,82,90,50,250,8,200
-1.992337114982630,88,95,50,325,7,275
-1.9929018803092700,98,105,200,400,7,200
-1.9929316771934700,72,80,130,275,8,145
-1.993091663277600,72,80,160,250,8,90
-1.9930918509359400,82,90,60,275,8,215
-1.993131713872160,94,100,70,500,6,430
-1.9933259281873200,82,90,130,300,8,170
-1.9933887852589500,94,100,50,500,6,450
-1.9933896985948800,98,105,170,325,7,155
-1.9934482545639400,72,80,80,300,8,220
-1.9934650545265300,78,85,80,375,7,295
-1.9935207480580300,72,80,170,250,8,80
-1.9939454833987700,82,90,170,275,8,105
-1.9939862012645100,78,85,180,350,7,170
-1.9940189792185900,46,55,140,450,9,310
-1.994028219231790,46,55,70,375,9,305
-1.994133411320870,52,60,170,500,8,330
-1.9941798722717100,56,65,150,200,9,50
-1.9942141406474600,46,55,150,475,9,325
-1.994319545509910,78,85,120,250,7,130
-1.9945612487007100,94,100,130,475,6,345
-1.9946328597243600,88,95,130,275,7,145
-1.9947037609431600,46,55,150,450,9,300
-1.9947167940064900,62,70,130,300,8,170
-1.9947637410132700,62,70,120,325,8,205
-1.9947694791553400,98,105,50,350,7,300
-1.9949000731993800,78,85,170,300,7,130
-1.995042727767820,78,85,130,250,7,120
-1.9950529087092600,56,65,200,275,9,75
-1.9953123364186000,62,70,150,250,8,100
-1.9953353970209600,78,85,90,375,7,285
-1.9953517417666800,92,100,180,225,8,45
-1.995451073307820,98,105,110,475,7,365
-1.99549306413854,78,85,180,325,7,145
-1.9956542421191700,94,100,170,375,6,205
-1.9956993495977700,78,85,160,375,7,215
-1.996067621214480,46,55,180,375,9,195
-1.996091266312530,88,95,60,275,7,215
-1.9962528670338600,88,95,60,225,7,165
-1.9963423111258800,52,60,100,450,8,350
-1.9964347428759100,62,70,170,275,8,105
-1.9965137279397300,98,105,60,400,7,340
-1.996591960262740,46,55,160,300,9,140
-1.9968860399817300,46,55,100,225,9,125
-1.9969898803766600,78,85,90,225,7,135
-1.99710274269724,46,55,70,450,9,380
-1.997180716069150,98,105,120,400,7,280
-1.9972152900961500,78,85,60,500,7,440
-1.9973380408548900,46,55,130,375,9,245
-1.9973852091001200,94,100,70,225,6,155
-1.9977912530062900,78,85,50,275,7,225
-1.9980596341324600,82,90,140,325,8,185
-1.9981182606323300,46,55,150,425,9,275
-1.9983026729921200,56,65,120,300,9,180
-1.9983832731414900,78,85,150,225,7,75
-1.9983929988876700,68,75,170,500,7,330
-1.998415808177870,98,105,150,475,7,325
-1.9984229610271800,94,100,120,475,6,355
-1.9988113651264200,62,70,160,250,8,90
-1.9988657963047800,46,55,190,350,9,160
-1.998977506994410,98,105,50,400,7,350
-1.9990012003473400,82,90,80,300,8,220
-1.9990393157426900,92,100,100,200,8,100
-1.9990462970445100,46,55,130,425,9,295
-1.999135135529730,98,105,50,450,7,400
-1.9994780769801300,46,55,200,300,9,100
-1.9996142186941800,78,85,80,350,7,270
-1.9996980785536300,78,85,200,350,7,150
-1.9997882590289100,94,100,180,450,6,270
-1.999842351128370,56,65,80,200,9,120
-1.9998840489147500,98,105,130,400,7,270
-1.9999397354778700,46,55,140,375,9,235
-1.9999969686135200,46,55,80,375,9,295
-2.000070790769510,46,55,140,425,9,285
-2.000079294917630,98,105,70,450,7,380
-2.000082482986510,68,75,200,450,7,250
-2.0001573528192300,92,100,50,175,8,125
-2.0001630699777900,62,70,110,325,8,215
-2.0001671587453900,98,105,80,250,7,170
-2.000188701535620,46,55,180,400,9,220
-2.0002008015205900,52,60,110,500,8,390
-2.0003897452164200,98,105,60,425,7,365
-2.0005901339978800,46,55,150,350,9,200
-2.000659700185840,94,100,100,425,6,325
-2.0009073038627300,68,75,170,475,7,305
-2.0010066596234600,78,85,100,275,7,175
-2.0010362951325000,94,100,130,450,6,320
-2.0012151450382900,94,100,160,400,6,240
-2.0012459591725200,52,60,200,450,8,250
-2.0013513711516200,98,105,140,450,7,310
-2.0013776507534200,98,105,70,475,7,405
-2.0014790762432500,98,105,190,375,7,185
-2.0016007699673400,78,85,80,425,7,345
-2.001616787555840,52,60,170,350,8,180
-2.001646309261690,78,85,100,250,7,150
-2.00165713787341,98,105,90,450,7,360
-2.0017173397330800,94,100,90,450,6,360
-2.0018033344110000,82,90,110,325,8,215
-2.0018341910924000,46,55,80,500,9,420
-2.001864450985980,46,55,150,325,9,175
-2.001889780575800,78,85,60,475,7,415
-2.0020606569579000,46,55,80,475,9,395
-2.002219669982490,94,100,200,425,6,225
-2.002240969607100,78,85,140,350,7,210
-2.0023170602230900,46,55,150,225,9,75
-2.0023992599207100,46,55,130,250,9,120
-2.0024824169627000,88,95,150,250,7,100
-2.0026239185447700,98,105,90,400,7,310
-2.0027489746696100,46,55,190,400,9,210
-2.002852876380350,88,95,130,300,7,170
-2.0028653797550200,88,95,110,325,7,215
-2.00303314078663,94,100,150,450,6,300
-2.003065256262240,98,105,180,400,7,220
-2.003068738576080,94,100,200,400,6,200
-2.003149603357190,52,60,90,475,8,385
-2.003194366213630,78,85,90,300,7,210
-2.003197363125740,94,100,110,475,6,365
-2.0032349043131300,78,85,80,275,7,195
-2.0033214528379300,78,85,60,300,7,240
-2.003344681591050,98,105,200,425,7,225
-2.003426920830210,76,85,100,175,9,75
-2.0035137843938400,72,80,170,275,8,105
-2.0036488274169000,94,100,170,450,6,280
-2.0036560088222800,98,105,60,350,7,290
-2.003880043024740,46,55,70,425,9,355
-2.003904962978440,46,55,170,300,9,130
-2.004034551833000,68,75,100,450,7,350
-2.004136211145990,46,55,90,425,9,335
-2.0042957012157900,98,105,150,450,7,300
-2.004422630579330,46,55,80,450,9,370
-2.0044486467089300,66,75,170,225,9,55
-2.0044763153509600,78,85,190,325,7,135
-2.004480361554080,52,60,150,500,8,350
-2.0045738267648500,46,55,110,425,9,315
-2.004581707308540,98,105,160,300,7,140
-2.004835242600340,96,105,170,200,9,30
-2.004836435379840,62,70,130,325,8,195
-2.0048583518283600,98,105,150,425,7,275
-2.004951548741270,72,80,140,325,8,185
-2.0049670625794400,62,70,140,325,8,185
-2.005038415466900,46,55,200,350,9,150
-2.005070618866740,72,80,120,325,8,205
-2.005122917345650,82,90,130,325,8,195
-2.0052537736592900,68,75,170,350,7,180
-2.005518912640190,76,85,170,200,9,30
-2.0055989408931100,78,85,70,350,7,280
-2.005708617783460,46,55,140,250,9,110
-2.005767718731440,46,55,190,425,9,235
-2.005795110929260,92,100,160,200,8,40
-2.0058334953683300,78,85,110,400,7,290
-2.005865487249840,94,100,150,425,6,275
-2.005927792515470,98,105,130,375,7,245
-2.006058773057190,78,85,140,225,7,85
-2.0061849657711800,78,85,120,375,7,255
-2.0062189568792900,98,105,190,400,7,210
-2.006241286463460,98,105,120,425,7,305
-2.0062911835095300,52,60,80,250,8,170
-2.0063072985350900,68,75,150,500,7,350
-2.006348494086640,96,105,200,250,9,50
-2.006359524475200,78,85,100,325,7,225
-2.0064121270266000,98,105,80,475,7,395
-2.0064484713650900,98,105,50,475,7,425
-2.0064888041751500,68,75,90,475,7,385
-2.0065496612640300,66,75,120,300,9,180
-2.0066350553071300,94,100,180,425,6,245
-2.0067878928826900,66,75,80,200,9,120
-2.007130601934150,98,105,180,375,7,195
-2.0071646078257300,98,105,140,400,7,260
-2.0071968334025600,88,95,130,325,7,195
-2.007228379831040,46,55,100,400,9,300
-2.007291994257990,78,85,80,225,7,145
-2.007396075058700,46,55,100,250,9,150
-2.0074113644717600,78,85,70,275,7,205
-2.0075472373179400,98,105,130,425,7,295
-2.007789519108360,98,105,140,425,7,285
-2.0078482685178400,46,55,140,275,9,135
-2.007857122400620,94,100,80,250,6,170
-2.0081173012507400,98,105,160,325,7,165
-2.008167736702290,94,100,130,400,6,270
-2.008177334822060,52,60,50,375,8,325
-2.0083625819107400,46,55,190,375,9,185
-2.008474076753390,78,85,200,325,7,125
-2.008503142918070,94,100,120,225,6,105
-2.0085048641490800,78,85,70,250,7,180
-2.0085260972317600,66,75,150,200,9,50
-2.0086949831738400,68,75,120,500,7,380
-2.009035159125840,94,100,90,250,6,160
-2.0090589601186200,98,105,160,450,7,290
-2.0091059985919800,94,100,80,500,6,420
-2.0091092113869700,98,105,60,325,7,265
-2.009110939273500,72,80,110,325,8,215
-2.0091262433348100,94,100,50,475,6,425
-2.009184471971370,46,55,50,275,9,225
-2.009315585808920,46,55,80,350,9,270
-2.009359700719010,46,55,180,325,9,145
-2.009422467087400,94,100,70,475,6,405
-2.009432597745940,66,75,180,275,9,95
-2.009509195221720,88,95,80,300,7,220
-2.009656782737540,58,65,200,500,7,300
-2.009799707202450,88,95,160,250,7,90
-2.0100262052844000,98,105,140,475,7,335
-2.0100588167557300,94,100,110,450,6,340
-2.0101179410426200,46,55,90,225,9,135
-2.0102211383676300,78,85,90,275,7,185
-2.0102815050762500,78,85,60,450,7,390
-2.0103123008082400,46,55,90,375,9,285
-2.010382363833890,76,85,60,150,9,90
-2.0104309549399400,52,60,50,350,8,300
-2.010466301871930,88,95,140,325,7,185
-2.0105135510122800,98,105,60,375,7,315
-2.010529726483940,94,100,150,400,6,250
-2.010687933706290,94,100,120,400,6,280
-2.0108189296444200,98,105,110,450,7,340
-2.0108658186785400,86,95,90,175,9,85
-2.0108994147515500,94,100,140,400,6,260
-2.0112288467723400,68,75,50,375,7,325
-2.011403465673770,72,80,160,225,8,65
-2.0114405362217500,98,105,90,250,7,160
-2.0115500545630400,46,55,70,250,9,180
-2.011598870233760,52,60,160,425,8,265
-2.0116050218392600,94,100,150,475,6,325
-2.01184289904438,62,70,170,225,8,55
-2.0119127249200400,98,105,80,500,7,420
-2.011955554402400,98,105,110,425,7,315
-2.01196244407834,94,100,60,350,6,290
-2.0119626074201200,94,100,130,425,6,295
-2.0120626009601800,78,85,180,300,7,120
-2.0122014251169100,94,100,140,450,6,310
-2.012350289138750,94,100,70,450,6,380
-2.0123677406624000,98,105,190,425,7,235
-2.0124345023272700,46,55,140,475,9,335
-2.012516899280930,96,105,190,225,9,35
-2.0125292181052900,52,60,120,500,8,380
-2.012610353680880,94,100,60,400,6,340
-2.0126931392614100,98,105,170,300,7,130
-2.012693785302930,98,105,100,400,7,300
-2.0127191383247500,94,100,70,375,6,305
-2.012760414785700,78,85,110,250,7,140
-2.0130864339972000,98,105,200,300,7,100
-2.0133089293901500,72,80,130,325,8,195
-2.013314495340720,98,105,70,375,7,305
-2.013398624024580,52,60,50,425,8,375
-2.0135551034088800,92,100,130,200,8,70
-2.013616478893040,94,100,90,400,6,310
-2.0136847845681800,52,60,50,400,8,350
-2.013722068031670,96,105,120,175,9,55
-2.0137573269622700,98,105,70,425,7,355
-2.0139178088193500,68,75,100,475,7,375
-2.013996018382510,98,105,70,225,7,155
-2.014025929375200,46,55,120,250,9,130
-2.0140675966674400,52,60,180,475,8,295
-2.014074774339890,46,55,200,375,9,175
-2.014115546579270,98,105,150,325,7,175
-2.014247992891330,78,85,120,275,7,155
-2.014335453834060,68,75,160,425,7,265
-2.0144006320260600,78,85,110,350,7,240
-2.0146221630928600,52,60,170,375,8,205
-2.0149234065186900,46,55,80,225,9,145
-2.014932677761250,52,60,100,475,8,375
-2.0149650541132000,98,105,200,350,7,150
-2.0150878445163700,94,100,80,475,6,395
-2.015090018655530,98,105,150,350,7,200
-2.01510129846912,46,55,60,475,9,415
-2.015139178484180,94,100,60,375,6,315
-2.0151456905727000,98,105,190,350,7,160
-2.015236215100060,94,100,180,400,6,220
-2.0153145343811,68,75,130,500,7,370
-2.0153951237638100,52,60,170,400,8,230
-2.0154248657042600,94,100,120,425,6,305
-2.015457165796520,46,55,70,275,9,205
-2.0156059597817300,36,45,200,500,9,300
-2.0156070832582300,46,55,80,275,9,195
-2.015652217870550,78,85,80,400,7,320
-2.015714624553390,98,105,80,450,7,370
-2.0160168355994000,78,85,120,350,7,230
-2.0160653768822500,52,60,70,225,8,155
-2.0161068949662200,46,55,60,300,9,240
-2.01619338113819,68,75,180,475,7,295
-2.016296618103940,56,65,60,200,9,140
-2.0165248950928900,94,100,60,325,6,265
-2.0165485572567400,46,55,190,325,9,135
-2.016671521647770,92,100,120,200,8,80
-2.016714056814250,98,105,60,475,7,415
-2.016739506224770,52,60,170,475,8,305
-2.016803843411880,68,75,50,425,7,375
-2.016870592177360,68,75,170,400,7,230
-2.017064619580310,52,60,190,450,8,260
-2.0170782783973200,68,75,140,500,7,360
-2.0171988451528100,56,65,50,175,9,125
-2.017969966672350,94,100,180,375,6,195
-2.0180183001806,78,85,70,400,7,330
-2.018107048045390,46,55,160,450,9,290
-2.0183458113408600,98,105,80,375,7,295
-2.018354100681630,98,105,120,225,7,105
-2.018444186936690,98,105,90,425,7,335
-2.018462042514810,94,100,140,425,6,285
-2.018481035585260,56,65,180,225,9,45
-2.018486512557680,92,100,60,175,8,115
-2.018727511462030,82,90,120,300,8,180
-2.018775428518500,46,55,160,375,9,215
-2.0188012688317400,98,105,130,225,7,95
-2.018853210304290,46,55,180,350,9,170
-2.018868674191230,74,80,200,500,6,300
-2.019069141043310,52,60,130,225,8,95
-2.0191459273028000,98,105,180,350,7,170
-2.0192406611394300,68,75,190,450,7,260
-2.0193676573078200,56,65,190,275,9,85
-2.0194140854465100,94,100,160,450,6,290
-2.0196523666393200,46,55,90,300,9,210
-2.0197878859718200,78,85,50,225,7,175
-2.0198300204336800,94,100,190,400,6,210
-2.0198614940478100,52,60,140,500,8,360
-2.0199506487204400,88,95,170,275,7,105
-2.0200088850899600,78,85,100,375,7,275
-2.0200835393200100,78,85,160,275,7,115
-2.0202905799455400,82,90,160,225,8,65
-2.0203299355762000,46,55,60,500,9,440
-2.020369455161660,94,100,160,325,6,165
-2.020592622048690,78,85,90,325,7,235
-2.0207008413573500,98,105,140,375,7,235
-2.0208350052966100,68,75,120,475,7,355
-2.020889648374010,46,55,110,400,9,290
-2.0210501717021200,68,75,170,375,7,205
-2.0210575826175500,56,65,110,200,9,90
-2.021275191553760,52,60,170,325,8,155
-2.0213296104822600,46,55,140,350,9,210
-2.021340002809700,76,85,200,250,9,50
-2.0214535628883700,78,85,100,350,7,250
-2.02153604694718,94,100,130,375,6,245
-2.02161428281399,46,55,90,275,9,185
-2.021672556439240,94,100,150,350,6,200
-2.021715542693230,68,75,50,350,7,300
-2.0218177998297500,98,105,160,375,7,215
-2.022097657067090,56,65,180,250,9,70
-2.022213417691250,68,75,110,500,7,390
-2.022249985925780,94,100,140,475,6,335
-2.02236336737587,78,85,50,300,7,250
-2.0224322358214800,78,85,190,300,7,110
-2.022578626986140,94,100,80,450,6,370
-2.022625317629640,52,60,50,500,8,450
-2.022721628579900,46,55,70,350,9,280
-2.023174836802880,68,75,160,350,7,190
-2.023259178834120,98,105,90,350,7,260
-2.023334267060980,92,100,70,175,8,105
-2.0233619577729,66,75,200,275,9,75
-2.023417935673400,94,100,140,250,6,110
-2.0234378112501300,46,55,140,225,9,85
-2.023517218121390,68,75,160,475,7,315
-2.02366947905048,46,55,80,425,9,345
-2.0238844799177500,52,60,90,250,8,160
-2.0240542624909400,52,60,130,500,8,370
-2.024174830933750,78,85,100,300,7,200
-2.0242336064262400,66,75,110,200,9,90
-2.024271319985970,56,65,50,200,9,150
-2.0243690615848900,46,55,100,300,9,200
-2.024376717068960,94,100,130,225,6,95
-2.024434760542230,88,95,160,225,7,65
-2.024472279143840,52,60,160,475,8,315
-2.0245503170957600,68,75,60,425,7,365
-2.024730852242460,86,95,50,150,9,100
-2.024770064986690,94,100,90,350,6,260
-2.0247744932037100,98,105,190,325,7,135
-2.024805702013280,68,75,80,250,7,170
-2.024817344056860,52,60,60,425,8,365
-2.0248419608139100,94,100,110,425,6,315
-2.024845159679790,68,75,90,450,7,360
-2.0248672257253500,98,105,200,375,7,175
-2.0249198244649200,68,75,50,500,7,450
-2.024956114852310,56,65,160,200,9,40
-2.0253119544998200,68,75,130,475,7,345
-2.025389668809190,78,85,110,275,7,165
-2.0256307559979100,62,70,120,300,8,180
-2.0256707172745500,82,90,180,275,8,95
-2.025694791432610,74,80,200,475,6,275
-2.0257709349017200,62,70,150,200,8,50
-2.025827691710330,96,105,60,150,9,90
-2.0258777911350500,68,75,50,400,7,350
-2.025909258812070,78,85,150,300,7,150
-2.0259633716299000,56,65,90,200,9,110
-2.0260741857690300,94,100,190,350,6,160
-2.026092313561740,94,100,180,350,6,170
-2.02611212414369,52,60,160,400,8,240
-2.0261941714902100,68,75,90,250,7,160
-2.0262525026903700,94,100,80,375,6,295
-2.0262855572774000,52,60,130,475,8,345
-2.026393089065800,94,100,200,300,6,100
-2.026469012610650,46,55,200,325,9,125
-2.0265699497950000,98,105,60,500,7,440
-2.0266381532965500,52,60,50,450,8,400
-2.02670169279678,94,100,190,425,6,235
-2.0267094370672200,78,85,110,375,7,265
-2.026727830519320,98,105,180,325,7,145
-2.026747741984620,52,60,70,500,8,430
-2.0268810274249800,52,60,160,325,8,165
-2.02695244348033,94,100,130,250,6,120
-2.027053377575290,94,100,160,375,6,215
-2.027059771733990,52,60,110,475,8,365
-2.027091393167020,98,105,80,225,7,145
-2.0272789967002000,94,100,200,350,6,150
-2.0272812386651000,98,105,130,250,7,120
-2.0273553757184300,94,100,200,375,6,175
-2.027504907738360,68,75,170,325,7,155
-2.027527392499860,66,75,190,275,9,85
-2.027596610070780,78,85,70,325,7,255
-2.02772082921006,46,55,100,275,9,175
-2.0279286670494100,94,100,160,300,6,140
-2.0284359906733500,94,100,70,425,6,355
-2.0284686540705300,68,75,180,425,7,245
-2.028556799764310,52,60,100,425,8,325
-2.0285979324525600,92,100,140,200,8,60
-2.028603535452370,88,95,120,300,7,180
-2.0286084977404800,58,65,200,475,7,275
-2.0286299206990100,68,75,70,225,7,155
-2.0286653867779000,68,75,110,475,7,365
-2.028763561110700,98,105,140,350,7,210
-2.0288964055875200,78,85,110,225,7,115
-2.0289781900291300,52,60,60,325,8,265
-2.029156138082960,78,85,130,350,7,220
-2.0291809247600800,72,80,180,275,8,95
-2.0292282479485800,76,85,190,225,9,35
-2.0293205814651400,88,95,80,200,7,120
-2.0294243781479300,62,70,80,200,8,120
-2.029552660189580,68,75,140,450,7,310
-2.0296143327222500,74,80,190,500,6,310
-2.0296674302740900,52,60,50,475,8,425
-2.029776623109010,52,60,160,350,8,190
-2.0298405784553500,98,105,120,350,7,230
-2.0300983537061800,98,105,180,300,7,120
-2.0301292078536300,52,60,120,425,8,305
-2.0304907355292900,72,80,120,300,8,180
-2.030491825181460,68,75,50,450,7,400
-2.030556651540090,68,75,70,500,7,430
-2.030618863240430,52,60,130,450,8,320
-2.0308486170869000,72,80,80,200,8,120
-2.0310353012446600,98,105,80,425,7,345
-2.031156380969910,78,85,150,375,7,225
-2.031225325871700,46,55,120,350,9,230
-2.03131316285256,98,105,140,250,7,110
-2.0313663872702600,94,100,60,475,6,415
-2.0313887686119000,78,85,140,300,7,160
-2.031398054222170,46,55,110,250,9,140
-2.031405726406390,46,55,190,300,9,110
-2.0314513029250200,86,95,100,175,9,75
-2.0314597134424800,98,105,80,350,7,270
-2.0315605899658000,98,105,90,375,7,285
-2.0316633809999400,88,95,180,275,7,95
-2.031669016450990,98,105,110,400,7,290
-2.0318869972886600,94,100,190,375,6,185
-2.0319222526827100,66,75,180,225,9,45
-2.0320380588302300,68,75,120,425,7,305
-2.032083107518850,94,100,100,400,6,300
-2.032123607682910,62,70,180,275,8,95
-2.032172293563320,46,55,60,450,9,390
-2.0321853602703500,98,105,70,275,7,205
-2.0321873322177200,72,80,170,225,8,55
-2.0323511903857300,52,60,120,225,8,105
-2.032487600046720,94,100,170,300,6,130
-2.0326003236885500,46,55,100,375,9,275
-2.032750673188090,52,60,130,400,8,270
-2.032779873851400,52,60,120,475,8,355
-2.0330762699244400,52,60,180,425,8,245
-2.0331003948078000,68,75,170,425,7,255
-2.0331213660800500,58,65,190,500,7,310
-2.033294669939670,46,55,100,325,9,225
-2.0333766405030400,52,60,170,425,8,255
-2.033443611819860,78,85,80,325,7,245
-2.033548647245770,46,55,80,400,9,320
-2.0335771671377500,94,100,150,325,6,175
-2.0337089984082600,94,100,140,375,6,235
-2.033781718714010,94,100,90,375,6,285
-2.0339328964280100,66,75,60,200,9,140
-2.033956768255110,66,75,90,200,9,110
-2.03402433155713,62,70,200,275,8,75
-2.034097366608220,52,60,60,375,8,315
-2.0341370651112900,52,60,60,350,8,290
-2.0341553457074900,52,60,150,400,8,250
-2.0341885420320800,78,85,50,325,7,275
-2.034253956046830,68,75,130,450,7,320
-2.0342973279285300,46,55,180,300,9,120
-2.034297635265140,66,75,50,200,9,150
-2.034447962397790,82,90,80,200,8,120
-2.0345108081057500,68,75,160,400,7,240
-2.034608422387420,52,60,90,400,8,310
-2.034704808575510,68,75,100,425,7,325
-2.0347057600506100,58,65,190,475,7,285
-2.034719208634060,78,85,60,225,7,165
-2.034912728892250,68,75,170,450,7,280
-2.0349800221261,72,80,200,275,8,75
-2.0349921195754900,94,100,60,500,6,440
-2.0351105534861600,94,100,90,425,6,335
-2.0351968214682700,78,85,60,250,7,190
-2.03529038204621,68,75,130,225,7,95
-2.035404159598460,94,100,80,425,6,345
-2.0354186193126900,94,100,140,275,6,135
-2.035534088923930,46,55,120,275,9,155
-2.03555910961781,68,75,60,325,7,265
-2.035568800899520,46,55,90,325,9,235
-2.0355817410572800,98,105,80,275,7,195
-2.035591417543690,52,60,70,375,8,305
-2.0357274055944500,68,75,150,400,7,250
-2.035738408035650,46,55,50,300,9,250
-2.0359458399160600,94,100,80,350,6,270
-2.036012146089350,68,75,60,350,7,290
-2.0360216373799800,96,105,70,150,9,80
-2.036095573114940,62,70,60,200,8,140
-2.0361384561969800,98,105,140,275,7,135
-2.0361437144518100,46,55,130,350,9,220
-2.036160975939270,46,55,120,375,9,255
-2.036171003123140,78,85,50,250,7,200
-2.036245850428160,94,100,80,275,6,195
-2.036343828472810,82,90,180,250,8,70
-2.0363571874383100,78,85,150,275,7,125
-2.036921004080350,46,55,110,225,9,115
-2.03699949554154,98,105,120,375,7,255
-2.0371837909342900,68,75,130,400,7,270
-2.037235328882850,98,105,90,225,7,135
-2.0373746449501200,78,85,110,300,7,190
-2.0373991716110500,74,80,190,475,6,285
-2.0375130066447000,94,100,70,250,6,180
-2.0377078604614300,86,95,170,200,9,30
-2.037751753640880,68,75,120,400,7,280
-2.0378237960770800,94,100,180,325,6,145
-2.037869689434730,98,105,100,225,7,125
-2.038182154204210,98,105,100,250,7,150
-2.0382167163860900,72,80,150,200,8,50
-2.0382655884958600,52,60,180,450,8,270
-2.038322182951900,78,85,70,300,7,230
-2.0384884497459200,94,100,60,450,6,390
-2.038685926690300,94,100,70,275,6,205
-2.038736574765160,94,100,50,275,6,225
-2.0387486763327800,98,105,60,450,7,390
-2.0389623900981900,78,85,170,250,7,80
-2.0390228545148800,46,55,110,275,9,165
-2.0391174129463900,68,75,200,400,7,200
-2.039142768868510,68,75,180,450,7,270
-2.039533458317540,94,100,120,375,6,255
-2.0395753644825600,68,75,50,475,7,425
-2.0396065411626500,82,90,170,225,8,55
-2.0398284358152900,58,65,160,500,7,340
-2.03996405796419,82,90,150,200,8,50
-2.040065570905400,98,105,70,400,7,330
-2.0401410211946200,52,60,90,450,8,360
-2.0401713713237700,78,85,60,275,7,215
-2.040308108714070,94,100,190,325,6,135
-2.040308161888920,66,75,180,250,9,70
-2.040318083249820,68,75,150,450,7,300
-2.040456289695650,98,105,70,250,7,180
-2.040640434827580,94,100,200,325,6,125
-2.0406440539194200,52,60,180,400,8,220
-2.0407854207345900,46,55,70,325,9,255
-2.0411295626085300,94,100,80,225,6,145
-2.0411510617323700,68,75,150,225,7,75
-2.041179926894680,88,95,150,200,7,50
-2.0412862750774600,46,55,70,400,9,330
-2.041295671261350,76,85,120,175,9,55
-2.0413366317154800,52,60,150,475,8,325
-2.0413481477780500,82,90,200,275,8,75
-2.0413509861455800,68,75,160,325,7,165
-2.0415318287760700,98,105,80,400,7,320
-2.041643056136580,86,95,120,175,9,55
-2.041691758577600,98,105,120,250,7,130
-2.0417438697141900,94,100,180,300,6,120
-2.04178470353963,66,75,100,200,9,100
-2.0419761856348400,98,105,90,300,7,210
-2.0420076730731900,78,85,130,300,7,170
-2.0420118245262500,46,55,160,275,9,115
-2.0420395761692300,98,105,150,375,7,225
-2.042047849589160,52,60,200,400,8,200
-2.0421298961409000,62,70,180,225,8,45
-2.042317542128840,86,95,200,250,9,50
-2.042380110718010,46,55,150,300,9,150
-2.042421745277590,94,100,90,300,6,210
-2.042473364113150,68,75,70,475,7,405
-2.0425056959009400,92,100,80,175,8,95
-2.042562434707990,56,65,100,200,9,100
-2.04260390075124,94,100,100,250,6,150
-2.0426486530666300,98,105,140,225,7,85
-2.042932835354760,94,100,120,350,6,230
-2.0429508507098300,94,100,60,300,6,240
-2.0433631132167200,98,105,70,350,7,280
-2.043399197225070,52,60,130,250,8,120
-2.0434036490085000,52,60,70,475,8,405
-2.0434390896265700,46,55,110,350,9,240
-2.0434617412701300,62,70,180,250,8,70
-2.043478656503200,98,105,50,275,7,225
-2.0435554593650200,94,100,140,350,6,210
-2.043658439612170,68,75,60,375,7,315
-2.0437056739788400,68,75,180,400,7,220
-2.043717731824860,98,105,200,325,7,125
-2.0437594011408900,98,105,90,275,7,185
-2.0438512151340200,72,80,180,250,8,70
-2.0438557695265300,98,105,130,350,7,220
-2.0439979536232100,78,85,70,200,7,130
-2.0440715098383200,46,55,100,350,9,250
-2.0441112087120700,94,100,100,225,6,125
-2.044138821644950,94,100,90,225,6,135
-2.044177325123570,72,80,110,200,8,90
-2.044216287251060,68,75,120,225,7,105
-2.0442870117459700,86,95,60,150,9,90
-2.0443289274403100,82,90,90,200,8,110
-2.04437113291027,68,75,90,400,7,310
-2.0444598253132700,56,65,120,200,9,80
-2.0445576401938700,98,105,110,350,7,240
-2.0445868093083800,78,85,130,275,7,145
-2.0447488375246700,94,100,110,400,6,290
-2.044858138291140,52,60,140,450,8,310
-2.044941349965680,52,60,140,400,8,260
-2.0450458275066300,82,90,190,275,8,85
-2.0451748156323600,58,65,180,500,7,320
-2.045442503414560,68,75,200,425,7,225
-2.0454826111688700,68,75,180,375,7,195
-2.045499293954950,98,105,100,375,7,275
-2.0455949002713300,36,45,190,475,9,285
-2.045780672331070,82,90,60,200,8,140
-2.045785134003930,68,75,150,475,7,325
-2.0458011179371800,52,60,60,400,8,340
-2.046299429711190,52,60,190,425,8,235
-2.0463327033785000,46,55,110,375,9,265
-2.046404332853300,68,75,160,300,7,140
-2.0464986678553100,98,105,60,300,7,240
-2.046576479637980,98,105,110,375,7,265
-2.0465782129490900,62,70,110,200,8,90
-2.046791880131090,52,60,200,425,8,225
-2.0469544571261800,68,75,60,400,7,340
-2.0471240576082200,72,80,190,275,8,85
-2.047197595444160,36,45,200,475,9,275
-2.047201641739720,68,75,90,350,7,260
-2.0472618569113200,68,75,200,300,7,100
-2.0472780515115400,88,95,200,275,7,75
-2.0475462031856300,52,60,150,450,8,300
-2.0475688626508700,46,55,140,300,9,160
-2.04771254833723,94,100,90,275,6,185
-2.0477310867964100,98,105,150,300,7,150
-2.0478355879643500,52,60,200,300,8,100
-2.0480794548714400,36,45,190,500,9,310
-2.048083811883620,68,75,80,475,7,395
-2.048095181413750,52,60,170,450,8,280
-2.0481301551794600,52,60,120,400,8,280
-2.048251319716110,52,60,170,300,8,130
-2.04836363418529,68,75,140,400,7,260
-2.0483742940995300,52,60,90,350,8,260
-2.0485963622055100,98,105,100,275,7,175
-2.048677371580170,52,60,160,300,8,140
-2.048705208606090,46,55,80,325,9,245
-2.048728281425220,68,75,70,375,7,305
-2.0489173584443900,94,100,70,350,6,280
-2.0492031349265100,74,80,160,500,6,340
-2.049242999787950,74,80,180,500,6,320
-2.049270225522790,68,75,190,425,7,235
-2.049435177205950,68,75,70,450,7,380
-2.0494653342388700,52,60,70,425,8,355
-2.049517019594020,52,60,150,350,8,200
-2.0496067505268800,52,60,130,425,8,295
-2.0496603981780200,46,55,150,375,9,225
-2.0497438484535300,94,100,80,400,6,320
-2.0498246995155100,52,60,80,500,8,420
-2.0498602437824600,72,80,60,200,8,140
-2.050016027793380,62,70,50,200,8,150
-2.0502182266398700,68,75,150,350,7,200
-2.050333513869160,62,70,190,275,8,85
-2.050457469933170,56,65,70,175,9,105
-2.0504728213002100,52,60,70,450,8,380
-2.050583470866180,68,75,130,425,7,295
-2.0507386375226900,68,75,110,450,7,340
-2.0508500618145400,56,65,60,175,9,115
-2.0510005001095400,90,95,200,500,5,300
-2.051216694668270,94,100,70,400,6,330
-2.0512313547488200,78,85,150,250,7,100
-2.0515546317259600,68,75,140,425,7,285
-2.0515665192251500,88,95,170,225,7,55
-2.0517406815325500,58,65,100,500,7,400
-2.051751770228310,94,100,120,250,6,130
-2.051904555276990,98,105,100,325,7,225
-2.0519702452099200,98,105,120,275,7,155
-2.0521879338428600,52,60,90,300,8,210
-2.0525170316182300,94,100,110,250,6,140
-2.0525455166324100,98,105,150,225,7,75
-2.052598733624190,68,75,130,250,7,120
-2.052627085146020,68,75,80,450,7,370
-2.0526641745533300,84,90,200,500,6,300
-2.052691618465880,46,55,150,275,9,125
-2.052761844927950,68,75,50,275,7,225
-2.052786893075050,52,60,110,450,8,340
-2.0527890672031400,68,75,130,375,7,245
-2.0528710685701300,52,60,80,475,8,395
-2.052977358405710,98,105,110,250,7,140
-2.052980163748200,98,105,190,300,7,110
-2.053025861974040,98,105,90,325,7,235
-2.0533264994091300,52,60,130,375,8,245
-2.053376859219710,96,105,80,150,9,70
-2.053490357508030,94,100,110,350,6,240
-2.053551186333960,46,55,110,300,9,190
-2.0536064988227300,74,80,100,500,6,400
-2.0540886819893600,46,55,60,275,9,215
-2.054132690369300,52,60,80,450,8,370
-2.054199874173030,66,75,50,175,9,125
-2.054451950064150,46,55,50,325,9,275
-2.054480908587950,58,65,90,500,7,410
-2.054535543773360,56,65,130,200,9,70
-2.054705592272840,46,55,60,250,9,190
-2.054879949548100,62,70,50,175,8,125
-2.055207380103900,52,60,100,400,8,300
-2.0552108221513200,46,55,50,225,9,175
-2.05525081413648,68,75,90,225,7,135
-2.055278419691260,58,65,170,500,7,330
-2.055280867499670,52,60,100,225,8,125
-2.0555116661642100,46,55,70,300,9,230
-2.055617550697790,68,75,170,300,7,130
-2.0557969065356700,68,75,100,250,7,150
-2.05584466215974,46,55,70,200,9,130
-2.055874791640680,94,100,100,375,6,275
-2.056070456563250,52,60,190,400,8,210
-2.0563610972060200,94,100,100,275,6,175
-2.0563796017607300,94,100,100,300,6,200
-2.0566253152259100,94,100,150,225,6,75
-2.0567860656527700,52,60,140,425,8,285
-2.0568688495730600,52,60,180,375,8,195
-2.056902495442690,78,85,110,325,7,215
-2.0569808372736700,86,95,190,225,9,35
-2.0570261339710500,98,105,100,350,7,250
-2.057041924795490,78,85,120,325,7,205
-2.0570546690354500,52,60,150,425,8,275
-2.057323207888720,82,90,110,200,8,90
-2.0573882541039100,94,100,100,325,6,225
-2.0574361459507000,98,105,70,325,7,255
-2.0575102065093900,68,75,150,325,7,175
-2.057603503135290,94,100,160,275,6,115
-2.0576652708915200,52,60,90,225,8,135
-2.0578059010993600,88,95,190,275,7,85
-2.057973848909180,68,75,80,500,7,420
-2.058145345319160,72,80,50,200,8,150
-2.058168874423520,98,105,160,275,7,115
-2.0582304074550700,94,100,190,300,6,110
-2.0582423844155600,94,100,150,300,6,150
-2.058450271070750,74,80,90,500,6,410
-2.058462950049840,68,75,80,275,7,195
-2.058616783612750,94,100,110,375,6,265
-2.058665455206260,78,85,160,250,7,90
-2.0587675401316200,90,95,190,500,5,310
-2.058867109456890,78,85,80,300,7,220
-2.0588780814042800,88,95,50,200,7,150
-2.058998789884610,46,55,60,225,9,165
-2.059093329141620,52,60,80,225,8,145
-2.059225513522050,52,60,190,350,8,160
-2.0592959525946000,94,100,140,225,6,85
-2.0593287231085300,94,100,100,350,6,250
-2.0593726590201600,94,100,150,375,6,225
-2.0594207446591200,62,70,90,200,8,110
-2.0594507698984500,52,60,110,425,8,315
-2.0596130260000600,58,65,120,450,7,330
-2.0597186458232500,92,100,110,175,8,65
-2.0598318156501300,72,80,100,200,8,100
-2.0598480670079200,94,100,140,300,6,160
-2.060079417624320,98,105,110,275,7,165
-2.0602157256550200,68,75,110,425,7,315
-2.060237222466520,68,75,190,350,7,160
-2.0603553107385600,98,105,50,300,7,250
-2.0603575083777500,52,60,80,275,8,195
-2.0604985232875700,36,45,180,500,9,320
-2.0607469673554100,52,60,140,375,8,235
-2.0607814770260600,88,95,60,200,7,140
-2.0609183488868200,78,85,140,325,7,185
-2.0609585112626000,52,60,140,250,8,110
-2.061301755445610,52,60,60,300,8,240
-2.061360524462970,66,75,130,200,9,70
-2.061408918277370,68,75,60,300,7,240
-2.061454633178520,68,75,60,475,7,415
-2.0614727825732700,90,95,200,475,5,275
-2.0614785785424600,58,65,170,350,7,180
-2.0614918093010300,88,95,180,250,7,70
-2.0615693251258000,68,75,190,375,7,185
-2.0616003899975100,68,75,150,425,7,275
-2.0617157095422600,66,75,160,200,9,40
-2.061753647255730,74,80,120,450,6,330
-2.0618703891298400,68,75,140,475,7,335
-2.062070637776470,72,80,90,200,8,110
-2.0621030915421500,52,60,140,475,8,335
-2.062120746454290,68,75,190,400,7,210
-2.0622708945908100,88,95,90,200,7,110
-2.0622756501197200,68,75,200,350,7,150
-2.062408440716380,74,80,120,500,6,380
-2.0624280086622000,84,90,200,475,6,275
-2.0625176045473500,52,60,50,275,8,225
-2.0625461810642300,78,85,160,225,7,65
-2.062614387824670,86,95,70,150,9,80
-2.062641084553150,66,75,120,200,9,80
-2.0628369475117000,46,55,50,250,9,200
-2.062981075691950,68,75,100,400,7,300
-2.0630800356627900,94,100,90,325,6,235
-2.0632164779018500,56,65,140,200,9,60
-2.0632240984838000,52,60,180,350,8,170
-2.063513685849910,52,60,90,375,8,285
-2.0637798209126200,52,60,140,275,8,135
-2.0639330044481800,94,100,110,300,6,190
-2.0640468375493100,62,70,100,200,8,100
-2.0640897706292700,68,75,190,325,7,135
-2.0641277813909300,98,105,100,300,7,200
-2.064192720674180,68,75,70,425,7,355
-2.0645444314385400,94,100,130,350,6,220
-2.0650533749556100,52,60,80,375,8,295
-2.065059339752890,52,60,100,250,8,150
-2.0651817876005800,46,55,80,300,9,220
-2.06524565662083,68,75,140,375,7,235
-2.0652957683766000,72,80,180,225,8,45
-2.0653104616619400,94,100,50,300,6,250
-2.065589280077920,98,105,140,300,7,160
-2.065594507618950,74,80,170,350,6,180
-2.0657363309274900,68,75,100,225,7,125
-2.0657789320585100,68,75,140,275,7,135
-2.0658795825453600,94,100,50,325,6,275
-2.065901878480840,98,105,110,225,7,115
-2.0659204437452200,52,60,70,275,8,205
-2.0659644227543400,68,75,200,325,7,125
-2.065982250934040,52,60,150,225,8,75
-2.0660133845611200,74,80,200,450,6,250
-2.0662274048442700,58,65,100,450,7,350
-2.0662795046096900,68,75,90,300,7,210
-2.066306179298780,68,75,180,350,7,170
-2.0667020593840400,68,75,60,500,7,440
-2.066702635390820,92,100,190,250,8,60
-2.0671960260402400,72,80,160,200,8,40
-2.067494571336210,68,75,160,450,7,290
-2.0675928826867100,66,75,60,175,9,115
-2.067704672177170,98,105,110,300,7,190
-2.0677195719951500,52,60,200,350,8,150
-2.0677385705070500,68,75,80,350,7,270
-2.067775135502180,36,45,160,500,9,340
-2.067796401482440,68,75,140,250,7,110
-2.068024608690370,68,75,80,225,7,145
-2.0681323522635300,74,80,170,500,6,330
-2.0682106812489300,88,95,180,225,7,45
-2.0684142413200800,68,75,90,375,7,285
-2.068502151216580,62,70,160,200,8,40
-2.0686727135161100,58,65,200,450,7,250
-2.068683440626420,94,100,120,275,6,155
-2.0687899252123300,52,60,60,475,8,415
-2.0688665822262500,58,65,90,475,7,385
-2.0689275622183500,52,60,90,425,8,335
-2.068957887662560,36,45,120,450,9,330
-2.068967210542150,94,100,110,225,6,115
-2.069039250045050,98,105,80,325,7,245
-2.0690728752138000,84,90,190,500,6,310
-2.0690921976140100,52,60,90,275,8,185
-2.0691353668583100,98,105,60,250,7,190
-2.0692528516315,78,85,130,325,7,195
-2.069301607240940,78,85,170,275,7,105
-2.0694205673291900,52,60,80,350,8,270
-2.069780562469690,52,60,110,400,8,290
-2.069802140914940,36,45,90,500,9,410
-2.0698043010234400,46,55,170,250,9,80
-2.069928831629900,52,60,160,450,8,290
-2.0699336771127800,88,95,110,200,7,90
-2.0699622233791200,92,100,90,175,8,85
-2.069989372394110,72,80,50,175,8,125
-2.070060985632490,68,75,90,425,7,335
-2.070142127197030,68,75,160,375,7,215
-2.0702005094128000,94,100,70,325,6,255
-2.070292289238230,88,95,100,200,7,100
-2.070307241382030,68,75,80,375,7,295
-2.0704245262418100,74,80,100,450,6,350
-2.0705561004614200,68,75,120,350,7,230
-2.0705899659915000,72,80,120,200,8,80
-2.0707524939699200,94,100,80,325,6,245
-2.070983513079180,94,100,60,250,6,190
-2.07101474326396,82,90,50,175,8,125
-2.0710611923634100,52,60,70,250,8,180
-2.0711314038788400,58,65,170,400,7,230
-2.0712571987891300,46,55,130,275,9,145
-2.071274865233140,52,60,150,325,8,175
-2.0713433718561200,58,65,150,500,7,350
-2.071362497645070,52,60,160,375,8,215
-2.0716487379319500,68,75,80,425,7,345
-2.071763953062600,82,90,180,225,8,45
-2.0718182880812100,58,65,170,475,7,305
-2.072056395091120,62,70,130,200,8,70
-2.0721940220551100,98,105,60,225,7,165
-2.0722435097535800,82,90,50,200,8,150
-2.07246344523479,94,100,60,225,6,165
-2.072507211760500,52,60,180,325,8,145
-2.0725369793327100,58,65,90,250,7,160
-2.0728948591001500,98,105,70,300,7,230
-2.0729310392645100,46,55,150,250,9,100
-2.0729867493649400,68,75,180,325,7,145
-2.073229151054600,94,100,110,275,6,165
-2.0733081804139200,66,75,140,200,9,60
-2.073367139595900,46,55,110,325,9,215
-2.0737007578790700,98,105,50,325,7,275
-2.0737726369706000,52,60,200,325,8,125
-2.073885430484820,68,75,100,275,7,175
-2.0739203003269000,52,60,200,375,8,175
-2.073960691878310,52,60,190,325,8,135
-2.074079814020060,68,75,140,225,7,85
-2.0740949302166700,52,60,190,375,8,185
-2.074226768344190,94,100,130,275,6,145
-2.074244708246050,74,80,160,425,6,265
-2.07443444692343,46,55,160,250,9,90
-2.0748236093893200,74,80,190,450,6,260
-2.074931941950810,82,90,100,200,8,100
-2.0750593341933700,52,60,100,375,8,275
-2.075126737313920,36,45,100,500,9,400
-2.075201344016620,74,80,170,400,6,230
-2.075290375092130,68,75,200,375,7,175
-2.0753085728644700,46,55,120,325,9,205
-2.075329454329870,52,60,120,250,8,130
-2.075479088964790,58,65,50,425,7,375
-2.075778365382480,36,45,50,375,9,325
-2.0757804329588600,74,80,150,500,6,350
-2.075803433831730,52,60,180,300,8,120
-2.075888204043900,68,75,180,300,7,120
-2.076027009749900,52,60,140,350,8,210
-2.0760359464504300,98,105,150,275,7,125
-2.076119726074060,68,75,120,250,7,130
-2.0761538048130800,68,75,100,375,7,275
-2.0761764230177800,68,75,90,275,7,185
-2.076623652718580,98,105,170,250,7,80
-2.0766873284819100,90,95,190,475,5,285
-2.076722891115940,74,80,90,475,6,385
-2.0771644451555900,58,65,50,375,7,325
-2.077234563280450,94,100,70,300,6,230
-2.077380848114440,68,75,70,350,7,280
-2.077446246477080,46,55,140,325,9,185
-2.077491662530920,46,55,130,300,9,170
-2.077588524642800,58,65,120,500,7,380
-2.0776757425604700,94,100,60,275,6,215
-2.0777791248626600,84,90,180,500,6,320
-2.077866364232610,52,60,60,500,8,440
-2.077978831140100,52,60,120,350,8,230
-2.0782017794876700,52,60,100,275,8,175
-2.0782125395265600,98,105,120,325,7,205
-2.078245940778460,36,45,90,475,9,385
-2.0784752164781600,56,65,110,175,9,65
-2.0785351258261600,68,75,70,275,7,205
-2.0785699685786800,74,80,170,475,6,305
-2.078571858464750,94,100,150,275,6,125
-2.078636686351280,62,70,60,175,8,115
-2.078642257873590,52,60,140,225,8,85
-2.0787513440150100,46,55,160,225,9,65
-2.0788109035391000,36,45,170,350,9,180
-2.0788362075354200,68,75,110,350,7,240
-2.0788406717588000,68,75,190,300,7,110
-2.0791614751377800,84,90,190,475,6,285
-2.079200949996080,98,105,130,275,7,145
-2.0792090669453600,68,75,100,325,7,225
-2.079272253436040,88,95,50,175,7,125
-2.079280809399980,78,85,170,225,7,55
-2.0792895507703900,72,80,130,200,8,70
-2.0794268315333600,68,75,110,250,7,140
-2.079481355303300,58,65,170,325,7,155
-2.079816261513950,74,80,180,475,6,295
-2.0799497612750500,74,80,100,475,6,375
-2.079979718816790,52,60,80,400,8,320
-2.080167504847350,82,90,130,200,8,70
-2.0801946444520000,84,90,170,475,6,305
-2.0802359700631800,52,60,80,425,8,345
-2.0803499366263900,52,60,70,350,8,280
-2.080554053856090,36,45,200,450,9,250
-2.080691076318720,68,75,140,350,7,210
-2.08081163028363,68,75,70,250,7,180
-2.080823157584670,92,100,100,175,8,75
-2.0810361150394100,98,105,150,250,7,100
-2.0811178860465600,58,65,180,475,7,295
-2.08126176570982,98,105,140,325,7,185
-2.0813176109969500,90,95,160,500,5,340
-2.0813510751634800,76,85,70,150,9,80
-2.08136572005056,86,95,80,150,9,70
-2.0814114840630700,98,105,60,275,7,215
-2.08161167308494,72,80,60,175,8,115
-2.081672611517550,90,95,170,500,5,330
-2.081903337570630,52,60,120,375,8,255
-2.0822725460383500,84,90,160,500,6,340
-2.0823803534983500,68,75,60,450,7,390
-2.0824550840000800,58,65,100,475,7,375
-2.082518701227060,52,60,60,450,8,390
-2.0825760948394700,58,65,130,500,7,370
-2.0826153932976600,74,80,130,500,6,370
-2.082632958828310,52,60,90,325,8,235
-2.0828022147535200,84,90,150,500,6,350
-2.0829189380749000,58,65,160,425,7,265
-2.082992501963590,78,85,180,275,7,95
-2.083116980847080,66,75,70,175,9,105
-2.083421433074850,46,55,130,325,9,195
-2.0836806011718800,98,105,130,300,7,170
-2.083748678589620,94,100,70,200,6,130
-2.0840210985605000,52,60,100,325,8,225
-2.084107391425140,58,65,190,450,7,260
-2.084324361904280,82,90,60,175,8,115
-2.084361568697490,78,85,120,300,7,180
-2.0843873935377800,94,100,50,250,6,200
-2.0844739148498600,36,45,190,450,9,260
-2.084780224721290,98,105,50,250,7,200
-2.0853265030455600,58,65,130,450,7,320
-2.085482391541250,58,65,160,350,7,190
-2.0855349153293100,98,105,70,200,7,130
-2.0856294410634700,36,45,170,500,9,330
-2.0856826568377500,52,60,110,250,8,140
-2.0858379094421200,94,100,50,225,6,175
-2.0858502880769000,98,105,50,225,7,175
-2.0859775552348900,62,70,120,200,8,80
-2.0860345032830400,74,80,180,450,6,270
-2.0861272049784100,52,60,60,225,8,165
-2.086180478654630,36,45,170,475,9,305
-2.086193155869790,74,80,50,375,6,325
-2.0863477480720400,68,75,110,400,7,290
-2.08662540470445,94,100,110,325,6,215
-2.08699127320776,58,65,80,250,7,170
-2.0870254837575000,82,90,120,200,8,80
-2.0870853319308200,52,60,50,225,8,175
-2.0871633716648700,58,65,110,500,7,390
-2.0872303288516800,52,60,50,300,8,250
-2.0872351879353900,58,65,160,400,7,240
-2.0875341666594800,68,75,70,400,7,330
-2.0876838632418600,88,95,60,175,7,115
-2.0878747941059100,58,65,130,400,7,270
-2.0879421053238300,84,90,90,500,6,410
-2.088005993629930,90,95,180,500,5,320
-2.0880345879066900,98,105,80,300,7,220
-2.0880416853784000,36,45,120,500,9,380
-2.088106138909510,36,45,50,350,9,300
-2.0881099405925200,52,60,110,350,8,240
-2.0881104186389300,36,45,100,475,9,375
-2.088370548405240,58,65,140,500,7,360
-2.0884185543958600,74,80,130,475,6,345
-2.0884585592553800,74,80,50,500,6,450
-2.088533371500580,68,75,100,300,7,200
-2.0887490889820700,52,60,130,350,8,220
-2.0888266536932100,74,80,170,375,6,205
-2.088913097847590,84,90,100,500,6,400
-2.0889401380379500,74,80,50,425,6,375
-2.0889763596288200,56,65,80,175,9,95
-2.0890968787904800,78,85,150,200,7,50
-2.0891773632898200,68,75,140,300,7,160
-2.0895314679784500,36,45,50,400,9,350
-2.0895538430043400,68,75,130,350,7,220
-2.08958391094446,36,45,50,425,9,375
-2.0896026163781800,56,65,90,175,9,85
-2.0896449352673800,36,45,140,500,9,360
-2.089731487691180,74,80,110,500,6,390
-2.0897946061420200,36,45,130,500,9,370
-2.0898390040785400,36,45,100,425,9,325
-2.08984408403399,58,65,50,450,7,400
-2.0900737728452700,94,100,130,300,6,170
-2.090079906711040,84,90,170,500,6,330
-2.090117490743240,36,45,150,500,9,350
-2.090133381639970,98,105,160,250,7,90
-2.0901620059152,58,65,50,400,7,350
-2.0901922554577200,96,105,130,175,9,45
-2.090386758797820,74,80,140,500,6,360
-2.0903985461141800,52,60,120,275,8,155
-2.090426090720950,94,100,170,250,6,80
-2.090433575446420,52,60,100,300,8,200
-2.090562122210650,74,80,160,475,6,315
-2.0906259703297300,78,85,80,200,7,120
-2.0906299218672400,58,65,120,225,7,105
-2.0906325422171100,52,60,70,325,8,255
-2.090797572043620,74,80,50,350,6,300
-2.0908148809217900,68,75,50,300,7,250
-2.0911391658344900,52,60,70,400,8,330
-2.091293213303970,68,75,120,275,7,155
-2.0914907309301200,92,100,50,150,8,100
-2.0915012847065400,58,65,50,350,7,300
-2.091769442963010,58,65,120,475,7,355
-2.0917888911343400,94,100,120,325,6,205
-2.0917897339410400,58,65,170,375,7,205
-2.0917993565365700,58,65,110,475,7,365
-2.091813106627820,88,95,120,200,7,80
-2.0918475617233200,74,80,50,450,6,400
-2.0919123506541100,58,65,60,425,7,365
-2.092001387681600,94,100,80,300,6,220
-2.0921678902923500,58,65,50,500,7,450
-2.092406324218310,98,105,110,325,7,215
-2.0924183638722000,74,80,50,400,6,350
-2.092494239259930,36,45,170,400,9,230
-2.092518724199580,74,80,170,425,6,255
-2.0925730715378100,94,100,150,250,6,100
-2.0928886473111000,58,65,160,475,7,315
-2.0929012111864000,52,60,70,200,8,130
-2.0929151668636400,36,45,160,425,9,265
-2.093016395135650,52,60,110,225,8,115
-2.0930797671448300,74,80,130,400,6,270
-2.093187194538240,66,75,110,175,9,65
-2.093203309270170,94,100,140,325,6,185
-2.0933727681232200,68,75,120,375,7,255
-2.0933881313426300,36,45,100,450,9,350
-2.0935532730071900,36,45,180,475,9,295
-2.0935981592961100,68,75,80,400,7,320
-2.093684909829330,68,75,160,275,7,115
-2.0936964888635000,68,75,90,325,7,235
-2.093854191298560,52,60,190,300,8,110
-2.094064232312150,98,105,170,275,7,105
-2.094324855214490,96,105,50,125,9,75
-2.094400135383690,52,60,80,325,8,245
-2.094510286716760,92,100,170,200,8,30
-2.0945818341438700,76,85,80,150,9,70
-2.0946519220842400,88,95,130,200,7,70
-2.094662336048800,98,105,130,325,7,195
-2.0946707726902100,58,65,130,475,7,345
-2.0946912661923300,46,55,80,200,9,120
-2.0947831555135200,68,75,150,375,7,225
-2.0947840831941100,58,65,70,500,7,430
-2.094897326766260,74,80,70,500,6,430
-2.095211538497840,90,95,90,500,5,410
-2.0953252803351700,52,60,160,275,8,115
-2.095440138332250,82,90,160,200,8,40
-2.0955484691211700,74,80,80,250,6,170
-2.0955934387652800,58,65,130,225,7,95
-2.095596136896290,96,105,100,150,9,50
-2.095617784415720,82,90,140,200,8,60
-2.095802285421250,94,100,160,250,6,90
-2.0959044397807400,58,65,70,225,7,155
-2.095905249922240,36,45,70,225,9,155
-2.0962247204641500,84,90,120,450,6,330
-2.096307422735900,74,80,160,400,6,240
-2.0963589404847300,74,80,100,425,6,325
-2.096685561565060,52,60,50,325,8,275
-2.096744472831830,68,75,110,275,7,165
-2.0968789264087300,36,45,170,425,9,255
-2.0969789670594700,46,55,180,275,9,95
-2.0971006417360800,92,100,200,250,8,50
-2.0972910351871700,46,55,170,275,9,105
-2.097363346658080,52,60,140,300,8,160
-2.0975111735610100,68,75,70,325,7,255
-2.0976215939729100,68,75,100,350,7,250
-2.097645463122730,68,75,110,375,7,265
-2.0976721741262800,74,80,130,450,6,320
-2.0976810438932500,58,65,180,425,7,245
-2.097822019470910,74,80,60,425,6,365
-2.0979210264372000,68,75,150,300,7,150
-2.0979245799004700,52,60,150,375,8,225
-2.09800864300486,56,65,190,250,9,60
-2.0980161623808700,68,75,60,250,7,190
-2.0981861134316800,46,55,120,300,9,180
-2.0984177956928100,74,80,120,475,6,355
-2.0984362913115900,52,60,100,350,8,250
-2.0986144391090000,36,45,90,250,9,160
-2.0987265704803400,36,45,80,250,9,170
-2.0987489816315600,62,70,140,200,8,60
-2.0989817821372400,84,90,200,450,6,250
-2.099149838745590,74,80,120,400,6,280
-2.099172747927230,72,80,140,200,8,60
-2.0993108852251400,68,75,50,325,7,275
-2.099354549754940,74,80,160,350,6,190
-2.099724803837010,74,80,140,400,6,260
-2.0997400392903800,46,55,150,200,9,50
-2.099775051546280,52,60,110,375,8,265
-2.0998916927729500,90,95,50,375,5,325
-2.099938939544990,84,90,90,475,6,385
-2.0999888918074300,74,80,160,325,6,165
-2.1000797153408700,94,100,130,325,6,195
-2.1001340316946900,74,80,170,325,6,155
-2.1001959602185300,58,65,170,425,7,255
-2.100282133042230,52,60,110,275,8,165
-2.1003445261768800,58,65,60,350,7,290
-2.1004227945065200,36,45,170,325,9,155
-2.1005532003489900,58,65,90,400,7,310
-2.1006294056668300,90,95,120,450,5,330
-2.100769021989940,78,85,200,275,7,75
-2.1007740546907900,78,85,50,200,7,150
-2.100856750106230,74,80,90,250,6,160
-2.1009924326817100,68,75,50,225,7,175
-2.1012853107566500,72,80,70,175,8,105
-2.1013076125921600,84,90,180,475,6,295
-2.101532918585690,58,65,100,425,7,325
-2.101561075738580,78,85,180,250,7,70
-2.1015920028990500,88,95,140,200,7,60
-2.1017011918340300,74,80,180,425,6,245
-2.1018117401277800,84,90,120,500,6,380
-2.1020314343826700,96,105,140,175,9,35
-2.102154414749720,62,70,70,175,8,105
-2.1022082629359000,36,45,130,450,9,320
-2.102287933641930,90,95,100,500,5,400
-2.1024179930677200,88,95,160,200,7,40
-2.102550720005530,88,95,70,175,7,105
-2.102576446624490,58,65,180,450,7,270
-2.102735842719600,74,80,90,450,6,360
-2.1030851321150300,36,45,120,225,9,105
-2.103301377770030,90,95,90,475,5,385
-2.103454859721210,58,65,90,450,7,360
-2.1035784433687300,78,85,110,200,7,90
-2.1036244710903900,96,105,90,150,9,60
-2.1036897645413,36,45,110,500,9,390
-2.103896648403700,90,95,170,475,5,305
-2.103987867775980,74,80,110,475,6,365
-2.1041103575358800,66,75,80,175,9,95
-2.104140310084170,36,45,60,375,9,315
-2.104203550503900,58,65,60,375,7,315
-2.104288084881560,74,80,200,425,6,225
-2.1042898593825500,74,80,70,225,6,155
-2.104318602222370,52,60,150,300,8,150
-2.1043951649859500,74,80,60,350,6,290
-2.10462329449065,98,105,120,300,7,180
-2.1046944850370600,52,60,60,250,8,190
-2.1047764679973600,58,65,120,400,7,280
-2.104890871377780,68,75,80,325,7,245
-2.1049360997880300,94,100,170,275,6,105
-2.10495337583357,90,95,150,500,5,350
-2.1051995422070400,58,65,160,325,7,165
-2.105231303508590,46,55,170,225,9,55
-2.105655788069870,36,45,130,225,9,95
-2.1056669705568100,36,45,90,400,9,310
-2.1058301848850600,36,45,70,500,9,430
-2.105984817614240,90,95,200,450,5,250
-2.1062882105604700,36,45,120,475,9,355
-2.106462659991590,74,80,150,475,6,325
-2.1067724971428800,74,80,120,225,6,105
-2.106963822439230,58,65,50,475,7,425
-2.1070047240979800,36,45,160,350,9,190
-2.1073709839442200,68,75,110,225,7,115
-2.107450085648500,58,65,80,475,7,395
-2.1075228285464300,98,105,80,200,7,120
-2.10761103594198,76,85,100,150,9,50
-2.1076813969572900,58,65,110,450,7,340
-2.1078349415889200,92,100,60,150,8,90
-2.107863655953,90,95,120,500,5,380
-2.1079934482700700,58,65,70,450,7,380
-2.108205108057020,74,80,200,400,6,200
-2.1082670586549600,68,75,70,300,7,230
-2.1083133501318200,82,90,70,175,8,105
-2.108326018365820,72,80,80,175,8,95
-2.108343654723110,84,90,170,350,6,180
-2.108412709954540,90,95,170,350,5,180
-2.1084499499735100,58,65,200,400,7,200
-2.108640548545470,68,75,60,225,7,165
-2.1087875971497600,58,65,150,400,7,250
-2.108933143480370,74,80,50,475,6,425
-2.1089535795523900,92,100,120,175,8,55
-2.1090332011064700,78,85,60,200,7,140
-2.1092359815292200,66,75,190,250,9,60
-2.1093213578571000,74,80,150,450,6,300
-2.109413336798950,58,65,150,475,7,325
-2.1094425775069300,36,45,60,425,9,365
-2.109688231198350,74,80,130,425,6,295
-2.1097408682663600,84,90,170,400,6,230
-2.10986312968833,98,105,180,275,7,95
-2.1098887083230600,74,80,60,375,6,315
-2.1099026701150100,90,95,170,400,5,230
-2.109994413176280,36,45,170,375,9,205
-2.1100406324894700,74,80,130,225,6,95
-2.1100852718850400,74,80,90,350,6,260
-2.110112220913370,36,45,160,475,9,315
-2.1103640209165800,84,90,100,450,6,350
-2.110427828100330,58,65,170,450,7,280
-2.1105541033576700,52,60,130,300,8,170
-2.110662636072190,92,100,190,225,8,35
-2.1107958400918500,68,75,130,275,7,145
-2.1108588240001900,76,85,50,125,9,75
-2.1110276931068900,58,65,70,475,7,405
-2.1110303744875600,36,45,50,500,9,450
-2.1110697498707300,58,65,140,450,7,310
-2.11151856711934,68,75,70,200,7,130
-2.1115581025521700,52,60,50,250,8,200
-2.111631568702860,36,45,200,400,9,200
-2.111730198608290,94,100,120,300,6,180
-2.111783548715270,58,65,60,325,7,265
-2.111796864037720,58,65,150,450,7,300
-2.111817591903480,74,80,170,450,6,280
-2.1121248594184500,52,60,170,250,8,80
-2.112252805799170,84,90,130,500,6,370
-2.1122536906678600,52,60,150,250,8,100
-2.1124149766888200,84,90,190,450,6,260
-2.1124956555035900,58,65,60,400,7,340
-2.1125268212963900,62,70,80,175,8,95
-2.112645894452220,68,75,150,250,7,100
-2.112651979202830,58,65,160,300,7,140
-2.1126676007970300,84,90,50,400,6,350
-2.1127212245645600,94,100,180,275,6,95
-2.112744510944520,74,80,90,400,6,310
-2.1129507018566800,90,95,140,500,5,360
-2.112992664632010,58,65,180,375,7,195
-2.113022671470680,58,65,180,400,7,220
-2.113121529062510,36,45,50,450,9,400
-2.113176998663310,84,90,170,375,6,205
-2.113180886691410,68,75,110,300,7,190
-2.113185032711270,74,80,150,400,6,250
-2.113239926108360,68,75,60,275,7,215
-2.1133596431550200,84,90,50,350,6,300
-2.1134085581956700,36,45,160,400,9,240
-2.1134777276771500,52,60,110,300,8,190
-2.113546048809580,74,80,120,425,6,305
-2.1137405152993300,74,80,70,375,6,305
-2.1141433939409600,36,45,50,475,9,425
-2.1141467554554900,90,95,160,425,5,265
-2.1142426581126000,74,80,110,450,6,340
-2.1142788318949200,36,45,60,350,9,290
-2.114310823212620,36,45,70,375,9,305
-2.1143122429543200,68,75,150,275,7,125
-2.1143160749103300,98,105,160,225,7,65
-2.1144061803061700,52,60,60,275,8,215
-2.114414429987060,74,80,70,475,6,405
-2.1145006256146500,74,80,140,450,6,310
-2.114505063961820,84,90,100,475,6,375
-2.114562894005370,74,80,140,425,6,285
-2.114890034530190,36,45,60,325,9,265
-2.1149555353921800,58,65,200,425,7,225
-2.114984734942270,58,65,140,425,7,285
-2.1150428428097400,90,95,180,475,5,295
-2.115069785397540,78,85,190,275,7,85
-2.1150879960270900,90,95,50,425,5,375
-2.1151648435168700,52,60,70,300,8,230
-2.1151878514117000,36,45,150,450,9,300
-2.115303397047160,74,80,190,350,6,160
-2.1153981224920200,58,65,80,450,7,370
-2.115481312185390,58,65,140,400,7,260
-2.1154819700784100,52,60,130,275,8,145
-2.1155621725239700,58,65,140,250,7,110
-2.1156342126810000,68,75,170,250,7,80
-2.1157568718626600,82,90,190,250,8,60
-2.116116479860760,84,90,140,500,6,360
-2.1161318834793500,36,45,130,400,9,270
-2.11632849345106,84,90,50,375,6,325
-2.116454338376760,84,90,110,500,6,390
-2.1166146849222200,36,45,110,475,9,365
-2.1166451528483200,52,60,150,275,8,125
-2.116702815873760,52,60,160,225,8,65
-2.1167310705767300,46,55,200,275,9,75
-2.1169965458254900,58,65,120,425,7,305
-2.117366412025330,36,45,90,450,9,360
-2.1175618542152900,58,65,190,350,7,160
-2.1177714694138100,74,80,130,250,6,120
-2.1179166838557500,36,45,180,450,9,270
-2.1179381473168500,74,80,60,400,6,340
-2.117951288156690,58,65,130,425,7,295
-2.117992356989070,36,45,130,475,9,345
-2.1182140557661300,84,90,130,450,6,320
-2.118261538132670,94,100,160,225,6,65
-2.118270411331500,58,65,70,375,7,305
-2.118296217314850,58,65,50,275,7,225
-2.118303099361900,74,80,60,325,6,265
-2.1187754053251400,90,95,50,350,5,300
-2.1187901829896800,74,80,180,400,6,220
-2.1188864113860400,58,65,90,350,7,260
-2.1191240927527900,84,90,160,425,6,265
-2.119124333645730,74,80,80,475,6,395
-2.1192265685254400,96,105,200,225,9,25
-2.1193186762965600,90,95,100,450,5,350
-2.119454619471810,84,90,130,400,6,270
-2.119566058245330,56,65,170,200,9,30
-2.1196561285341900,90,95,50,500,5,450
-2.1196573645563600,36,45,120,425,9,305
-2.1196597129812400,58,65,110,425,7,315
-2.1198021455235200,98,105,190,275,7,85
-2.1199675576367900,84,90,160,475,6,315
-2.120100808910980,90,95,190,450,5,260
-2.1201119299187600,36,45,50,275,9,225
-2.1202723608451400,46,55,190,275,9,85
-2.12045740313062,56,65,50,150,9,100
-2.1204578275678200,98,105,200,275,7,75
-2.120681275091580,82,90,110,175,8,65
-2.1210219351020700,56,65,100,175,9,75
-2.121094978450110,58,65,150,425,7,275
-2.121115669858840,74,80,110,425,6,315
-2.121430242903940,84,90,170,425,6,255
-2.1214609497352100,84,90,100,425,6,325
-2.1215489228527600,58,65,200,300,7,100
-2.121567173695400,68,75,80,300,7,220
-2.121624478263660,74,80,200,300,6,100
-2.121667977426220,36,45,150,400,9,250
-2.121920507842980,58,65,130,375,7,245
-2.12217923841632,82,90,80,175,8,95
-2.1221916746371600,90,95,100,475,5,375
-2.1222400471839700,68,75,50,250,7,200
-2.1222614391214700,90,95,60,425,5,365
-2.12241558752802,74,80,190,425,6,235
-2.1226076172929800,68,75,140,325,7,185
-2.122635714647600,84,90,120,425,6,305
-2.1226531853962800,36,45,130,250,9,120
-2.122721575674450,84,90,160,400,6,240
-2.1228562681453600,58,65,150,350,7,200
-2.1229558718852200,58,65,190,325,7,135
-2.122963091315360,58,65,80,500,7,420
-2.1230852838500200,84,90,50,500,6,450
-2.123115946448150,76,85,200,225,9,25
-2.1231375899468000,72,80,110,175,8,65
-2.123179185935020,90,95,130,500,5,370
-2.123362592070540,74,80,70,450,6,380
-2.123381934643800,58,65,90,425,7,335
-2.1235021622165100,74,80,80,500,6,420
-2.1235752682346100,94,100,80,200,6,120
-2.123600710848640,58,65,180,350,7,170
-2.1236293978665600,84,90,130,475,6,345
-2.123633318390520,84,90,160,350,6,190
-2.1236919563767900,36,45,120,400,9,280
-2.123714898261600,36,45,80,225,9,145
-2.1238737232731600,58,65,190,400,7,210
-2.123888396191780,74,80,190,375,6,185
-2.1238904372915200,52,60,80,300,8,220
-2.1239433013083400,90,95,160,350,5,190
-2.1239795556176300,62,70,110,175,8,65
-2.124048702618860,46,55,110,200,9,90
-2.1241295620029900,74,80,130,375,6,245
-2.124176096606020,74,80,150,350,6,200
-2.1241775405644400,52,60,150,200,8,50
-2.12419629448804,72,80,90,175,8,85
-2.124298780731160,84,90,70,500,6,430
-2.124343138938600,74,80,180,375,6,195
-2.124475858777990,36,45,60,400,9,340
-2.1244923872729500,78,85,120,200,7,80
-2.124615395955590,36,45,180,425,9,245
-2.1246714833788800,58,65,190,425,7,235
-2.124791262746920,88,95,110,175,7,65
-2.1248362453565500,90,95,160,475,5,315
-2.1248376926045300,84,90,170,450,6,280
-2.124893911591310,36,45,130,375,9,245
-2.125039827095270,62,70,90,175,8,85
-2.1253073978231100,76,85,140,175,9,35
-2.1253791563840900,82,90,90,175,8,85
-2.1254544465622900,90,95,170,425,5,255
-2.1255368087991800,78,85,100,200,7,100
-2.1255984566166600,90,95,70,500,5,430
-2.1257033790018500,66,75,170,200,9,30
-2.125771571782850,58,65,140,475,7,335
-2.1257901977674200,58,65,200,350,7,150
-2.1258212267145100,88,95,80,175,7,95
-2.1259030968300200,78,85,90,200,7,110
-2.125911088486940,36,45,160,300,9,140
-2.1259136421357000,36,45,160,325,9,165
-2.126062772995600,66,75,90,175,9,85
-2.1262222354250500,58,65,130,250,7,120
-2.1262505632795900,94,100,60,200,6,140
-2.1264162780343100,36,45,80,475,9,395
-2.126496148205970,74,80,150,425,6,275
-2.1265278990774000,36,45,140,400,9,260
-2.126581313757040,36,45,70,475,9,405
-2.126589795898300,36,45,140,450,9,310
-2.1266917339232400,58,65,80,375,7,295
-2.1267697887166000,72,80,190,250,8,60
-2.1267924620604500,58,65,140,375,7,235
-2.1268593924721300,74,80,190,400,6,210
-2.126866299769830,58,65,100,225,7,125
-2.1269939799084300,84,90,180,450,6,270
-2.1270225761726500,86,95,100,150,9,50
-2.1270300574873700,90,95,110,500,5,390
-2.12715925132065,94,100,180,250,6,70
-2.1273390872434600,76,85,130,175,9,45
-2.127555210114410,58,65,160,375,7,215
-2.127604892114030,84,90,120,475,6,355
-2.1276775897485600,84,90,50,425,6,375
-2.1277387484552200,90,95,120,475,5,355
-2.127894328736500,58,65,90,225,7,135
-2.127983902907790,84,90,110,475,6,365
-2.1281426560402400,88,95,190,250,7,60
-2.1282690141029100,36,45,110,450,9,340
-2.128438436452270,66,75,100,175,9,75
-2.1284644442343400,90,95,170,375,5,205
-2.128527107548890,90,95,50,450,5,400
-2.1287986581740000,74,80,160,300,6,140
-2.128834069085770,74,80,140,250,6,110
-2.129121460835070,84,90,150,350,6,200
-2.129184653751620,74,80,150,325,6,175
-2.129232505773670,84,90,140,450,6,310
-2.129283736606860,36,45,90,350,9,260
-2.129421071549600,36,45,80,450,9,370
-2.129486164070950,90,95,170,325,5,155
-2.129529145115820,36,45,170,300,9,130
-2.129571180245630,58,65,190,375,7,185
-2.1296038703405400,52,60,140,325,8,185
-2.129696898371650,42,50,200,500,8,300
-2.1297318881867500,36,45,170,450,9,280
-2.1297952786202000,74,80,160,450,6,290
-2.1298038494582100,90,95,100,425,5,325
-2.1298898481417100,84,90,200,400,6,200
-2.1299441452383,58,65,100,400,7,300
-2.1299547839609500,84,90,170,325,6,155
-2.129994255400540,58,65,170,300,7,130
-2.1300737340995900,98,105,180,250,7,70
-2.130188888242380,36,45,100,225,9,125
-2.13027735544674,46,55,180,250,9,70
-2.130295739796590,46,55,60,200,9,140
-2.1303125861051400,74,80,80,450,6,370
-2.1303391707367900,74,80,140,475,6,335
-2.1304422354850600,98,105,150,200,7,50
-2.1304486663727200,78,85,180,225,7,45
-2.1304821063896800,68,75,120,325,7,205
-2.130505526605550,36,45,200,425,9,225
-2.1305688796763300,90,95,130,450,5,320
-2.13057399315496,36,45,180,375,9,195
-2.130831221517130,58,65,70,425,7,355
-2.131004679779710,84,90,60,425,6,365
-2.131046984324790,86,95,90,150,9,60
-2.1310892746488100,74,80,90,425,6,335
-2.131100383781140,36,45,90,300,9,210
-2.1311499855595600,74,80,200,350,6,150
-2.131194307469750,84,90,90,250,6,160
-2.131276535876670,90,95,50,400,5,350
-2.131372144689200,58,65,60,500,7,440
-2.1315142684468700,74,80,90,225,6,135
-2.131661260758900,52,60,110,325,8,215
-2.1317101439728900,58,65,180,325,7,145
-2.1318280859426200,74,80,60,300,6,240
-2.131834501394140,96,105,110,150,9,40
-2.1318980255730800,46,55,90,200,9,110
-2.131946688722700,74,80,170,300,6,130
-2.1319607838372000,78,85,160,200,7,40
-2.1319757652794700,84,90,180,425,6,245
-2.1320433615865000,90,95,180,450,5,270
-2.132101726986130,66,75,50,150,9,100
-2.1321143364408000,74,80,140,375,6,235
-2.1321456359240800,68,75,160,250,7,90
-2.1321622360644400,84,90,150,450,6,300
-2.132225482750660,36,45,180,400,9,220
-2.1324023704384800,74,80,80,350,6,270
-2.132408016726330,74,80,80,375,6,295
-2.1324218135641300,74,80,150,225,6,75
-2.1324297081949000,84,90,70,475,6,405
-2.132506628751730,78,85,50,175,7,125
-2.132649445571000,84,90,150,475,6,325
-2.1326630300061000,68,75,130,325,7,195
-2.1326804831362700,84,90,90,450,6,360
-2.1326934449525800,90,95,130,475,5,345
-2.132713807093510,58,65,140,225,7,85
-2.132762281434970,90,95,70,225,5,155
-2.133046105785480,36,45,150,475,9,325
-2.1331675874632800,68,75,160,225,7,65
-2.1333649649630200,74,80,180,350,6,170
-2.1334474685192700,74,80,100,225,6,125
-2.1335456760752900,76,85,90,150,9,60
-2.1335977100750900,58,65,80,350,7,270
-2.133636486474130,36,45,70,450,9,380
-2.133768847524960,84,90,150,400,6,250
-2.133811998441090,58,65,60,300,7,240
-2.133813499565400,94,100,150,200,6,50
-2.1338577527169200,52,60,160,250,8,90
-2.13389812924354,58,65,140,275,7,135
-2.1339802069883400,74,80,70,425,6,355
-2.1340874222208000,84,90,70,225,6,155
-2.1341498592566000,98,105,170,225,7,55
-2.134215713387170,64,70,200,500,6,300
-2.134216435577210,90,95,200,425,5,225
-2.1342246794899100,36,45,90,225,9,135
-2.1343535521563300,74,80,140,275,6,135
-2.134713403087560,36,45,70,425,9,355
-2.1348436979795300,78,85,60,175,7,115
-2.1348469194360200,68,75,130,300,7,170
-2.134861336076180,68,75,110,325,7,215
-2.1348938780419300,36,45,150,350,9,200
-2.1349027238528000,58,65,80,225,7,145
-2.134921578150220,46,55,100,200,9,100
-2.1350142729803100,36,45,80,275,9,195
-2.135034300452220,84,90,180,375,6,195
-2.1352037463128700,74,80,90,275,6,185
-2.1352169082390000,52,60,120,325,8,205
-2.1355221263829500,84,90,50,450,6,400
-2.1355250883377900,58,65,90,300,7,210
-2.1355334801848900,58,65,160,450,7,290
-2.1356037333428200,94,100,170,225,6,55
-2.135733434176490,84,90,80,475,6,395
-2.1357334742518300,90,95,50,475,5,425
-2.1359958792024400,90,95,150,400,5,250
-2.1361556196260000,36,45,80,375,9,295
-2.1362047561737500,74,80,50,275,6,225
-2.136350248633600,58,65,150,325,7,175
-2.136456949766600,74,80,100,400,6,300
-2.136480347483550,84,90,190,400,6,210
-2.136866711507230,90,95,110,475,5,365
-2.136925304741370,58,65,70,350,7,280
-2.1369329458735100,36,45,180,350,9,170
-2.1369849442258900,58,65,90,375,7,285
-2.137115030696790,98,105,90,200,7,110
-2.1371927285445,36,45,80,500,9,420
-2.1372592264041000,86,95,50,125,9,75
-2.1373192074223100,90,95,120,225,5,105
-2.1373521069157900,36,45,180,300,9,120
-2.137357214123170,58,65,200,375,7,175
-2.1374053999311700,56,65,190,225,9,35
-2.137564166889290,58,65,70,275,7,205
-2.137667743476020,58,65,100,250,7,150
-2.137700261787090,58,65,80,275,7,195
-2.137747551271260,90,95,90,250,5,160
-2.137854789063380,58,65,90,275,7,185
-2.137986799104750,90,95,160,400,5,240
-2.138046971250270,84,90,70,375,6,305
-2.1380481429983300,36,45,140,475,9,335
-2.1380822151818500,84,90,80,250,6,170
-2.1382921223823800,36,45,140,250,9,110
-2.138342733722210,74,80,90,375,6,285
-2.138413716845780,84,90,180,400,6,220
-2.1384933137985800,36,45,140,425,9,285
-2.13850623840225,36,45,100,250,9,150
-2.1385074211340000,90,95,140,450,5,310
-2.1386188309171300,84,90,130,375,6,245
-2.1387238186554600,74,80,180,325,6,145
-2.138799299035660,58,65,200,325,7,125
-2.138850909353660,58,65,80,425,7,345
-2.1390739484542500,58,65,150,225,7,75
-2.1390950093008400,74,80,160,375,6,215
-2.1391429744906100,90,95,60,325,5,265
-2.139147045937920,62,70,190,250,8,60
-2.1391675496430700,36,45,200,300,9,100
-2.1392757069822300,36,45,130,425,9,295
-2.139322422855800,58,65,70,250,7,180
-2.1393923396297600,74,80,180,300,6,120
-2.139796389204410,84,90,120,400,6,280
-2.1398541062688500,90,95,170,450,5,280
-2.139942787697660,36,45,190,425,9,235
-2.1400026156272500,74,80,80,275,6,195
-2.140052574373190,82,90,100,175,8,75
-2.1401997406551600,58,65,60,475,7,415
-2.1402045111595500,74,80,70,275,6,205
-2.1402269508734200,86,95,130,175,9,45
-2.1403239811111700,84,90,160,325,6,165
-2.140409493017140,74,80,140,225,6,85
-2.1406596460007800,74,80,100,250,6,150
-2.1406748092942400,90,95,90,450,5,360
-2.140766770794910,84,90,90,400,6,310
-2.1407736558235900,84,90,50,475,6,425
-2.140814906420470,78,85,130,200,7,70
-2.1408961738624900,94,100,200,275,6,75
-2.1408984437163200,90,95,130,400,5,270
-2.1409502563577000,46,55,180,225,9,45
-2.140992159034620,84,90,200,425,6,225
-2.1415224378870000,36,45,70,250,9,180
-2.14152313467621,74,80,200,375,6,175
-2.141702881689410,74,80,190,325,6,135
-2.1418090151957500,36,45,190,400,9,210
-2.1419073611589,74,80,110,250,6,140
-2.1421556633591200,58,65,140,350,7,210
-2.1424124339753000,46,55,50,200,9,150
-2.1425464197129200,90,95,80,250,5,170
-2.1426557593581600,90,95,190,425,5,235
-2.1427337503738200,94,100,190,275,6,85
-2.142779489549150,58,65,180,300,7,120
-2.142884674450210,84,90,120,225,6,105
-2.142899174814620,90,95,130,225,5,95
-2.1430418130540200,90,95,130,375,5,245
-2.1431469005093700,74,80,120,250,6,130
-2.143188102180960,92,100,80,150,8,70
-2.1433258121019600,90,95,150,450,5,300
-2.1433493699302100,84,90,70,450,6,380
-2.1433848830171900,74,80,120,350,6,230
-2.143406120424480,36,45,60,300,9,240
-2.1436031196483100,90,95,160,325,5,165
-2.1436475526769500,58,65,110,250,7,140
-2.1436655277197900,68,75,170,225,7,55
-2.1438188553955000,58,65,110,400,7,290
-2.143861094093350,84,90,190,425,6,235
-2.14392642272653,74,80,80,225,6,145
-2.1439318471757300,58,65,120,250,7,130
-2.144009432359880,90,95,130,425,5,295
-2.1440184108715400,84,90,140,400,6,260
-2.1440605431183600,72,80,50,150,8,100
-2.1441585560286900,90,95,150,475,5,325
-2.144247259860170,90,95,60,375,5,315
-2.1443233270449800,90,95,180,425,5,245
-2.144421256877310,36,45,150,225,9,75
-2.144465054561430,36,45,80,350,9,270
-2.1444941541788700,74,80,60,500,6,440
-2.1445368770434500,90,95,200,400,5,200
-2.1447605949444300,52,60,170,275,8,105
-2.1448179665039300,36,45,150,425,9,275
-2.144826963898160,74,80,80,425,6,345
-2.1448920351750600,90,95,60,350,5,290
-2.144900945139980,84,90,110,450,6,340
-2.144926220531810,98,105,110,200,7,90
-2.1450115940178600,84,90,130,425,6,295
-2.1451461167801400,74,80,60,475,6,415
-2.1451614398249400,36,45,140,275,9,135
-2.145204355807670,62,70,170,200,8,30
-2.1453519849408100,58,65,120,375,7,255
-2.1453734008320400,36,45,140,225,9,85
-2.145416231340570,58,65,60,450,7,390
-2.1455020465549000,84,90,140,425,6,285
-2.1455757017249200,74,80,140,350,6,210
-2.145739137230250,90,95,60,400,5,340
-2.145812481671390,36,45,160,450,9,290
-2.1459558470899800,84,90,60,350,6,290
-2.1460074772318500,36,45,190,375,9,185
-2.1461187888662200,98,105,60,200,7,140
-2.146190596480640,58,65,100,275,7,175
-2.146256539850290,90,95,150,425,5,275
-2.146385514079780,90,95,70,475,5,405
-2.146415509160350,36,45,90,425,9,335
-2.146612251494940,84,90,140,375,6,235
-2.146639217528510,36,45,100,400,9,300
-2.1469596227620700,36,45,190,350,9,160
-2.1469854131318000,92,100,70,150,8,80
-2.14700055933043,84,90,60,375,6,315
-2.1472622177864600,52,60,130,325,8,195
-2.147454821918180,84,90,80,450,6,370
-2.1475853270571500,46,55,130,200,9,70
-2.147695790810470,84,90,160,300,6,140
-2.1477247041169900,52,60,120,300,8,180
-2.147734401981540,84,90,110,425,6,315
-2.1477636004696500,36,45,140,350,9,210
-2.1477848252864300,90,95,70,375,5,305
-2.1479054733117400,36,45,120,350,9,230
-2.1479339013478100,74,80,90,300,6,210
-2.1479823608097700,58,65,120,350,7,230
-2.1480351903550300,84,90,60,400,6,340
-2.1482200593856200,74,80,100,275,6,175
-2.148395501563760,94,100,110,200,6,90
-2.1484883319257100,90,95,140,400,5,260
-2.1485344821311300,72,80,100,175,8,75
-2.1487398944630300,36,45,150,325,9,175
-2.1488269091060500,52,60,170,225,8,55
-2.148912342161750,84,90,150,425,6,275
-2.149058609114320,36,45,160,375,9,215
-2.149083726620330,84,90,140,475,6,335
-2.1491551851598100,36,45,110,425,9,315
-2.149212507827920,74,80,110,400,6,290
-2.1492668018210300,88,95,90,175,7,85
-2.1492753704913900,74,80,100,375,6,275
-2.149446305563630,82,90,50,150,8,100
-2.1495152833308400,36,45,200,350,9,150
-2.1495170998950200,46,55,50,175,9,125
-2.149597996935100,90,95,90,225,5,135
-2.1495982567457200,56,65,60,150,9,90
-2.1496382380192800,74,80,200,325,6,125
-2.1496605827110600,90,95,90,400,5,310
-2.149727000163760,84,90,200,300,6,100
-2.1498432568521300,36,45,200,375,9,175
-2.1499244715883200,84,90,80,500,6,420
-2.1500515360032800,86,95,140,175,9,35
-2.1501269567683100,90,95,120,400,5,280
-2.1502631165236000,36,45,90,275,9,185
-2.1504859304511900,36,45,70,275,9,205
-2.1505445894034600,36,45,120,250,9,130
-2.1505459662340500,68,75,170,275,7,105
-2.150548420764580,36,45,140,375,9,235
-2.150607817659770,98,105,50,200,7,150
-2.1507269048721900,90,95,80,500,5,420
-2.1507317153582300,36,45,90,375,9,285
-2.1507553638042400,90,95,120,425,5,305
-2.150817620178070,84,90,190,350,6,160
-2.1508307853222100,78,85,140,200,7,60
-2.1510593222252100,36,45,60,500,9,440
-2.151209241134340,36,45,70,350,9,280
-2.1512230589037200,74,80,100,300,6,200
-2.151419240174510,58,65,100,375,7,275
-2.1516253265924200,90,95,180,350,5,170
-2.151637588248130,86,95,200,225,9,25
-2.1519946899769200,36,45,60,475,9,415
-2.151997638636240,74,80,110,225,6,115
-2.152196051304500,84,90,170,300,6,130
-2.1522852600173100,58,65,70,400,7,330
-2.152369401685510,74,80,70,350,6,280
-2.1523960563201500,84,90,190,375,6,185
-2.152613916216480,90,95,170,300,5,130
-2.152792886268760,78,85,70,175,7,105
-2.152878479237880,88,95,50,150,7,100
-2.1529136098419600,98,105,100,200,7,100
-2.15302568803164,56,65,120,175,9,55
-2.153031929106640,84,90,150,325,6,175
-2.153083882542230,74,80,70,250,6,180
-2.153100482303090,90,95,180,400,5,220
-2.153223202135410,46,55,120,200,9,80
-2.153325375332050,36,45,200,325,9,125
-2.1534722772920900,58,65,100,325,7,225
-2.1534990197385900,58,65,50,300,7,250
-2.1535556679384000,48,55,200,500,7,300
-2.1537443964360200,94,100,90,200,6,110
-2.1539562461248600,96,105,180,200,9,20
-2.1541890072018700,90,95,190,400,5,210
-2.1542028512258500,90,95,180,375,5,195
-2.154652945131870,90,95,140,425,5,285
-2.1547404947371900,84,90,60,325,6,265
-2.1548168930777000,84,90,130,250,6,120
-2.1552328039991000,90,95,70,450,5,380
-2.1552922059576900,68,75,80,200,7,120
-2.155342215195390,74,80,120,275,6,155
-2.1553680594336200,58,65,110,225,7,115
-2.155370782077090,90,95,80,475,5,395
-2.155418432637310,90,95,110,450,5,340
-2.1555529806765700,36,45,190,325,9,135
-2.1556697244567600,52,60,80,200,8,120
-2.1556970362965100,74,80,60,450,6,390
-2.1557714271013200,74,80,110,350,6,240
-2.1558108572081000,84,90,200,375,6,175
-2.155961478313750,90,95,90,350,5,260
-2.1560024808318200,62,70,50,150,8,100
-2.1561632598703800,84,90,90,350,6,260
-2.1563558877712400,94,100,50,200,6,150
-2.1564630113627500,64,70,200,475,6,275
-2.156490817735040,68,75,150,200,7,50
-2.1567004900558900,46,55,160,200,9,40
-2.1569049128335200,84,90,180,350,6,170
-2.1569161273886600,84,90,100,400,6,300
-2.156938787567100,84,90,130,225,6,95
-2.1570158516769100,58,65,150,300,7,150
-2.1571941827853600,36,45,110,250,9,140
-2.157382064250500,84,90,70,425,6,355
-2.1573956086170700,90,95,140,475,5,335
-2.157558180092910,36,45,110,400,9,290
-2.1579625118039100,84,90,200,350,6,150
-2.158114952142570,58,65,90,325,7,235
-2.1581831484668200,88,95,100,175,7,75
-2.158190965482470,58,65,110,350,7,240
-2.1581954590501300,90,95,150,350,5,200
-2.1582131904573700,58,65,190,300,7,110
-2.1583958883426200,42,50,200,475,8,275
-2.1583971038997100,66,75,120,175,9,55
-2.158402422914930,62,70,100,175,8,75
-2.1585997862975900,74,80,110,275,6,165
-2.158751412695240,74,80,100,350,6,250
-2.1589080986691700,58,65,130,350,7,220
-2.159489252520760,68,75,120,300,7,180
-2.1594949946087100,66,75,60,150,9,90
-2.159648246503440,84,90,90,425,6,335
-2.159659041962590,36,45,80,425,9,345
-2.159699745875000,74,80,120,375,6,255
-2.1598340745908300,90,95,160,300,5,140
-2.1600428386782200,36,45,180,325,9,145
-2.160137862264260,90,95,200,300,5,100
-2.1601652130888800,74,80,110,375,6,265
-2.160184873055130,94,100,180,225,6,45
-2.160205299775840,84,90,160,375,6,215
-2.1604491317792400,52,60,180,275,8,95
-2.160567869883620,58,65,100,300,7,200
-2.160644713154700,90,95,160,450,5,290
-2.160696216752420,58,65,80,400,7,320
-2.16084596438597,82,90,170,200,8,30
-2.1608689309092300,74,80,80,400,6,320
-2.161009580268130,84,90,180,325,6,145
-2.161012097452610,74,80,50,300,6,250
-2.161135254211890,88,95,170,200,7,30
-2.161179771654660,74,80,70,400,6,330
-2.161266237976750,72,80,170,200,8,30
-2.161273468632450,36,45,50,300,9,250
-2.161382436649840,74,80,100,325,6,225
-2.161525739326010,90,95,100,400,5,300
-2.161548819200460,90,95,190,350,5,160
-2.1617327746514900,36,45,100,275,9,175
-2.1621765876586100,52,60,200,275,8,75
-2.162182638982230,94,100,100,200,6,100
-2.162352074472240,84,90,160,450,6,290
-2.162409962979440,58,65,160,275,7,115
-2.1624798924491600,74,80,130,350,6,220
-2.162567374176550,90,95,140,250,5,110
-2.162679639328640,66,75,190,225,9,35
-2.162681058088680,90,95,60,475,5,415
-2.1627601977577500,90,95,80,375,5,295
-2.1628783360665900,46,55,140,200,9,60
-2.1630145770319900,58,65,150,375,7,225
-2.163288675605330,90,95,140,275,5,135
-2.1632999684347600,84,90,80,375,6,295
-2.1633663996073200,84,90,140,275,6,135
-2.163382213193390,84,90,190,325,6,135
-2.1634357190997900,58,65,110,375,7,265
-2.1635756465562500,56,65,200,250,9,50
-2.1636671404030400,74,80,90,325,6,235
-2.1637904948214500,90,95,80,450,5,370
-2.1639404759747900,74,80,190,300,6,110
-2.1640258607747200,98,105,180,225,7,45
-2.164063099240130,90,95,60,300,5,240
-2.1641115422715400,64,70,190,475,6,285
-2.1641464027363100,100,105,200,500,5,300
-2.1642106058296300,68,75,180,275,7,95
-2.1642788142087500,74,80,50,225,6,175
-2.1643600447986900,64,70,190,500,6,310
-2.1644757969306100,42,50,190,500,8,310
-2.164739405290450,52,60,60,200,8,140
-2.164855727916040,74,80,150,375,6,225
-2.165154969502000,90,95,110,425,5,315
-2.165225433925290,90,95,80,225,5,145
-2.165242016885330,84,90,140,250,6,110
-2.1653374507375600,74,80,160,275,6,115
-2.1654432820481800,98,105,120,200,7,80
-2.1654609808951300,36,45,100,325,9,225
-2.1655442761859800,90,95,70,425,5,355
-2.165830284638620,36,45,100,300,9,200
-2.1658611754266100,36,45,60,450,9,390
-2.1658744055988500,84,90,100,225,6,125
-2.1659266729771100,58,65,120,275,7,155
-2.166106112494170,48,55,190,475,7,285
-2.1662997045345300,58,65,50,325,7,275
-2.1663011000752900,84,90,60,475,6,415
-2.166432568791610,74,80,70,325,6,255
-2.166479994666170,84,90,80,400,6,320
-2.1667814856904700,36,45,50,325,9,275
-2.1668107895340800,66,75,200,250,9,50
-2.1670542820255700,90,95,200,350,5,150
-2.1672971767297800,58,65,70,325,7,255
-2.167308550016390,90,95,90,425,5,335
-2.1679299970016000,58,65,70,300,7,230
-2.168033110919670,90,95,140,375,5,235
-2.16807399789424,84,90,100,250,6,150
-2.1681519592431400,42,50,190,475,8,285
-2.1681814736971600,76,85,110,150,9,40
-2.168194120937920,90,95,200,375,5,175
-2.1682004089693700,72,80,190,225,8,35
-2.168265583501350,98,105,160,200,7,40
-2.1683235328502500,90,95,50,275,5,225
-2.168505848849030,84,90,140,350,6,210
-2.168673622091310,90,95,190,375,5,185
-2.1686880742149600,36,45,100,375,9,275
-2.1687171726565600,90,95,150,325,5,175
-2.1687264086351200,84,90,90,375,6,285
-2.1687703764482700,58,65,100,350,7,250
-2.16904913169468,82,90,60,150,8,90
-2.1690963718273300,90,95,70,275,5,205
-2.169163016925950,90,95,160,375,5,215
-2.169227561215790,94,100,160,200,6,40
-2.1692815613527200,84,90,80,350,6,270
-2.1694346757184500,36,45,80,400,9,320
-2.169523392876680,46,55,70,175,9,105
-2.1695421676541700,58,65,80,325,7,245
-2.1695787773845900,84,90,50,275,6,225
-2.16960899274239,84,90,200,325,6,125
-2.169718683361220,36,45,190,300,9,110
-2.169901178474170,36,45,120,375,9,255
-2.1699079365532400,82,90,190,225,8,35
-2.169928888511590,74,80,60,250,6,190
-2.1700765342135800,84,90,90,225,6,135
-2.1703032051713500,48,55,200,475,7,275
-2.1703754918479600,90,95,100,225,5,125
-2.1704465348458900,48,55,190,500,7,310
-2.1707198428133300,58,65,60,250,7,190
-2.1710230046778400,36,45,60,250,9,190
-2.1714360401114500,76,85,180,200,9,20
-2.1715563834486100,58,65,70,200,7,130
-2.171572454290640,86,95,110,150,9,40
-2.171840745104880,90,95,130,250,5,120
-2.1719319680414200,84,90,60,500,6,440
-2.1719840078421800,84,90,120,350,6,230
-2.171992904750350,84,90,80,275,6,195
-2.1720204227244200,94,100,120,200,6,80
-2.1721421308496200,90,95,100,250,5,150
-2.172613370544800,58,65,50,225,7,175
-2.1728996299793300,74,80,50,325,6,275
-2.1731927556187900,74,80,150,300,6,150
-2.1734427252821000,36,45,70,325,9,255
-2.1735465291517900,58,65,110,275,7,165
-2.1736377935174400,90,95,80,350,5,270
-2.173907556316880,36,45,110,275,9,165
-2.173917142437910,64,70,180,500,6,320
-2.174071770993010,36,45,110,350,9,240
-2.174172281239690,84,90,90,300,6,210
-2.17420197149311,90,95,60,500,5,440
-2.1742285083311400,98,105,50,175,7,125
-2.174236045114720,100,105,190,475,5,285
-2.174353337954550,90,95,180,325,5,145
-2.174366310607870,36,45,70,400,9,330
-2.1744521158811700,46,55,60,175,9,115
-2.1744765210922800,64,70,120,450,6,330
-2.1746597030412400,74,80,140,300,6,160
-2.1749544442284200,90,95,120,250,5,130
-2.175020334902850,52,60,190,275,8,85
-2.1751050782517200,82,90,200,250,8,50
-2.17512417571412,98,105,130,200,7,70
-2.1755221755625000,84,90,120,250,6,130
-2.1756593884020500,84,90,100,275,6,175
-2.1757368693783100,74,80,150,275,6,125
-2.175739849410190,90,95,140,350,5,210
-2.1758355402815400,68,75,50,200,7,150
-2.1758431589797100,64,70,160,500,6,340
-2.175878268559750,84,90,110,250,6,140
-2.175929851979640,68,75,200,275,7,75
-2.175999745549260,84,90,80,425,6,345
-2.176130096067480,36,45,100,350,9,250
-2.1762565891533000,58,65,110,300,7,190
-2.176258323090930,58,65,140,300,7,160
-2.1762676150779300,54,60,200,500,6,300
-2.1762818246413800,84,90,120,375,6,255
-2.1763888989024600,62,70,120,175,8,55
-2.1764058146602900,72,80,200,250,8,50
-2.1764126525326300,58,65,50,250,7,200
-2.176442797953840,90,95,90,375,5,285
-2.17651657702385,78,85,110,175,7,65
-2.176606679470830,74,80,80,325,6,245
-2.1768087330116900,58,65,60,225,7,165
-2.1769792394163700,84,90,80,225,6,145
-2.1770413102553200,94,100,50,175,6,125
-2.1770690536777700,84,90,60,300,6,240
-2.1771878301220400,74,80,60,225,6,165
-2.177322588617810,68,75,180,225,7,45
-2.1776510661788100,84,90,70,250,6,180
-2.1776539066577400,84,90,110,400,6,290
-2.1776689478360600,36,45,110,375,9,265
-2.1778153581902800,68,75,180,250,7,70
-2.1779966779626400,36,45,120,275,9,155
-2.178111771588490,36,45,60,225,9,165
-2.1781528977888600,78,85,80,175,7,95
-2.1782109384115700,58,65,60,275,7,215
-2.1782504176560200,90,95,150,225,5,75
-2.178268438468310,42,50,180,500,8,320
-2.178520843937380,36,45,130,350,9,220
-2.1785517450071400,84,90,70,275,6,205
-2.178662422355650,74,80,110,300,6,190
-2.1787623170919600,90,95,80,275,5,195
-2.17880854639768,84,90,180,300,6,120
-2.178879330964380,52,60,110,200,8,90
-2.178904377536670,36,45,160,275,9,115
-2.1789914663852700,90,95,90,275,5,185
-2.179035952989410,90,95,190,325,5,135
-2.179048651128010,90,95,70,250,5,180
-2.1791724938903300,68,75,100,200,7,100
-2.1792544846262400,84,90,90,275,6,185
-2.1793459639648900,90,95,80,425,5,345
-2.1793555107248800,90,95,120,350,5,230
-2.180020638392020,36,45,90,325,9,235
-2.1803714696761400,88,95,120,175,7,55
-2.18043313416372,94,100,140,200,6,60
-2.1804513838797200,90,95,140,225,5,85
-2.1804731293537400,36,45,50,225,9,175
-2.180484339022350,58,65,120,325,7,205
-2.1805389968100300,84,90,100,325,6,225
-2.180586819534570,52,60,90,200,8,110
-2.180876530341820,74,80,50,250,6,200
-2.1809922720845700,52,60,180,225,8,45
-2.180993244957390,64,70,90,500,6,410
-2.1812972698667000,68,75,190,275,7,85
-2.1814379994794800,58,65,150,250,7,100
-2.1815946250109000,90,95,80,400,5,320
-2.1816098435853100,98,105,60,175,7,115
-2.18174861800821,84,90,150,225,6,75
-2.1817871925474800,68,75,60,200,7,140
-2.1818784529149300,58,65,170,250,7,80
-2.1820208509006500,36,45,150,375,9,225
-2.1820251534907200,84,90,70,400,6,330
-2.1820330073468800,36,45,150,300,9,150
-2.182110602421670,74,80,70,200,6,130
-2.182324129660300,88,95,200,250,7,50
-2.182326680639230,82,90,120,175,8,55
-2.1824319562931400,72,80,120,175,8,55
-2.1824591495434300,36,45,110,225,9,115
-2.182616243599790,52,60,50,200,8,150
-2.182795156759270,90,95,90,300,5,210
-2.1828743491350800,90,95,50,300,5,250
-2.1829185015275400,62,70,190,225,8,35
-2.1831028291334700,90,95,110,400,5,290
-2.1831391130422500,90,95,200,325,5,125
-2.183275360665070,84,90,60,450,6,390
-2.183527268502370,74,80,130,300,6,170
-2.183636132612650,72,80,60,150,8,90
-2.1837610884658900,90,95,100,325,5,225
-2.1839172658821300,46,55,110,175,9,65
-2.183994700502800,78,85,90,175,7,85
-2.1841470948782000,90,95,70,350,5,280
-2.1842667484687400,48,55,180,500,7,320
-2.184336323279370,64,70,150,500,6,350
-2.1844200116152700,74,80,150,250,6,100
-2.184490291541450,84,90,110,350,6,240
-2.184498136271550,68,75,110,200,7,90
-2.1846133830843900,90,95,180,300,5,120
-2.1846229722776600,64,70,200,450,6,250
-2.1847788190592500,94,100,60,175,6,115
-2.1848783694426800,92,100,50,125,8,75
-2.1849546163656400,74,80,60,275,6,215
-2.185002561278550,58,65,160,250,7,90
-2.18507188716387,94,100,130,200,6,70
-2.185203617222160,42,50,90,500,8,410
-2.18521533584493,36,45,110,300,9,190
-2.1854257128536300,58,65,150,275,7,125
-2.1856873343129100,36,45,80,325,9,245
-2.185934340234950,88,95,190,225,7,35
-2.1859793981836000,36,45,70,300,9,230
-2.1860390578863100,84,90,140,225,6,85
-2.186044051001440,84,90,150,375,6,225
-2.1860661152434800,84,90,100,350,6,250
-2.186358372035090,64,70,170,350,6,180
-2.1863976565480700,84,90,70,350,6,280
-2.18641844420979,90,95,60,450,5,390
-2.1866499442173000,52,60,180,250,8,70
-2.186698798878620,42,50,120,450,8,330
-2.1867190750154700,90,95,120,375,5,255
-2.1869829621996800,98,105,140,200,7,60
-2.1872560224873700,74,80,70,300,6,230
-2.1873080958957800,88,95,60,150,7,90
-2.1873988999895500,48,55,90,500,7,410
-2.1874020656882900,36,45,50,250,9,200
-2.187871383596120,100,105,190,500,5,310
-2.1879727820152800,74,80,170,250,6,80
-2.187987088841870,74,80,130,275,6,145
-2.188066578389020,58,65,130,275,7,145
-2.188079736152620,68,75,90,200,7,110
-2.188080969273510,90,95,50,325,5,275
-2.1884016414218600,36,45,150,275,9,125
-2.188484860897990,42,50,160,500,8,340
-2.1885343856362200,84,90,100,375,6,275
-2.1885368193589500,90,95,70,400,5,330
-2.188695642274320,90,95,100,275,5,175
-2.1887190071673700,90,95,130,350,5,220
-2.1890563003580300,36,45,70,200,9,130
-2.1892954262404600,62,70,60,150,8,90
-2.1894896964389000,36,45,170,250,9,80
-2.1897539377796900,90,95,70,325,5,255
-2.1899674284533800,74,80,80,300,6,220
-2.1900449287016300,84,90,150,275,6,125
-2.190105736296500,84,90,90,325,6,235
-2.1902038287616500,64,70,100,500,6,400
-2.1904981179411600,100,105,200,475,5,275
-2.1906018755644000,62,70,200,250,8,50
-2.1906521608764000,90,95,110,250,5,140
-2.190825267197950,52,60,160,200,8,40
-2.1910392954352800,36,45,140,300,9,160
-2.1910694302080200,84,90,190,300,6,110
-2.1911400243427800,84,90,160,275,6,115
-2.191244913193390,64,70,90,475,6,385
-2.19143815543591,90,95,140,300,5,160
-2.1914504899573400,96,105,60,125,9,65
-2.1915723334885100,84,90,130,350,6,220
-2.19167389033331,98,105,80,175,7,95
-2.1917444751704100,48,55,170,500,7,330
-2.191788908635990,90,95,110,350,5,240
-2.191807764717520,90,95,100,375,5,275
-2.191893370651550,74,80,160,250,6,90
-2.1920441427660800,90,95,190,300,5,110
-2.192360828779240,84,90,110,275,6,165
-2.192420929157000,42,50,100,500,8,400
-2.1926738581140900,64,70,170,500,6,330
-2.192833471072180,36,45,60,275,9,215
-2.19288546061639,64,70,160,425,6,265
-2.1931354854314200,46,55,80,175,9,95
-2.1932453399209600,90,95,100,350,5,250
-2.1932615311025900,46,55,190,250,9,60
-2.1932981837036900,90,95,120,275,5,155
-2.1933566569242400,84,90,140,300,6,160
-2.193362897837850,84,90,110,375,6,265
-2.1934451675176300,68,75,160,200,7,40
-2.1935243357631000,84,90,50,300,6,250
-2.193632987310260,100,105,180,500,5,320
-2.193697993731900,92,100,200,225,8,25
-2.193726246302130,84,90,70,325,6,255
-2.193763331492690,90,95,90,325,5,235
-2.193802490987960,92,100,100,150,8,50
-2.1941567030479200,58,65,110,325,7,215
-2.194575234896100,48,55,160,500,7,340
-2.1945856007547200,58,65,130,300,7,170
-2.194650453088720,74,80,120,325,6,205
-2.194653399071710,78,85,190,250,7,60
-2.194772282812820,48,55,120,450,7,330
-2.1950210364919100,98,105,190,250,7,60
-2.195025464501110,74,80,160,225,6,65
-2.1950272267074200,90,95,150,375,5,225
-2.195045350342510,78,85,50,150,7,100
-2.1951447224867400,42,50,100,450,8,350
-2.195223480492230,56,65,70,150,9,80
-2.1952479486819700,42,50,200,450,8,250
-2.1952569628747300,52,60,50,175,8,125
-2.1954221618924700,48,55,200,450,7,250
-2.1955204980263500,90,95,110,375,5,265
-2.19559493204165,84,90,150,300,6,150
-2.1956523827605800,48,55,150,500,7,350
-2.1957894313204700,84,90,100,300,6,200
-2.195990961988800,90,95,150,300,5,150
-2.196093033041920,36,45,150,250,9,100
-2.196543993720410,92,100,130,175,8,45
-2.1965911207056900,74,80,140,325,6,185
-2.196594193432610,98,105,70,175,7,105
-2.197171541467370,94,100,70,175,6,105
-2.197715874372280,48,55,90,475,7,385
-2.197812484846340,90,95,50,225,5,175
-2.1978500731800400,58,65,80,300,7,220
-2.197966384734550,54,60,190,500,6,310
-2.1981906984248200,74,80,110,325,6,215
-2.1981939062070700,58,65,160,225,7,65
-2.1983030855153700,64,70,180,475,6,295
-2.198364564298050,84,90,110,225,6,115
-2.1986266721814100,48,55,100,500,7,400
-2.198682020041970,96,105,150,175,9,25
-2.1988945881857800,42,50,100,475,8,375
-2.199063367299700,76,85,60,125,9,65
-2.1990821116172400,64,70,170,475,6,305
-2.1994158768341300,54,60,200,475,6,275
-2.199611471740700,42,50,170,500,8,330
-2.1996775581323200,66,75,80,150,9,70
-2.2000186032286300,84,90,120,275,6,155
-2.200222904370680,90,95,100,300,5,200
-2.200744388901880,58,65,140,325,7,185
-2.2007798418082800,90,95,160,275,5,115
-2.200850293186650,64,70,120,500,6,380
-2.2010559428869000,64,70,100,450,6,350
-2.2012405295876900,68,75,50,175,7,125
-2.20149739022793,42,50,90,475,8,385
-2.2016780381827300,42,50,120,500,8,380
-2.2017154889879400,96,105,120,150,9,30
-2.202043729760860,56,65,80,150,9,70
-2.2021636170016900,66,75,70,150,9,80
-2.2021681690266100,90,95,110,275,5,165
-2.2024864120224100,64,70,100,475,6,375
-2.202554002527410,52,60,120,200,8,80
-2.2027949669610900,90,95,70,300,5,230
-2.2028520987878200,74,80,130,325,6,195
-2.202930656864290,52,60,100,200,8,100
-2.2029699422883900,74,80,170,275,6,105
-2.202980689628150,36,45,80,300,9,220
-2.203200564392410,92,100,90,150,8,60
-2.203464978969490,64,70,50,375,6,325
-2.203765745054970,84,90,50,325,6,275
-2.204179916168090,96,105,70,125,9,55
-2.20424252088904,84,90,170,250,6,80
-2.2046751865024200,100,105,160,500,5,340
-2.204786593576700,42,50,170,350,8,180
-2.204855432230050,48,55,170,350,7,180
-2.204884521199720,64,70,120,475,6,355
-2.204935503359630,84,90,110,300,6,190
-2.205085457412300,42,50,50,400,8,350
-2.205369508893750,64,70,190,450,6,260
-2.2054430668259400,48,55,180,475,7,295
-2.206447353306480,52,60,130,200,8,70
-2.2066130837788700,58,65,130,325,7,195
-2.206803801663240,64,70,100,425,6,325
-2.206924134189640,80,85,200,500,5,300
-2.2071374244938400,86,95,180,200,9,20
-2.207446755281920,68,75,120,200,7,80
-2.2075332353773100,94,100,80,175,6,95
-2.2075395142983400,64,70,50,400,6,350
-2.2076101162108100,46,55,90,175,9,85
-2.2079633161057900,48,55,120,500,7,380
-2.2080988571242500,54,60,180,500,6,320
-2.208195912341220,84,90,150,250,6,100
-2.208271631780710,42,50,190,450,8,260
-2.208528368350920,48,55,190,450,7,260
-2.2086962498293700,64,70,140,500,6,360
-2.2087861474937400,100,105,100,500,5,400
-2.20879704038621,90,95,70,200,5,130
-2.2090037346961100,64,70,160,475,6,315
-2.2091555055701700,84,90,60,250,6,190
-2.209265889922440,42,50,180,475,8,295
-2.209282938268870,100,105,170,500,5,330
-2.209453075215190,42,50,150,500,8,350
-2.209461294963660,36,45,130,275,9,145
-2.2095447880016400,54,60,190,475,6,285
-2.2096094505894500,36,45,160,250,9,90
-2.209786159045310,68,75,130,200,7,70
-2.209922720961890,64,70,170,400,6,230
-2.2099507488355300,90,95,60,275,5,215
-2.2099746533099100,64,70,50,425,6,375
-2.210006250025540,42,50,170,475,8,305
-2.210007462230710,84,90,70,200,6,130
-2.2103162287470500,42,50,170,400,8,230
-2.2103599533695700,90,95,150,275,5,125
-2.21058062096641,90,95,170,250,5,80
-2.210678243695690,86,95,70,125,9,55
-2.210741658084710,48,55,160,475,7,315
-2.2109024402406100,64,70,130,500,6,370
-2.2109058715049900,90,95,110,225,5,115
-2.211033542049090,64,70,170,425,6,255
-2.211277813911750,42,50,70,500,8,430
-2.211292621361810,90,95,50,250,5,200
-2.2113217578367600,48,55,100,450,7,350
-2.211379024815050,64,70,70,500,6,430
-2.2114064544697700,64,70,170,375,6,205
-2.2114472703867600,90,95,110,300,5,190
-2.211491936254300,84,90,160,250,6,90
-2.211498067746880,90,95,60,225,5,165
-2.2117050428557300,84,90,80,325,6,245
-2.211789945829790,46,55,170,200,9,30
-2.2119485362275100,100,105,90,500,5,410
-2.211974012527510,76,85,120,150,9,30
-2.212036785871110,90,95,80,325,5,245
-2.212100910464690,42,50,140,500,8,360
-2.21212866528003,64,70,50,350,6,300
-2.2122145683136600,64,70,110,500,6,390
-2.212310857186570,100,105,120,450,5,330
-2.212438072767710,58,65,170,275,7,105
-2.212470682180670,48,55,50,375,7,325
-2.2128272481120900,84,90,70,300,6,230
-2.2128989430829600,64,70,160,400,6,240
-2.2130902155271700,100,105,150,500,5,350
-2.2131039426903500,90,95,60,250,5,190
-2.21340728268879,58,65,120,300,7,180
-2.213600989062310,100,105,90,475,5,385
-2.213768869012710,36,45,140,325,9,185
-2.21377630121098,48,55,160,425,7,265
-2.213827565894050,100,105,170,350,5,180
-2.213863785305710,84,90,170,275,6,105
-2.2145608083415300,42,50,50,375,8,325
-2.214572979353240,98,105,90,175,7,85
-2.214631437703000,76,85,150,175,9,25
-2.214685642140760,84,90,50,225,6,175
-2.214760747557810,46,55,100,175,9,75
-2.214768001680460,84,90,60,225,6,165
-2.21486663537729,88,95,70,150,7,80
-2.2149567245621700,84,90,50,250,6,200
-2.215172249686740,42,50,50,350,8,300
-2.215262124822030,84,90,130,300,6,170
-2.215523516736850,64,70,150,400,6,250
-2.215538573386740,36,45,110,325,9,215
-2.2155584581212300,52,60,60,175,8,115
-2.2156660878575900,84,90,60,275,6,215
-2.215674842907880,64,70,120,225,6,105
-2.215793340512690,42,50,120,475,8,355
-2.215879876060920,98,105,110,175,7,65
-2.215938724572310,86,95,60,125,9,65
-2.216072852781260,42,50,50,425,8,375
-2.2162014715963700,64,70,180,425,6,245
-2.2163677779361800,48,55,140,500,7,360
-2.2165295217930800,54,60,120,450,6,330
-2.2165719363113900,84,90,120,325,6,205
-2.2165892205436900,64,70,60,425,6,365
-2.216649796395330,42,50,160,350,8,190
-2.216693457512600,36,45,170,275,9,105
-2.2168666654176700,92,100,140,175,8,35
-2.217037979129050,48,55,50,400,7,350
-2.217146580480050,42,50,170,325,8,155
-2.217592372012090,84,90,130,275,6,145
-2.217710800305100,64,70,90,250,6,160
-2.2179608901863800,74,80,120,300,6,180
-2.2181186525553700,64,70,160,350,6,190
-2.218190899390280,48,55,170,475,7,305
-2.2184338725310900,48,55,170,400,7,230
-2.218640942684480,36,45,130,300,9,170
-2.218698811611520,64,70,50,450,6,400
-2.2188818296724400,36,45,80,200,9,120
-2.2189771547608100,94,100,190,250,6,60
-2.2190393707202000,100,105,170,475,5,305
-2.2191484875191000,48,55,100,475,7,375
-2.219201925188100,100,105,200,450,5,250
-2.2192916352662400,90,95,120,325,5,205
-2.2193967570562500,48,55,70,225,7,155
-2.2194462708747400,36,45,120,325,9,205
-2.21958988050026,86,95,120,150,9,30
-2.219633670300430,42,50,160,425,8,265
-2.2196526167561100,36,45,160,225,9,65
-2.2197282770683200,90,95,150,250,5,100
-2.2197388451351700,54,60,200,450,6,250
-2.219893411322010,78,85,170,200,7,30
-2.2199657571660500,48,55,50,425,7,375
-2.220071234592860,68,75,60,175,7,115
-2.220355375485040,78,85,100,175,7,75
-2.2205432659278,90,95,110,325,5,215
-2.220549846019640,48,55,130,500,7,370
-2.220748668762580,64,70,130,475,6,345
-2.2207958607828100,86,95,150,175,9,25
-2.2207991944703000,58,65,150,200,7,50
-2.2209948589679400,64,70,170,325,6,155
-2.2212132319731700,100,105,190,450,5,260
-2.2212501114550800,100,105,130,500,5,370
-2.2213056769014800,84,90,80,300,6,220
-2.2214077514604000,54,60,90,500,6,410
-2.221500203464150,42,50,60,425,8,365
-2.221523335658240,48,55,60,425,7,365
-2.2215490521475200,58,65,80,200,7,120
-2.222290359774900,64,70,80,250,6,170
-2.222300416712360,90,95,130,275,5,145
-2.2223358577456000,48,55,180,450,7,270
-2.222396412765240,64,70,110,475,6,365
-2.222643031503010,74,80,180,275,6,95
-2.2229142488566500,54,60,160,500,6,340
-2.2230233253451500,78,85,60,150,7,90
-2.2230463938225200,100,105,140,500,5,360
-2.2231074990680800,42,50,110,500,8,390
-2.2231671147915700,82,90,70,150,8,80
-2.223354966360090,64,70,60,350,6,290
-2.223578485055750,48,55,130,450,7,320
-2.223625403013650,64,70,130,400,6,270
-2.2237318822935500,74,80,170,225,6,55
-2.223899818250690,56,65,100,150,9,50
-2.223946202059970,100,105,180,475,5,295
-2.2240321391912500,48,55,50,500,7,450
-2.224103947181930,64,70,130,450,6,320
-2.224131798730530,58,65,180,275,7,95
-2.22416714548213,42,50,130,475,8,345
-2.2242252635846400,42,50,130,500,8,370
-2.2243655022412400,42,50,170,375,8,205
-2.224444812225390,42,50,130,400,8,270
-2.2244656521937700,64,70,180,450,6,270
-2.2246342019320400,58,65,170,225,7,55
-2.2246672900407900,54,60,100,500,6,400
-2.2247102790098500,100,105,120,500,5,380
-2.2247294893678300,42,50,60,375,8,315
-2.224831875637290,68,75,70,175,7,105
-2.2251187059386000,64,70,70,225,6,155
-2.225275867780730,42,50,90,400,8,310
-2.2253867656034000,36,45,170,225,9,55
-2.225418831483960,64,70,50,500,6,450
-2.2254357007004000,48,55,70,500,7,430
-2.225524568815470,42,50,50,450,8,400
-2.225725622011760,94,100,110,175,6,65
-2.225763280472290,48,55,80,250,7,170
-2.225798266837210,64,70,50,475,6,425
-2.2258421244076500,84,90,110,325,6,215
-2.225856821886630,84,90,140,325,6,185
-2.2258626355176000,52,60,110,175,8,65
-2.2258791871766000,82,90,80,150,8,70
-2.2260429775264600,42,50,50,500,8,450
-2.226083644772640,48,55,120,475,7,355
-2.2261233632340800,64,70,140,400,6,260
-2.2265194503727600,100,105,160,475,5,315
-2.2266758725321500,42,50,60,325,8,265
-2.226685171038870,64,70,200,400,6,200
-2.2268725594604100,100,105,100,450,5,350
-2.226882304634030,90,95,130,300,5,170
-2.2269313462090900,76,85,70,125,9,55
-2.2269744826755200,48,55,50,350,7,300
-2.226991640847160,100,105,170,400,5,230
-2.227292799350160,56,65,50,125,9,75
-2.2272954572557300,42,50,130,450,8,320
-2.2273201254478700,74,80,150,200,6,50
-2.2273780884959500,36,45,130,325,9,195
-2.2274116139020500,48,55,110,500,7,390
-2.227540323744080,62,70,80,150,8,70
-2.2275922553047200,42,50,100,425,8,325
-2.2276738909813700,80,85,190,500,5,310
-2.2277848238956,42,50,90,450,8,360
-2.22806993335102,42,50,80,250,8,170
-2.2282308634272300,42,50,170,425,8,255
-2.2285202439831600,72,80,70,150,8,80
-2.2285260277020200,48,55,130,475,7,345
-2.228583843694580,80,85,200,475,5,275
-2.2288274502610200,64,70,70,475,6,405
-2.2288530604177000,94,100,90,175,6,85
-2.2288532999264000,64,70,60,375,6,315
-2.228978229378340,68,75,140,200,7,60
-2.2290075976451700,42,50,160,325,8,165
-2.2292409671872500,64,70,90,450,6,360
-2.229601985275470,74,80,60,200,6,140
-2.229625528106540,42,50,90,250,8,160
-2.2297221636653200,80,85,160,500,5,340
-2.2298552218227300,48,55,110,475,7,365
-2.2300317082967,48,55,160,400,7,240
-2.230053807345650,58,65,200,275,7,75
-2.230056951005990,64,70,120,425,6,305
-2.230438299303720,90,95,80,300,5,220
-2.230449563101290,42,50,160,475,8,315
-2.2307231774762000,100,105,160,425,5,265
-2.2309639383731500,84,90,130,325,6,195
-2.2309753212039500,64,70,160,325,6,165
-2.231031356943770,90,95,160,250,5,90
-2.2310880064676100,64,70,130,225,6,95
-2.2311492361799800,48,55,170,325,7,155
-2.231262778088870,54,60,50,375,6,325
-2.23128463404911,48,55,90,250,7,160
-2.231493144168050,100,105,100,475,5,375
-2.2315021269258400,94,100,100,175,6,75
-2.231547835129850,100,105,170,425,5,255
-2.231557031862850,98,105,50,150,7,100
-2.2316604663463700,80,85,190,475,5,285
-2.231688990048230,42,50,60,400,8,340
-2.2318487218067600,48,55,180,425,7,245
-2.2319443148091800,42,50,180,450,8,270
-2.232078341625590,100,105,130,475,5,345
-2.232365662144850,36,45,180,275,9,95
-2.232565485729140,48,55,60,325,7,265
-2.232585520614570,48,55,170,375,7,205
-2.2326969051945600,64,70,110,450,6,340
-2.232714463865840,48,55,130,400,7,270
-2.2327400693752200,62,70,70,150,8,80
-2.2329709789968100,74,80,180,250,6,70
-2.233127128764050,42,50,60,350,8,290
-2.233148659132550,42,50,130,225,8,95
-2.2332404926449900,100,105,110,500,5,390
-2.2333060866065800,64,70,90,400,6,310
-2.2334141662952000,56,65,90,150,9,60
-2.233504571561400,74,80,80,200,6,120
-2.2336096190753600,64,70,150,450,6,300
-2.233668897682160,66,75,100,150,9,50
-2.2337422310582300,68,75,80,175,7,95
-2.233806769997190,100,105,160,400,5,240
-2.2338126265832300,42,50,160,400,8,240
-2.2338870994272700,36,45,120,300,9,180
-2.233952225786620,42,50,120,225,8,105
-2.2339976047419000,48,55,100,425,7,325
-2.2342701924495500,64,70,170,450,6,280
-2.234548606252020,42,50,150,475,8,325
-2.234622999275800,42,50,50,475,8,425
-2.234770378451330,48,55,160,350,7,190
-2.234858013546210,36,45,150,200,9,50
-2.234887095942570,64,70,150,475,6,325
-2.2350310745462000,52,60,140,200,8,60
-2.2350424846853200,48,55,60,350,7,290
-2.235176875422390,48,55,120,400,7,280
-2.235338815922620,48,55,70,475,7,405
-2.2353607703953700,64,70,80,475,6,395
-2.235403881555690,100,105,180,425,5,245
-2.235492237769310,42,50,70,375,8,305
-2.235521450848800,42,50,110,475,8,365
-2.2355479709921200,48,55,50,450,7,400
-2.23561940049934,64,70,120,400,6,280
-2.235728468404030,48,55,70,375,7,305
-2.2357495420135000,42,50,70,225,8,155
-2.235951327550280,48,55,110,450,7,340
-2.2360669984001500,48,55,90,450,7,360
-2.2360737517209200,64,70,160,450,6,290
-2.2360806612331600,64,70,130,425,6,295
-2.2360832578384600,100,105,130,450,5,320
-2.236142014715250,42,50,200,400,8,200
-2.236161790210960,100,105,170,375,5,205
-2.2364335940831100,54,60,170,500,6,330
-2.236472298207500,54,60,170,350,6,180
-2.2364854210155200,48,55,170,425,7,255
-2.236680619139100,64,70,200,425,6,225
-2.2369207786091800,88,95,80,150,7,70
-2.2370603738741100,42,50,70,475,8,405
-2.2370744072444200,100,105,180,450,5,270
-2.2372260776981200,64,70,180,400,6,220
-2.2373544785867400,70,75,200,500,5,300
-2.2374900776182200,90,95,130,325,5,195
-2.237512686961380,48,55,90,400,7,310
-2.2375422948351900,42,50,180,425,8,245
-2.2375887623360700,64,70,160,300,6,140
-2.237740810012280,64,70,190,350,6,160
-2.2378272752202000,52,60,70,175,8,105
-2.2383270634198800,64,70,70,375,6,305
-2.2385974091925200,68,75,110,175,7,65
-2.2385996120303100,64,70,60,400,6,340
-2.2386950066449900,64,70,180,375,6,195
-2.2387913311315200,100,105,100,425,5,325
-2.2388953549603000,90,95,140,325,5,185
-2.239136376098170,54,60,100,450,6,350
-2.2392082092766500,64,70,60,325,6,265
-2.239330544840640,66,75,90,150,9,60
-2.2395457603921400,42,50,130,425,8,295
-2.2396061511477000,48,55,120,225,7,105
-2.2397203776362200,78,85,190,225,7,35
-2.2400427176154200,42,50,70,450,8,380
-2.2401502619897900,100,105,70,500,5,430
-2.240172661124080,48,55,170,450,7,280
-2.240211550857810,100,105,120,475,5,355
-2.240409092571710,98,105,100,175,7,75
-2.240447360768800,74,80,200,275,6,75
-2.240636273130400,84,90,120,300,6,180
-2.2406627367841900,56,65,130,175,9,45
-2.2406679242192000,66,75,130,175,9,45
-2.2407010115193700,80,85,180,500,5,320
-2.2407184537531400,74,80,110,200,6,90
-2.2407992982461500,42,50,150,400,8,250
-2.2408183842656000,64,70,90,350,6,260
-2.240827712851230,64,70,140,450,6,310
-2.240919575191320,64,70,140,425,6,285
-2.2410402018520700,64,70,190,400,6,210
-2.2411354650705200,48,55,150,400,7,250
-2.241153126764830,42,50,150,450,8,300
-2.2412086980827800,64,70,100,250,6,150
-2.2413880390211000,64,70,50,275,6,225
-2.241455314275790,64,70,110,425,6,315
-2.241813126624350,54,60,90,475,6,385
-2.242066690020470,72,80,80,150,8,70
-2.242420116726930,78,85,200,250,7,50
-2.242586721389220,54,60,150,500,6,350
-2.2425943475229800,64,70,80,275,6,195
-2.242650816499520,48,55,50,475,7,425
-2.2427251134764800,64,70,80,450,6,370
-2.242739803733260,48,55,130,225,7,95
-2.242744083045640,42,50,180,400,8,220
-2.242831786491230,42,50,120,400,8,280
-2.242906374520390,84,90,160,225,6,65
-2.242979767585050,54,60,170,475,6,305
-2.2430017563379000,74,80,190,275,6,85
-2.243116769946150,100,105,200,400,5,200
-2.243286924847520,54,60,190,450,6,260
-2.243300921199960,52,60,80,175,8,95
-2.243360197024660,64,70,90,425,6,335
-2.2438282286707400,48,55,60,400,7,340
-2.2439000698692100,100,105,110,475,5,365
-2.2441168433713500,58,65,190,275,7,85
-2.2441214351664200,90,95,170,275,5,105
-2.2442500313468000,64,70,200,300,6,100
-2.244288395825560,100,105,50,375,5,325
-2.2442958252544300,100,105,50,425,5,375
-2.244499601182190,100,105,160,350,5,190
-2.2445046417359400,48,55,200,400,7,200
-2.2445914338602800,58,65,60,200,7,140
-2.2447342379582200,54,60,120,500,6,380
-2.2447420525194200,48,55,60,375,7,315
-2.2447615313196700,42,50,200,300,8,100
-2.2448206950347600,64,70,150,350,6,200
-2.2449829524924600,42,50,190,400,8,210
-2.2450963717589900,42,50,120,425,8,305
-2.2451111495440800,100,105,200,425,5,225
-2.2452180728732900,96,105,80,125,9,45
-2.245260717096960,80,85,120,450,5,330
-2.245279488842110,48,55,170,300,7,130
-2.245460714773460,54,60,100,475,6,375
-2.245533665650460,82,90,90,150,8,60
-2.245601787288330,64,70,200,350,6,150
-2.2456420840357100,42,50,110,450,8,340
-2.2456658551850400,46,55,50,150,9,100
-2.245784950151830,64,70,70,450,6,380
-2.245792373821770,42,50,170,450,8,280
-2.2458618007436700,64,70,80,500,6,420
-2.2461248473049200,90,95,160,225,5,65
-2.246135264834820,100,105,150,450,5,300
-2.246362069930840,42,50,200,425,8,225
-2.246439653263270,42,50,140,450,8,310
-2.2465315400777100,56,65,140,175,9,35
-2.246697337735470,64,70,130,375,6,245
-2.2467364156466500,64,70,190,425,6,235
-2.246750274452930,48,55,200,425,7,225
-2.246902329624580,48,55,140,425,7,285
-2.2469182319025700,100,105,180,375,5,195
-2.2469387081301400,36,45,60,200,9,140
-2.246958164366610,100,105,170,450,5,280
-2.2469788320464100,54,60,170,375,6,205
-2.247003264442140,98,105,200,250,7,50
-2.24703021790803,48,55,160,325,7,165
-2.2471185429959900,100,105,140,450,5,310
-2.2476104787360100,84,90,180,275,6,95
-2.247648725252150,36,45,180,225,9,45
-2.2476512371318300,100,105,150,400,5,250
-2.2478028943793200,48,55,140,400,7,260
-2.2478362556637500,56,65,200,225,9,25
-2.2478487255638600,48,55,150,350,7,200
-2.248011752893890,48,55,130,250,7,120
-2.248154554757200,54,60,170,400,6,230
-2.248245199087600,66,75,200,225,9,25
-2.2482472053568700,66,75,50,125,9,75
-2.2483206425719200,54,60,110,500,6,390
-2.24834283886112,48,55,70,450,7,380
-2.2485133553313900,42,50,140,425,8,285
-2.2485284807775800,64,70,140,375,6,235
-2.2487529550224600,54,60,100,425,6,325
-2.248754278577110,64,70,150,425,6,275
-2.2488610035076900,64,70,80,375,6,295
-2.2489177428057600,100,105,140,475,5,335
-2.248948495203090,48,55,80,475,7,395
-2.2490930877972200,48,55,180,400,7,220
-2.2491875563820800,100,105,50,450,5,400
-2.249321857105020,58,65,90,200,7,110
-2.249357795558720,48,55,120,425,7,305
-2.249450610193880,48,55,190,400,7,210
-2.2495323316496200,48,55,150,450,7,300
-2.2495378980762900,54,60,90,400,6,310
-2.249597055599300,54,60,50,350,6,300
-2.2497096012501200,64,70,150,225,6,75
-2.2497948942612800,100,105,120,400,5,280
-2.249814387775880,54,60,50,425,6,375
-2.2498246458777000,64,70,200,375,6,175
-2.2500363532947600,48,55,160,300,7,140
-2.250056077376820,54,60,160,425,6,265
-2.250296387819370,42,50,190,425,8,235
-2.2505112016888300,100,105,170,325,5,155
-2.250519340829300,42,50,150,425,8,275
-2.2505920569220100,64,70,130,250,6,120
-2.2507478279631000,58,65,180,225,7,45
-2.250798624235210,84,90,150,200,6,50
-2.250832241218020,48,55,140,450,7,310
-2.250916411323250,48,55,80,500,7,420
-2.2510422464674800,54,60,80,250,6,170
-2.2512374917750900,42,50,140,275,8,135
-2.251278526657050,100,105,130,400,5,270
-2.251353588531510,62,70,100,150,8,50
-2.251452525273240,100,105,70,450,5,380
-2.2515801250781300,100,105,130,425,5,295
-2.2516018778894800,42,50,120,250,8,130
-2.251726506811440,64,70,150,325,6,175
-2.251795657580100,100,105,60,400,5,340
-2.251948439200480,80,85,170,500,5,330
-2.251971447074450,100,105,150,475,5,325
-2.252147570916270,46,55,200,250,9,50
-2.252181534137320,70,75,200,475,5,275
-2.2522259528832200,78,85,120,175,7,55
-2.252241975878520,100,105,80,475,5,395
-2.2522664370065300,42,50,140,375,8,235
-2.252267207285690,54,60,180,475,6,295
-2.2523534955852200,48,55,130,375,7,245
-2.2523630264449300,64,70,70,425,6,355
-2.2524109836681500,48,55,90,350,7,260
-2.2524113943169300,54,60,50,400,6,350
-2.252479182400480,42,50,180,375,8,195
-2.252482012775740,42,50,80,475,8,395
-2.2525110130250100,54,60,60,425,6,365
-2.2525474650786400,64,70,140,475,6,335
-2.252660685172590,48,55,100,225,7,125
-2.2528109863858,58,65,110,200,7,90
-2.2528406693295500,48,55,200,300,7,100
-2.2528491903282000,64,70,100,400,6,300
-2.2529951053678700,100,105,50,400,5,350
-2.25300087330499,48,55,150,325,7,175
-2.253237366079650,42,50,80,450,8,370
-2.253268835498220,74,80,90,200,6,110
-2.2534537670149000,42,50,140,400,8,260
-2.253574422952230,48,55,80,450,7,370
-2.2535934195273700,58,65,160,200,7,40
-2.253630785369100,72,80,90,150,8,60
-2.2537216762018500,100,105,50,500,5,450
-2.253772159324540,74,80,50,200,6,150
-2.2539056525402900,42,50,160,300,8,140
-2.2539206586257800,48,55,130,425,7,295
-2.2541518125803800,64,70,190,375,6,185
-2.2542226286533200,100,105,60,425,5,365
-2.2542729515950300,100,105,80,250,5,170
-2.25430900782644,42,50,90,350,8,260
-2.2544320113896100,54,60,50,450,6,400
-2.254528056183170,54,60,160,350,6,190
-2.254566584021080,42,50,80,500,8,420
-2.2546134103756600,64,70,170,300,6,130
-2.254618784985060,58,65,50,200,7,150
-2.2546925846494100,84,90,80,200,6,120
-2.2547476159978900,80,85,160,475,5,315
-2.2549718399886100,48,55,150,475,7,325
-2.255027380867550,48,55,90,425,7,335
-2.255050824780970,74,80,180,225,6,45
-2.2550608649837000,100,105,90,450,5,360
-2.2552585159607400,48,55,140,250,7,110
-2.255401409626800,100,105,200,300,5,100
-2.255446005759690,54,60,170,425,6,255
-2.2554848921547600,58,65,180,250,7,70
-2.2554937792776200,64,70,160,375,6,215
-2.255524947163820,54,60,70,225,6,155
-2.2555667550781500,48,55,90,375,7,285
-2.2556042998530100,64,70,140,250,6,110
-2.255683761507370,100,105,110,425,5,315
-2.255712728883850,54,60,140,500,6,360
-2.2558866381287800,42,50,100,400,8,300
-2.255905276697610,64,70,120,250,6,130
-2.255972325659750,42,50,130,375,8,245
-2.256064660157990,42,50,50,275,8,225
-2.256065330243260,64,70,100,225,6,125
-2.2561665025733000,42,50,130,250,8,120
-2.2564277122595300,42,50,190,375,8,185
-2.256444301306370,92,100,110,150,8,40
-2.256469229830810,80,85,100,500,5,400
-2.2564811253561900,100,105,190,425,5,235
-2.2565123087986300,80,85,200,450,5,250
-2.256540862434360,36,45,50,200,9,150
-2.2565453866136500,100,105,50,475,5,425
-2.2567388928160500,42,50,70,425,8,355
-2.256793842614350,100,105,70,475,5,405
-2.25679577754032,100,105,90,400,5,310
-2.2568641999620700,64,70,90,375,6,285
-2.2568980485527500,48,55,150,425,7,275
-2.25690602580379,94,100,200,250,6,50
-2.25697445404134,42,50,110,425,8,315
-2.2570672111604600,64,70,140,275,6,135
-2.2573295034199200,48,55,80,375,7,295
-2.2573726713476400,64,70,180,325,6,145
-2.2573863942601300,48,55,110,425,7,315
-2.2574199934467800,80,85,90,500,5,410
-2.2574714833712300,42,50,90,300,8,210
-2.2574775113243,98,105,60,150,7,90
-2.257513672712020,100,105,190,400,5,210
-2.257824485756810,42,50,140,225,8,85
-2.25790131112491,54,60,130,500,6,370
-2.2581351431315900,64,70,90,225,6,135
-2.2581371535199800,36,45,200,275,9,75
-2.2581721152098300,46,55,60,150,9,90
-2.2582703745505100,54,60,160,475,6,315
-2.2583490229420400,54,60,170,325,6,155
-2.258362093075940,42,50,180,325,8,145
-2.2584034365217100,90,95,80,200,5,120
-2.2584376464773500,46,55,190,225,9,35
-2.258463028990310,36,45,180,250,9,70
-2.2584653439028300,68,75,190,250,7,60
-2.2585953857870200,54,60,90,250,6,160
-2.258651266016390,48,55,200,375,7,175
-2.258654451526380,48,55,190,425,7,235
-2.2587224117228600,42,50,150,325,8,175
-2.2588854435840800,48,55,180,375,7,195
-2.2590595197929100,100,105,120,425,5,305
-2.2592127374954800,42,50,160,375,8,215
-2.2592403712504300,48,55,140,275,7,135
-2.2593546939508700,100,105,190,350,5,160
-2.2594150986789000,42,50,190,350,8,160
-2.259457570416940,82,90,100,150,8,50
-2.2595677844169900,64,70,60,475,6,415
-2.259765607386610,48,55,190,350,7,160
-2.259782450599040,72,80,100,150,8,50
-2.259832504810320,90,95,180,275,5,95
-2.260066491376210,54,60,160,325,6,165
-2.260101616411020,42,50,200,375,8,175
-2.2601761436816100,74,80,160,200,6,40
-2.260216287937620,88,95,130,175,7,45
-2.260487528470120,42,50,90,425,8,335
-2.26049759377133,100,105,130,375,5,245
-2.260542020874230,100,105,70,375,5,305
-2.260749980690990,48,55,140,375,7,235
-2.260830174028770,100,105,150,350,5,200
-2.2609507291789400,64,70,60,500,6,440
-2.261239212440730,36,45,190,275,9,85
-2.261242380467330,66,75,140,175,9,35
-2.261272142160140,100,105,180,400,5,220
-2.26140580912259,52,60,190,250,8,60
-2.261583306896710,94,100,50,150,6,100
-2.2616127962192200,42,50,150,350,8,200
-2.2616405875113600,100,105,140,400,5,260
-2.2617828316700400,64,70,120,350,6,230
-2.2617894840423200,64,70,180,350,6,170
-2.2618023399177700,48,55,50,275,7,225
-2.261922448121660,42,50,60,475,8,415
-2.2620306385679600,54,60,130,475,6,345
-2.262077334210960,58,65,100,200,7,100
-2.2621926291848500,52,60,90,175,8,85
-2.2622758216973800,100,105,90,425,5,335
-2.2623137903383700,100,105,120,225,5,105
-2.262316739562400,42,50,90,225,8,135
-2.262415484386240,84,90,180,250,6,70
-2.262469567861460,54,60,160,400,6,240
-2.2626392536064600,64,70,60,300,6,240
-2.2626979053295500,100,105,80,450,5,370
-2.2627580132166100,54,60,120,225,6,105
-2.2628212484787400,42,50,100,225,8,125
-2.2628299248085700,42,50,80,225,8,145
-2.262834104934870,90,95,120,300,5,180
-2.262988372091310,82,90,130,175,8,45
-2.262992479685400,42,50,80,375,8,295
-2.2630028403230000,80,85,150,500,5,350
-2.263019613574450,54,60,70,375,6,305
-2.2630631446452400,48,55,70,425,7,355
-2.263077568776610,54,60,130,400,6,270
-2.2631235681837500,42,50,170,300,8,130
-2.2632330767834700,100,105,60,350,5,290
-2.2632903652307200,84,90,200,275,6,75
-2.263372021461140,96,105,90,125,9,35
-2.263439046093320,42,50,80,275,8,195
-2.2634668424787000,100,105,160,325,5,165
-2.2634791354149700,42,50,200,350,8,150
-2.26353802377407,80,85,90,475,5,385
-2.2635890301245700,100,105,110,450,5,340
-2.263666541190120,100,105,140,425,5,285
-2.2636838239545300,54,60,70,500,6,430
-2.2637559774875000,48,55,180,350,7,170
-2.263771927025180,100,105,50,350,5,300
-2.263861144734030,48,55,200,350,7,150
-2.2639141203612400,80,85,120,500,5,380
-2.2641440144356700,48,55,90,225,7,135
-2.264213737176740,42,50,160,450,8,290
-2.264271159229520,100,105,190,375,5,185
-2.2643193706900900,84,90,60,200,6,140
-2.264496233258610,70,75,190,500,5,310
-2.264523046446940,100,105,150,425,5,275
-2.264527211515680,48,55,180,325,7,145
-2.264559711677220,42,50,140,475,8,335
-2.2646026526856800,100,105,80,500,5,420
-2.2646030254116700,54,60,130,450,6,320
-2.2646322754162100,54,60,50,500,6,450
-2.264785824913750,74,80,100,200,6,100
-2.2648305286719700,62,70,90,150,8,60
-2.264849643451530,48,55,100,250,7,150
-2.2648504858544900,88,95,100,150,7,50
-2.264911905396640,64,70,80,350,6,270
-2.264961247090040,48,55,190,375,7,185
-2.2651686083219000,48,55,90,275,7,185
-2.2651851739282100,92,100,180,200,8,20
-2.2652018760333200,80,85,170,350,5,180
-2.2652163281269200,42,50,90,375,8,285
-2.265357393402520,42,50,140,250,8,110
-2.265507621347130,54,60,50,475,6,425
-2.265562680252490,100,105,200,375,5,175
-2.265677248421140,64,70,70,250,6,180
-2.2658791301834700,100,105,160,450,5,290
-2.2660012803664700,68,75,90,175,7,85
-2.2660545849581400,64,70,180,300,6,120
-2.2661093767986300,54,60,120,400,6,280
-2.2661587642403700,48,55,140,350,7,210
-2.26628697468966,48,55,100,400,7,300
-2.266546297729350,64,70,90,300,6,210
-2.2667102629581800,48,55,160,450,7,290
-2.2667558715381600,64,70,70,275,6,205
-2.2668236238137100,46,55,120,175,9,55
-2.2668645996991500,54,60,140,400,6,260
-2.266930441340510,54,60,120,475,6,355
-2.2671143452936600,64,70,80,425,6,345
-2.2672030383090700,100,105,160,300,5,140
-2.267311331123060,76,85,50,100,9,50
-2.267398583837350,48,55,80,275,7,195
-2.26741685419892,64,70,140,225,6,85
-2.2674674238860300,100,105,90,250,5,160
-2.2675123820369100,100,105,70,225,5,155
-2.267515917510110,58,65,50,175,7,125
-2.2676439476488200,54,60,130,225,6,95
-2.267667445426580,48,55,110,400,7,290
-2.2680019553596300,64,70,140,350,6,210
-2.2680947445445400,42,50,80,425,8,345
-2.2681807707654800,98,105,190,225,7,35
-2.2682027338424000,36,45,90,200,9,110
-2.268242224607210,64,70,200,325,6,125
-2.2682773521533100,84,90,170,225,6,55
-2.2682850444661200,64,70,190,325,6,135
-2.268395713319580,36,45,110,200,9,90
-2.2684465238408500,70,75,180,500,5,320
-2.268528482379950,90,95,190,275,5,85
-2.2686221405449100,82,90,140,175,8,35
-2.2686432466529000,80,85,160,425,5,265
-2.268665740086050,54,60,60,350,6,290
-2.2689929761014500,68,75,50,150,7,100
-2.269000564945340,80,85,130,500,5,370
-2.2690071672169300,54,60,180,425,6,245
-2.2690263926292400,54,60,110,475,6,365
-2.2690469125302300,48,55,140,475,7,335
-2.269124610242090,64,70,100,350,6,250
-2.269129254769500,90,95,170,225,5,55
-2.2691725055785600,42,50,90,275,8,185
-2.269225956484060,54,60,150,450,6,300
-2.269334634610120,42,50,150,225,8,75
-2.269339994736520,80,85,180,475,5,295
-2.269425521770590,90,95,200,275,5,75
-2.2694376149710700,36,45,160,200,9,40
-2.269504803727510,64,70,110,400,6,290
-2.2697165572354900,42,50,140,350,8,210
-2.2697372934929400,54,60,90,350,6,260
-2.269755015660590,42,50,70,250,8,180
-2.2697586151074600,100,105,60,475,5,415
-2.2698735792851900,72,80,50,125,8,75
-2.26988366231582,100,105,60,375,5,315
-2.2699907597190000,100,105,80,375,5,295
-2.2701836627342100,80,85,170,475,5,305
-2.2702015708355400,70,75,190,475,5,285
-2.2703469126597700,42,50,60,300,8,240
-2.2704032197950100,64,70,80,225,6,145
-2.270460345427110,36,45,100,200,9,100
-2.270527645401490,98,105,170,200,7,30
-2.2705387679085900,54,60,60,375,6,315
-2.270582081857880,42,50,80,350,8,270
-2.270719413252010,64,70,100,275,6,175
-2.270771749251340,100,105,200,350,5,150
-2.2707789314673500,48,55,80,350,7,270
-2.270858885879750,88,95,200,225,7,25
-2.2708718673289500,42,50,100,250,8,150
-2.2709023311828000,64,70,130,350,6,220
-2.270973236506020,52,60,170,200,8,30
-2.2710335657022300,100,105,170,300,5,130
-2.2713493910557500,42,50,70,275,8,205
-2.2714201528321300,42,50,180,350,8,170
-2.2714231815483100,48,55,90,300,7,210
-2.271496704952530,96,105,50,100,9,50
-2.2716876521185200,80,85,170,425,5,255
-2.2717587695337700,64,70,90,275,6,185
-2.2721480546059100,54,60,150,400,6,250
-2.272164989410320,90,95,150,200,5,50
-2.2722208611136700,54,60,120,425,6,305
-2.2722632508972300,48,55,60,475,7,415
-2.2722742448503600,48,55,60,300,7,240
-2.27227512489399,58,65,130,200,7,70
-2.272275868775740,94,100,170,200,6,30
-2.272364848044060,98,105,120,175,7,55
-2.2724218684936500,94,100,190,225,6,35
-2.272529300566420,54,60,90,450,6,360
-2.272670978078090,80,85,170,400,5,230
-2.2727960217840200,48,55,80,225,7,145
-2.2728073570833600,68,75,170,200,7,30
-2.2729628835732300,100,105,130,250,5,120
-2.2731453931325500,100,105,130,225,5,95
-2.2732101606683300,42,50,110,400,8,290
-2.273311521144030,74,80,120,200,6,80
-2.2733873605309800,100,105,150,325,5,175
-2.2733959628090800,74,80,50,175,6,125
-2.2734134376484400,94,100,60,150,6,90
-2.273445493655550,42,50,190,325,8,135
-2.273524758802020,48,55,60,500,7,440
-2.2736358544745100,48,55,160,375,7,215
-2.273721483425430,54,60,60,325,6,265
-2.2737610950769300,100,105,60,500,5,440
-2.273835065471190,54,60,200,400,6,200
-2.27436789632634,100,105,90,350,5,260
-2.274390726964850,100,105,140,375,5,235
-2.2744139811748500,54,60,180,400,6,220
-2.2744237725642800,64,70,110,250,6,140
-2.2745010941580400,54,60,140,450,6,310
-2.2748161891025200,84,90,190,275,6,85
-2.2748748622232700,54,60,150,475,6,325
-2.2748753724073800,100,105,70,425,5,355
-2.274982470656110,70,75,120,450,5,330
-2.275215370035040,42,50,60,500,8,440
-2.2752247244380900,62,70,200,225,8,25
-2.275340871000170,100,105,100,400,5,300
-2.275585844794380,94,100,120,175,6,55
-2.2756566398022300,48,55,190,325,7,135
-2.275715420702620,80,85,100,450,5,350
-2.2757945976239200,72,80,200,225,8,25
-2.27590192557002,62,70,130,175,8,45
-2.275994431313720,100,105,190,325,5,135
-2.276090115477670,58,65,120,200,7,80
-2.276243784140460,88,95,140,175,7,35
-2.2764032642070800,54,60,200,425,6,225
-2.2765704723943100,54,60,200,300,6,100
-2.2765811680814400,90,95,60,200,5,140
-2.2766297610065100,62,70,50,125,8,75
-2.2767609838876500,48,55,150,225,7,75
-2.276789052751670,80,85,140,500,5,360
-2.277039273078650,80,85,110,500,5,390
-2.277045156317210,42,50,100,375,8,275
-2.277131490855770,100,105,60,325,5,265
-2.277395979986600,42,50,200,325,8,125
-2.2775122412660000,48,55,140,225,7,85
-2.277574971126830,48,55,120,250,7,130
-2.2775888988228200,84,90,110,200,6,90
-2.2776534344453600,64,70,100,375,6,275
-2.277804622298510,54,60,170,450,6,280
-2.277837966955490,100,105,160,375,5,215
-2.2779056820681100,64,70,50,300,6,250
-2.2779592696479600,54,60,180,450,6,270
-2.2780295370293900,64,70,60,450,6,390
-2.2780438573210100,54,60,70,475,6,405
-2.2780579980756300,80,85,50,375,5,325
-2.278185772918610,42,50,70,350,8,280
-2.278375625159800,80,85,100,475,5,375
-2.2784286154851000,80,85,190,450,5,260
-2.278464816494070,88,95,90,150,7,60
-2.278480830969430,80,85,130,475,5,345
-2.2786159023158100,48,55,80,425,7,345
-2.27877690721088,72,80,130,175,8,45
-2.2789103792534900,90,95,110,200,5,90
-2.278916584297710,64,70,70,350,6,280
-2.2789780957547500,48,55,100,275,7,175
-2.2792180012751900,54,60,100,225,6,125
-2.279229744448570,54,60,60,400,6,340
-2.27935414236252,100,105,180,350,5,170
-2.2796008806336700,48,55,200,325,7,125
-2.2798098067875000,80,85,120,475,5,355
-2.2798997152205600,52,60,100,175,8,75
-2.2799451542878300,64,70,100,325,6,225
-2.2801341049206600,42,50,70,325,8,255
-2.2802979704211600,64,70,190,300,6,110
-2.2803171652858600,48,55,70,350,7,280
-2.280525252007810,48,55,100,325,7,225
-2.280920092304340,68,75,100,175,7,75
-2.281135739963440,64,70,80,400,6,320
-2.281300825176170,48,55,70,275,7,205
-2.2813393727650800,54,60,130,425,6,295
-2.281505016409830,64,70,70,400,6,330
-2.2815626826159600,42,50,120,350,8,230
-2.2815915747461300,48,55,70,250,7,180
-2.2816228688791600,100,105,80,225,5,145
-2.281673286077860,64,70,100,300,6,200
-2.28177599312788,70,75,90,500,5,410
-2.281912328979620,80,85,100,425,5,325
-2.281917901562300,98,105,70,150,7,80
-2.2819582240711900,82,90,50,125,8,75
-2.2819997916610500,100,105,80,350,5,270
-2.2822285309268400,100,105,180,325,5,145
-2.282275991414740,98,105,80,150,7,70
-2.2824090658211900,48,55,70,400,7,330
-2.2825699164239100,80,85,50,425,5,375
-2.2826445830161200,42,50,110,250,8,140
-2.2827067778841300,80,85,160,350,5,190
-2.28271176290065,48,55,110,250,7,140
-2.2827901773770400,100,105,140,275,5,135
-2.282812915892880,80,85,50,350,5,300
-2.282874009678900,42,50,100,275,8,175
-2.2829631310572700,36,45,50,175,9,125
-2.282984979173300,100,105,90,375,5,285
-2.2830176240668400,70,75,100,500,5,400
-2.283086148988820,64,70,110,275,6,165
-2.283099405031420,100,105,60,450,5,390
-2.2831005649522500,100,105,80,425,5,345
-2.2831133051749200,100,105,100,250,5,150
-2.283125996082500,90,95,180,250,5,70
-2.2831355800882700,42,50,180,300,8,120
-2.2831760222319900,48,55,60,450,7,390
-2.2832321430022000,100,105,180,300,5,120
-2.28327983083864,100,105,110,400,5,290
-2.283394942478810,48,55,180,300,7,120
-2.2834117463070300,52,60,50,150,8,100
-2.2834509946416100,100,105,120,350,5,230
-2.283486643132330,48,55,100,375,7,275
-2.283514170771860,74,80,140,200,6,60
-2.2836602779032500,100,105,80,275,5,195
-2.283675044241640,92,100,60,125,8,65
-2.2838238576319600,80,85,70,500,5,430
-2.2838922335558700,62,70,140,175,8,35
-2.283934770463350,42,50,190,300,8,110
-2.2839349263136600,64,70,120,275,6,155
-2.28396156119375,64,70,120,375,6,255
-2.283964423738800,54,60,150,350,6,200
-2.28416904581591,64,70,90,325,6,235
-2.284481183671310,54,60,180,375,6,195
-2.284543598827780,54,60,80,450,6,370
-2.2845882941106200,100,105,140,350,5,210
-2.2847061814156600,84,90,50,200,6,150
-2.284754076581850,42,50,60,450,8,390
-2.2847590710774100,64,70,70,325,6,255
-2.2847761933710700,54,60,80,475,6,395
-2.2848683507685500,54,60,110,450,6,340
-2.2849495268139800,64,70,150,375,6,225
-2.285037600635480,84,90,100,200,6,100
-2.2850856743476100,58,65,140,200,7,60
-2.285277850299810,54,60,130,375,6,245
-2.2855378649703700,54,60,150,325,6,175
-2.285968941304860,64,70,160,275,6,115
-2.2861008597943300,64,70,110,350,6,240
-2.2861239769177900,54,60,80,500,6,420
-2.286258845267790,100,105,110,350,5,240
-2.286295604315910,48,55,110,225,7,115
-2.2863206801272400,36,45,120,200,9,80
-2.2863537707805700,84,90,90,200,6,110
-2.2863664347578800,42,50,100,325,8,225
-2.286423889366900,80,85,160,400,5,240
-2.286473313397150,80,85,180,425,5,245
-2.286513412870740,90,95,50,200,5,150
-2.286520368747780,48,55,80,400,7,320
-2.2868515021120100,80,85,110,475,5,365
-2.2869028313304000,80,85,170,375,5,205
-2.2869332037442500,70,75,160,500,5,340
-2.2871060925401500,86,95,50,100,9,50
-2.287440520769370,54,60,190,400,6,210
-2.287691887598790,42,50,100,300,8,200
-2.2879190572409200,48,55,120,350,7,230
-2.288040568161320,42,50,80,400,8,320
-2.288100214259330,48,55,110,275,7,165
-2.2881785024866500,42,50,120,375,8,255
-2.288185710715070,54,60,140,250,6,110
-2.2884327623119800,54,60,140,425,6,285
-2.28844478606728,88,95,50,125,7,75
-2.288552600705280,42,50,130,350,8,220
-2.2887768311550200,54,60,130,250,6,120
-2.289007195531720,54,60,150,225,6,75
-2.2890644145037100,54,60,70,450,6,380
-2.2890774724969100,100,105,190,300,5,110
-2.2890915586968200,64,70,140,300,6,160
-2.2891232557294100,86,95,80,125,9,45
-2.2891582383626800,80,85,150,450,5,300
-2.289180095777120,56,65,180,200,9,20
-2.289714594986340,64,70,150,300,6,150
-2.289877885055740,74,80,130,200,6,70
-2.2899505143690600,64,70,50,325,6,275
-2.2900180103060900,54,60,90,225,6,135
-2.2900611300701600,54,60,190,425,6,235
-2.29017035486325,100,105,90,300,5,210
-2.2903339477644000,54,60,100,250,6,150
-2.290408207808980,54,60,60,500,6,440
-2.2904934293189300,100,105,70,275,5,205
-2.2904934878031100,42,50,90,325,8,235
-2.2905681257360500,42,50,120,275,8,155
-2.2905818752980400,80,85,130,450,5,320
-2.2906033692278400,54,60,150,425,6,275
-2.2906088212504400,82,90,200,225,8,25
-2.2907358742866600,78,85,70,150,7,80
-2.2907559255214100,80,85,50,500,5,450
-2.2909266097626800,58,65,60,175,7,115
-2.290941636440500,78,85,50,125,7,75
-2.290989483127070,54,60,170,300,6,130
-2.2910044693077400,42,50,150,300,8,150
-2.291194083503850,72,80,140,175,8,35
-2.29180171405461,70,75,200,450,5,250
-2.291962187024360,80,85,180,450,5,270
-2.292133052369780,90,95,90,200,5,110
-2.2922063681920300,100,105,100,225,5,125
-2.292250409083760,100,105,150,375,5,225
-2.2922646319918800,36,45,130,200,9,70
-2.292268058789170,48,55,190,300,7,110
-2.292281788979070,80,85,140,450,5,310
-2.2924066158316000,80,85,170,325,5,155
-2.292423708786000,84,90,180,225,6,45
-2.292485374928250,64,70,110,225,6,115
-2.2926127110582600,80,85,200,400,5,200
-2.292719322318930,100,105,140,250,5,110
-2.2929360112810000,26,35,200,500,9,300
-2.292992614025300,54,60,190,350,6,160
-2.2929992174558000,100,105,90,275,5,185
-2.2930207320446000,100,105,200,325,5,125
-2.293025465668080,80,85,50,400,5,350
-2.2930605230776600,54,60,110,425,6,315
-2.293070807970760,100,105,120,250,5,130
-2.2933001818861000,100,105,110,250,5,140
-2.2935252805597900,80,85,50,450,5,400
-2.2935468572977400,54,60,160,300,6,140
-2.293548404704940,100,105,100,375,5,275
-2.2935492527618000,74,80,60,175,6,115
-2.2935818041209000,100,105,110,375,5,265
-2.2937432468587100,48,55,100,300,7,200
-2.293758247441830,54,60,80,375,6,295
-2.293769684078980,42,50,110,350,8,240
-2.2938416249793800,48,55,50,300,7,250
-2.2940314388964600,80,85,90,400,5,310
-2.294151924604500,48,55,110,350,7,240
-2.2941587377446700,80,85,150,400,5,250
-2.2943414881329800,66,75,180,200,9,20
-2.2944256064160900,64,70,110,375,6,265
-2.294425848049400,42,50,110,375,8,265
-2.294445422328100,100,105,90,225,5,135
-2.294513770310370,42,50,100,350,8,250
-2.2946040059688400,78,85,80,150,7,70
-2.294754059787670,80,85,90,450,5,360
-2.2948879628150600,100,105,70,400,5,330
-2.2949286836745400,42,50,70,300,8,230
-2.295123990731780,38,45,200,500,7,300
-2.295148563851550,56,65,110,150,9,40
-2.295177978253060,80,85,60,425,5,365
-2.295253942613720,80,85,120,225,5,105
-2.2953089381786700,48,55,150,300,7,150
-2.2956970692964500,100,105,120,375,5,255
-2.2957007581452300,100,105,80,400,5,320
-2.295788983745640,80,85,170,450,5,280
-2.2958215483617600,66,75,110,150,9,40
-2.2959305075203100,54,60,70,425,6,355
-2.2959561253453400,42,50,70,400,8,330
-2.296171159001460,70,75,90,475,5,385
-2.296461516993790,100,105,70,350,5,280
-2.296486097143990,92,100,70,125,8,55
-2.2966377353037700,32,40,200,500,8,300
-2.29667402453877,54,60,140,275,6,135
-2.2967455593460100,48,55,90,325,7,235
-2.296985910909350,46,55,70,150,9,80
-2.297007524742650,100,105,50,275,5,225
-2.2971331804104600,54,60,80,225,6,145
-2.297184094145120,80,85,130,400,5,270
-2.297211107659940,42,50,50,250,8,200
-2.297221911273200,54,60,100,400,6,300
-2.297234415874050,54,60,190,375,6,185
-2.2972387281075100,64,70,50,225,6,175
-2.2973526696482700,54,60,140,475,6,335
-2.2977617587829800,100,105,130,350,5,220
-2.2977716528473500,64,70,50,250,6,200
-2.297962835430390,90,95,180,225,5,45
-2.297963223371020,54,60,50,275,6,225
-2.2980264725768700,70,75,180,475,5,295
-2.2980674851685100,80,85,200,425,5,225
-2.2981835103498900,70,75,150,500,5,350
-2.2981954574793600,70,75,170,500,5,330
-2.298265753051430,58,65,70,175,7,105
-2.2982900545899200,54,60,140,375,6,235
-2.2985107200896600,100,105,90,325,5,235
-2.2987022019199100,48,55,120,275,7,155
-2.2987330765697400,80,85,50,475,5,425
-2.298748839827890,48,55,120,375,7,255
-2.2989066978673300,64,70,80,325,6,245
-2.2989841675855500,48,55,110,375,7,265
-2.2990425515436400,80,85,70,225,5,155
-2.299305185120850,54,60,200,350,6,150
-2.2993073181080700,80,85,90,250,5,160
-2.299827119713430,42,50,50,300,8,250
-2.2998411383348500,94,100,70,150,6,80
-2.299875870105430,100,105,150,225,5,75
-2.299893031666490,42,50,110,275,8,165
-2.29999755038776,42,50,60,275,8,215
-2.3000981535785600,54,60,90,375,6,285
-2.300126323158200,48,55,150,375,7,225
-2.3001382404458400,80,85,80,250,5,170
-2.3001869379656900,54,60,80,275,6,195
-2.3002417552930600,42,50,140,300,8,160
-2.3005246410339000,54,60,80,350,6,270
-2.300546420294960,80,85,60,350,5,290
-2.3005585035954900,64,70,60,250,6,190
-2.3006717370712700,100,105,100,275,5,175
-2.300790075427530,80,85,200,300,5,100
-2.300810706737890,54,60,90,425,6,335
-2.300866798711890,80,85,120,425,5,305
-2.300887804234160,42,50,160,275,8,115
-2.300916655538550,54,60,140,225,6,85
-2.300918146682500,48,55,100,350,7,250
-2.301058294025160,52,60,190,225,8,35
-2.3012130584508100,84,90,120,200,6,80
-2.301265777468900,54,60,60,475,6,415
-2.301289490656090,42,50,60,225,8,165
-2.301632683378330,64,70,70,300,6,230
-2.3016769808706600,74,80,70,175,6,105
-2.301979083577060,48,55,60,275,7,215
-2.3020360403560800,100,105,60,300,5,240
-2.3020557582664800,54,60,90,300,6,210
-2.302078565942300,70,75,50,375,5,325
-2.302089914251630,80,85,180,375,5,195
-2.3022059677343400,80,85,120,400,5,280
-2.302240563919070,42,50,110,225,8,115
-2.3023110250216600,48,55,70,325,7,255
-2.302467615864680,80,85,70,475,5,405
-2.302534926368090,48,55,140,300,7,160
-2.3025422954586500,68,75,190,225,7,35
-2.3025435701467800,70,75,120,500,5,380
-2.3026560191646700,80,85,160,325,5,165
-2.302855798909920,54,60,180,325,6,145
-2.3029304060942300,48,55,130,350,7,220
-2.303058399548640,80,85,130,375,5,245
-2.303071572949040,54,60,160,375,6,215
-2.3031106056569100,100,105,100,350,5,250
-2.303128737885320,80,85,180,400,5,220
-2.3033118830462300,54,60,110,400,6,290
-2.303501757649030,42,50,150,375,8,225
-2.303514608010200,78,85,100,150,7,50
-2.3035146114952800,80,85,110,450,5,340
-2.3035422774272400,84,90,50,175,6,125
-2.303713013394770,100,105,70,250,5,180
-2.3037361192604000,48,55,50,225,7,175
-2.303796327321100,90,95,100,200,5,100
-2.303847987561060,54,60,60,300,6,240
-2.3038662819926300,36,45,60,175,9,115
-2.3038689707626700,42,50,50,225,8,175
-2.3038803060766200,64,70,60,225,6,165
-2.3039339659266600,52,60,120,175,8,55
-2.3040615772662400,80,85,150,425,5,275
-2.3041582075141700,42,50,70,200,8,130
-2.3043812800243100,48,55,50,325,7,275
-2.3045921188808000,36,45,70,175,9,105
-2.304730774990520,70,75,170,475,5,305
-2.304829664387250,70,75,170,350,5,180
-2.3048440993502100,68,75,120,175,7,55
-2.3050764886727300,48,55,70,300,7,230
-2.3050885316318000,48,55,160,275,7,115
-2.305139561057940,54,60,160,450,6,290
-2.305206564652580,76,85,80,125,9,45
-2.3055754315466900,92,100,120,150,8,30
-2.3057905588235200,48,55,80,325,7,245
-2.305873173993510,80,85,150,475,5,325
-2.3059070377012600,70,75,50,425,5,375
-2.3063358512821200,100,105,150,300,5,150
-2.306406473746430,84,90,130,200,6,70
-2.3064561083142700,70,75,170,400,5,230
-2.306506363057080,62,70,110,150,8,40
-2.3065085457449800,80,85,140,400,5,260
-2.306636155591010,90,95,50,175,5,125
-2.3066691448925300,42,50,60,250,8,190
-2.3066757984937200,80,85,190,425,5,235
-2.306688550793680,80,85,60,400,5,340
-2.3067040484644000,80,85,150,350,5,200
-2.3070109764067300,54,60,180,350,6,170
-2.307021976392660,80,85,130,225,5,95
-2.307024336943290,46,55,80,150,9,70
-2.307397337501690,42,50,80,325,8,245
-2.3074335421323700,100,105,160,275,5,115
-2.3076334065111900,54,60,140,350,6,210
-2.3076554253741600,70,75,100,450,5,350
-2.3077481922555600,100,105,100,325,5,225
-2.3077568569338000,80,85,140,375,5,235
-2.307834338247250,80,85,130,425,5,295
-2.307853525812240,54,60,70,275,6,205
-2.308032382377910,54,60,200,325,6,125
-2.3080362458210100,70,75,160,425,5,265
-2.3080791464815900,60,65,200,500,5,300
-2.308108558941820,64,70,150,275,6,125
-2.30817976900536,54,60,190,325,6,135
-2.3082628688136200,42,50,50,325,8,275
-2.3083156123137800,100,105,140,225,5,85
-2.308398785155720,64,70,130,275,6,145
-2.3084725141115100,80,85,160,300,5,140
-2.3084734058400500,48,55,110,300,7,190
-2.308577872391430,80,85,70,375,5,305
-2.3086057346263100,64,70,70,200,6,130
-2.308799018390850,70,75,170,375,5,205
-2.308975405729470,80,85,200,350,5,150
-2.3090155910370400,54,60,200,375,6,175
-2.309051849914220,64,70,110,300,6,190
-2.309060251577990,80,85,80,475,5,395
-2.3090706515809700,90,95,120,200,5,80
-2.309160811817620,70,75,180,450,5,270
-2.309180611285580,48,55,60,225,7,165
-2.3093040605518200,94,100,80,150,6,70
-2.3093565275060900,100,105,110,275,5,165
-2.3095921653777600,80,85,190,350,5,160
-2.309627538494350,68,75,60,150,7,90
-2.3098348562781800,42,50,150,250,8,100
-2.309951153385190,80,85,190,400,5,210
-2.3099576673010200,32,40,190,500,8,310
-2.310227935923430,54,60,80,425,6,345
-2.310247480354590,70,75,160,400,5,240
-2.3103199299460700,64,70,160,250,6,90
-2.310459512765910,80,85,140,425,5,285
-2.3105212031185500,54,60,90,275,6,185
-2.310569598685090,54,60,120,250,6,130
-2.310584282875780,36,45,140,200,9,60
-2.3109203399464500,64,70,150,250,6,100
-2.310944943654040,80,85,60,325,5,265
-2.311055539608040,70,75,190,450,5,260
-2.3110916216885800,52,60,60,150,8,90
-2.3116440591177400,70,75,100,475,5,375
-2.3117143668965200,54,60,70,350,6,280
-2.3117657016917000,80,85,60,375,5,315
-2.3118558975320600,64,70,130,300,6,170
-2.3119285057287600,72,80,110,150,8,40
-2.312185431387370,42,50,110,300,8,190
-2.312347409559810,58,65,110,175,7,65
-2.3124320401818200,100,105,110,225,5,115
-2.3124606828041300,64,70,110,325,6,215
-2.3125515942299500,80,85,80,500,5,420
-2.3127047223002700,64,70,170,250,6,80
-2.312764678794840,84,90,60,175,6,115
-2.313079600499930,54,60,100,275,6,175
-2.3131671961732300,80,85,170,300,5,130
-2.3132858099865900,70,75,130,500,5,370
-2.31336105451614,42,50,150,275,8,125
-2.313428936240480,54,60,70,250,6,180
-2.3134340838823300,26,35,190,475,9,285
-2.313493508216190,54,60,120,350,6,230
-2.3136147084181100,64,70,60,275,6,215
-2.313632477567700,92,100,150,175,8,25
-2.313812735261210,42,50,130,275,8,145
-2.3139688666456100,100,105,80,325,5,245
-2.3140945131509100,56,65,150,175,9,25
-2.314149363101210,70,75,130,225,5,95
-2.3141836523904600,82,90,110,150,8,40
-2.314647954398720,54,60,60,450,6,390
-2.3146559295142400,100,105,100,300,5,200
-2.3146846599818900,76,85,160,175,9,15
-2.314903828493440,80,85,110,425,5,315
-2.3149454348834100,80,85,150,325,5,175
-2.31494612012963,70,75,130,400,5,270
-2.314963102958530,80,85,130,250,5,120
-2.315017457858340,54,60,120,375,6,255
-2.3150485169175100,42,50,170,250,8,80
-2.3151269497306700,48,55,170,250,7,80
-2.315187096266500,70,75,90,250,5,160
-2.3154682766050800,80,85,70,450,5,380
-2.3155096283636900,52,60,200,250,8,50
-2.315670366322990,100,105,120,275,5,155
-2.3156956610451800,90,95,130,200,5,70
-2.315876822395650,80,85,80,450,5,370
-2.3160093953567700,48,55,70,200,7,130
-2.316077327443540,70,75,110,500,5,390
-2.31610712101676,54,60,110,225,6,115
-2.316228251393250,70,75,70,500,5,430
-2.316274894709030,100,105,70,325,5,255
-2.3163367897942800,100,105,140,300,5,160
-2.3165049124540600,70,75,50,350,5,300
-2.3165713223260500,54,60,100,325,6,225
-2.3169099939400100,64,70,120,325,6,205
-2.317021276529840,80,85,90,425,5,335
-2.31705005719543,70,75,140,500,5,360
-2.317113836468690,64,70,130,325,6,195
-2.317130439209640,80,85,160,375,5,215
-2.3171366734509,48,55,50,250,7,200
-2.317165563252210,68,75,200,250,7,50
-2.3172430782138400,54,60,90,325,6,235
-2.317635086651760,54,60,50,300,6,250
-2.3176675202706800,54,60,110,350,6,240
-2.3177472716341200,88,95,110,150,7,40
-2.3177555391677500,90,95,60,175,5,115
-2.3179838010453700,48,55,150,250,7,100
-2.318049114396220,26,35,190,500,9,310
-2.3181910129238500,80,85,60,500,5,440
-2.3182671241500600,42,50,80,300,8,220
-2.3185045989705300,48,55,80,300,7,220
-2.318654973368530,80,85,90,350,5,260
-2.318667520827660,48,55,60,250,7,190
-2.3188096271221300,36,45,80,175,9,95
-2.318834345772490,80,85,140,475,5,335
-2.3188756662514800,54,60,120,275,6,155
-2.318886791978100,32,40,200,475,8,275
-2.3191617132766300,70,75,120,225,5,105
-2.3192079261190400,42,50,120,325,8,205
-2.319221412137470,60,65,200,475,5,275
-2.319334968996420,74,80,90,175,6,85
-2.31936766527926,74,80,80,175,6,95
-2.3194032712504200,76,85,90,125,9,35
-2.319403943930000,54,60,100,300,6,200
-2.3194295051574200,100,105,130,275,5,145
-2.319455816730990,48,55,160,250,7,90
-2.319502131174620,70,75,160,475,5,315
-2.3195519599177200,80,85,100,400,5,300
-2.319618849776670,48,55,150,275,7,125
-2.319794883162320,70,75,80,250,5,170
-2.319997966194300,54,60,180,300,6,120
-2.3200267656088900,54,60,80,400,6,320
-2.320117779112080,26,35,200,475,9,275
-2.3201426264395200,70,75,130,450,5,320
-2.320207432155620,80,85,160,450,5,290
-2.3202669573133300,80,85,190,375,5,185
-2.3202686806800100,64,70,80,300,6,220
-2.320377109141190,58,65,80,175,7,95
-2.320455122979880,54,60,110,250,6,140
-2.320677137837180,80,85,60,475,5,415
-2.320737812893800,96,105,160,175,9,15
-2.3207848295568500,70,75,160,350,5,190
-2.3208147066478900,64,70,140,325,6,185
-2.32092952767929,70,75,170,450,5,280
-2.3209677274137,70,75,170,425,5,255
-2.3210290490932200,54,60,110,375,6,265
-2.3212344824904600,36,45,110,175,9,65
-2.3213789246380700,74,80,110,175,6,65
-2.321487651945430,80,85,100,225,5,125
-2.321593002219980,80,85,140,250,5,110
-2.3217148009812600,80,85,70,425,5,355
-2.3218528799576500,48,55,140,325,7,185
-2.3219130558633600,100,105,70,300,5,230
-2.3219375039478100,70,75,60,425,5,365
-2.3223899648155000,46,55,100,150,9,50
-2.3224369283872100,38,45,190,500,7,310
-2.3226143969971900,100,105,150,275,5,125
-2.3226315006542900,48,55,160,225,7,65
-2.3226401905386000,84,90,70,175,6,105
-2.3226900804843100,70,75,120,475,5,355
-2.322875018640630,38,45,120,450,7,330
-2.3230701697200900,70,75,200,400,5,200
-2.323083465443240,70,75,60,350,5,290
-2.3233612288161300,80,85,190,325,5,135
-2.323718550426890,42,50,130,300,8,170
-2.3238261988290800,70,75,50,450,5,400
-2.3238874336943400,54,60,70,325,6,255
-2.3241229182197300,38,45,200,475,7,275
-2.324146162710520,48,55,130,300,7,170
-2.32430347005275,84,90,160,200,6,40
-2.3243051879997900,54,60,50,225,6,175
-2.324321567752360,100,105,110,300,5,190
-2.324460924311930,74,80,190,250,6,60
-2.324547653211100,70,75,60,325,5,265
-2.3245893240622800,70,75,110,475,5,365
-2.324641169242360,32,40,180,500,8,320
-2.324800795863090,54,60,100,375,6,275
-2.324802715288120,54,60,150,375,6,225
-2.324825110529600,82,90,60,125,8,65
-2.3248937459813100,70,75,50,475,5,425
-2.3248975747971700,58,65,190,250,7,60
-2.3252770492838800,90,95,160,200,5,40
-2.325335974187020,42,50,160,250,8,90
-2.325477314473000,54,60,70,400,6,330
-2.325660277025300,80,85,180,350,5,170
-2.3257577471255100,80,85,200,375,5,175
-2.326094967024840,48,55,130,275,7,145
-2.3261789825282100,54,60,100,350,6,250
-2.3261862575470000,70,75,50,500,5,450
-2.326266802890100,54,60,150,300,6,150
-2.3263424519343300,70,75,150,450,5,300
-2.3263769229669600,54,60,130,350,6,220
-2.326546815039270,70,75,100,425,5,325
-2.3267157070269700,80,85,100,250,5,150
-2.3267308866072400,80,85,180,325,5,145
-2.326756654849320,62,70,180,200,8,20
-2.326862532372810,70,75,50,400,5,350
-2.3268927873931600,58,65,90,175,7,85
-2.327000048430890,80,85,80,375,5,295
-2.3272388989208500,90,95,70,175,5,105
-2.3274213299275200,26,35,180,500,9,320
-2.3274886020523300,80,85,140,350,5,210
-2.327513470478840,32,40,190,475,8,285
-2.3275665304748800,54,60,160,275,6,115
-2.3275761204959500,70,75,140,450,5,310
-2.327613071173840,100,105,50,300,5,250
-2.327874811656390,42,50,110,325,8,215
-2.328019415711970,80,85,140,275,5,135
-2.3280839236638500,38,45,190,475,7,285
-2.3282537259258800,80,85,80,350,5,270
-2.3283441515521900,58,65,170,200,7,30
-2.32864386616098,80,85,50,275,5,225
-2.3287049782312300,100,105,120,325,5,205
-2.328754227893940,80,85,150,225,5,75
-2.329114097966650,100,105,70,200,5,130
-2.3293883245378200,70,75,70,225,5,155
-2.32966200461908,80,85,90,275,5,185
-2.3299409081168200,60,65,190,500,5,310
-2.329949481746270,84,90,140,200,6,60
-2.3299507209646400,64,70,160,225,6,65
-2.3306021351320900,80,85,90,375,5,285
-2.3306210242617100,70,75,90,450,5,360
-2.330657111529680,66,75,60,125,9,65
-2.3308568228667800,78,85,140,175,7,35
-2.3308759079857000,80,85,90,225,5,135
-2.3309384608531900,70,75,170,325,5,155
-2.3309837832611200,38,45,160,500,7,340
-2.33106522752347,84,90,110,175,6,65
-2.3311842113732400,80,85,80,425,5,345
-2.3315462513446000,100,105,140,325,5,185
-2.3316475418097300,70,75,120,400,5,280
-2.331890604570370,70,75,120,425,5,305
-2.332242783325140,100,105,150,250,5,100
-2.332740253774510,70,75,160,325,5,165
-2.3329300763109000,80,85,70,350,5,280
-2.3333129470663300,70,75,130,475,5,345
-2.333373511078560,80,85,80,400,5,320
-2.333379640399740,54,60,140,300,6,160
-2.3334852463420000,60,65,190,475,5,285
-2.3336107093152200,70,75,150,400,5,250
-2.3337160337566800,80,85,80,275,5,195
-2.3337409654431800,78,85,90,150,7,60
-2.3337629781076000,48,55,120,325,7,205
-2.333847826136250,98,105,130,175,7,45
-2.3340858461499100,72,80,180,200,8,20
-2.3341359126230800,60,65,180,500,5,320
-2.334213660359390,92,100,80,125,8,45
-2.3342899599283800,90,95,140,200,5,60
-2.334399988649840,38,45,180,500,7,320
-2.3348484755029400,80,85,110,400,5,290
-2.3348514291765700,78,85,130,175,7,45
-2.3350384712173200,100,105,130,300,5,170
-2.335552615624070,70,75,140,425,5,285
-2.3355746525785500,54,60,190,300,6,110
-2.335718114734010,80,85,60,300,5,240
-2.3357972614592800,100,105,60,250,5,190
-2.335875842406670,80,85,120,250,5,130
-2.33590253541119,56,65,120,150,9,30
-2.336153061160240,100,105,50,325,5,275
-2.336195736851200,48,55,110,325,7,215
-2.3363876343473900,70,75,180,425,5,245
-2.3364988359750600,54,60,70,300,6,230
-2.3365792085462700,54,60,110,275,6,165
-2.3366224580897200,98,105,90,150,7,60
-2.3367509297611000,54,60,60,225,6,165
-2.336837824684730,80,85,180,300,5,120
-2.3368485802507000,54,60,170,250,6,80
-2.3369598948936000,100,105,170,250,5,80
-2.3370033059089600,80,85,100,275,5,175
-2.3370152002267500,80,85,120,350,5,230
-2.337292415357040,42,50,140,325,8,185
-2.337352536713390,78,85,200,225,7,25
-2.337385572803920,42,50,130,325,8,195
-2.337479840581350,76,85,130,150,9,20
-2.337498502947870,80,85,200,325,5,125
-2.337596792876600,84,90,190,250,6,60
-2.3376617621385300,70,75,180,400,5,220
-2.337807386175200,80,85,90,300,5,210
-2.337859843908270,70,75,150,475,5,325
-2.3378833933808400,26,35,160,500,9,340
-2.33790042878772,70,75,160,300,5,140
-2.3380292011157600,70,75,90,400,5,310
-2.338053222342250,32,40,160,500,8,340
-2.338261299630090,98,105,100,150,7,50
-2.3383237469141400,80,85,80,225,5,145
-2.3384744927916000,54,60,150,250,6,100
-2.338600853232110,46,55,90,150,9,60
-2.3386092344403300,70,75,110,450,5,340
-2.338664125287530,32,40,150,500,8,350
-2.3387678645030100,70,75,60,375,5,315
-2.3388399954648500,54,60,60,250,6,190
-2.338886680762370,42,50,160,225,8,65
-2.3389734581417300,66,75,120,150,9,30
-2.3392887777006400,64,70,170,275,6,105
-2.3393845107483700,42,50,170,275,8,105
-2.3395901820619400,96,100,200,500,4,300
-2.3396152113672600,64,70,80,200,6,120
-2.3398248342615600,36,45,90,175,9,85
-2.33993615231572,48,55,170,275,7,105
-2.3401533732579700,64,70,120,300,6,180
-2.3401545719836900,80,85,70,275,5,205
-2.340252203621740,70,75,70,475,5,405
-2.3402628762801000,82,90,180,200,8,20
-2.3403820621923300,80,85,140,225,5,85
-2.340393173517560,70,75,90,225,5,135
-2.3404274266931100,80,85,70,250,5,180
-2.3404394237257600,70,75,60,400,5,340
-2.3404780224996100,70,75,80,450,5,370
-2.340564569508810,46,55,200,225,9,25
-2.3406747967976300,70,75,130,375,5,245
-2.340693269395820,54,60,50,325,6,275
-2.341020863744220,60,65,160,500,5,340
-2.3412970219518100,96,105,130,150,9,20
-2.3417659447173200,38,45,200,450,7,250
-2.3418249666063000,74,80,100,175,6,75
-2.3419695926283000,26,35,120,450,9,330
-2.34200389983956,100,105,80,300,5,220
-2.3422032443169100,74,80,50,150,6,100
-2.342244166855830,58,65,100,175,7,75
-2.3422947906559600,84,90,80,175,6,95
-2.3423525103067400,58,65,50,150,7,100
-2.3424360347330000,64,70,150,200,6,50
-2.3425597232161200,70,75,130,425,5,295
-2.3427499108320200,54,60,80,325,6,245
-2.342824395532230,70,75,200,300,5,100
-2.342986792306930,64,70,180,275,6,95
-2.3430382454833300,32,40,120,450,8,330
-2.343048117281770,80,85,100,350,5,250
-2.343241107360860,70,75,190,425,5,235
-2.3432607494714200,100,105,160,250,5,90
-2.3432613065149600,100,105,130,325,5,195
-2.3434425254856200,90,95,80,175,5,95
-2.343445908028920,38,45,90,500,7,410
-2.3434855445658800,54,60,70,200,6,130
-2.343777449697320,100,105,60,275,5,215
-2.343824093656210,32,40,90,500,8,410
-2.3439112405763900,80,85,90,325,5,235
-2.344055405915500,70,75,140,475,5,335
-2.344058547509740,80,85,120,375,5,255
-2.3441049543583300,80,85,100,325,5,225
-2.3442130476039100,80,85,60,450,5,390
-2.3442271498819200,32,40,50,375,8,325
-2.3442309847844600,70,75,190,400,5,210
-2.3444109992720800,80,85,50,300,5,250
-2.344753242342890,54,60,80,300,6,220
-2.344818036886520,60,65,100,500,5,400
-2.3450541945075400,80,85,110,250,5,140
-2.345170135894700,32,40,100,500,8,400
-2.345436873808700,76,85,60,100,9,40
-2.3454533228955300,84,90,90,175,6,85
-2.3454691595214800,70,75,200,425,5,225
-2.345477759569800,54,60,110,300,6,190
-2.3455091673496200,70,75,180,375,5,195
-2.345527083855920,60,65,90,500,5,410
-2.3455607824193600,80,85,100,375,5,275
-2.345637261413370,70,75,150,425,5,275
-2.346229242860360,70,75,70,375,5,305
-2.3462779090085000,70,75,140,400,5,260
-2.34655168224567,100,105,110,325,5,215
-2.346587125038350,88,95,180,200,7,20
-2.346646131124540,26,35,100,500,9,400
-2.347064977654180,94,100,100,150,6,50
-2.3471165039024100,100,105,170,275,5,105
-2.347341099658100,56,65,60,125,9,65
-2.3473611092919100,86,95,160,175,9,15
-2.34750766569745,100,105,120,300,5,180
-2.347694229634040,70,75,160,450,5,290
-2.347735466028230,80,85,120,275,5,155
-2.3478628985390000,100,105,60,225,5,165
-2.3478847445614700,70,75,130,250,5,120
-2.3478911203918000,48,55,130,325,7,195
-2.3479171904255400,70,75,150,350,5,200
-2.348005882733380,48,55,150,200,7,50
-2.3480244829077700,70,75,70,425,5,355
-2.3480654887857300,32,40,170,500,8,330
-2.3481699778371500,94,100,50,125,6,75
-2.3481980173756200,70,75,190,350,5,160
-2.3483128330878200,96,100,180,500,4,320
-2.348316219340440,72,80,150,175,8,25
-2.348417079614920,54,60,60,275,6,215
-2.3485915864532200,54,60,150,275,6,125
-2.348826081423050,100,105,50,250,5,200
-2.34891010315669,32,40,200,450,8,250
-2.349022025824090,70,75,100,225,5,125
-2.3492280680190100,60,65,170,475,5,305
-2.349329455076470,70,75,80,350,5,270
-2.3493682641126400,46,55,130,175,9,45
-2.349372791271750,52,60,80,150,8,70
-2.3495107770934600,80,85,110,350,5,240
-2.3496190036921700,48,55,180,275,7,95
-2.349754396675630,70,75,190,375,5,185
-2.349836557408750,70,75,150,225,5,75
-2.349870766831360,70,75,80,500,5,420
-2.349958054239370,60,65,90,475,5,385
-2.350325339099670,54,60,50,250,6,200
-2.350519613481810,42,50,150,200,8,50
-2.350562460276510,90,95,190,250,5,60
-2.350697806798760,70,75,90,350,5,260
-2.3507652486526600,72,80,60,125,8,65
-2.351594825573190,36,45,190,250,9,60
-2.351931901776850,80,85,190,300,5,110
-2.352023405430800,74,80,170,200,6,30
-2.3520549754668000,68,75,70,150,7,80
-2.352125409966590,70,75,80,475,5,395
-2.3523029656192700,32,40,90,475,8,385
-2.352435580246350,38,45,50,375,7,325
-2.3524923349495300,32,40,50,350,8,300
-2.352543204514070,80,85,70,400,5,330
-2.3526163280449300,60,65,120,450,5,330
-2.3527057053080300,64,70,170,225,6,55
-2.35277317406865,80,85,100,300,5,200
-2.352877022999920,70,75,100,400,5,300
-2.3529050373205100,100,105,50,225,5,175
-2.35295689660979,80,85,110,375,5,265
-2.3530710577879100,42,50,180,275,8,95
-2.3531518704350900,82,90,70,125,8,55
-2.35322414220029,70,75,70,450,5,380
-2.353268004413760,54,60,130,275,6,145
-2.3534164878552900,90,95,110,175,5,65
-2.353451152365920,80,85,110,225,5,115
-2.3534521344782400,98,105,50,125,7,75
-2.353541276086650,88,95,60,125,7,65
-2.3536880829705900,96,100,190,500,4,310
-2.3537884608191200,70,75,80,275,5,195
-2.353934488462670,26,35,50,375,9,325
-2.354364363718380,94,100,130,175,6,45
-2.3544072289259200,80,85,150,375,5,225
-2.354436936414420,88,95,70,125,7,55
-2.354534784459650,32,40,170,400,8,230
-2.3545739769325700,54,60,160,225,6,65
-2.354894477632860,32,40,170,350,8,180
-2.355085644999340,26,35,80,250,9,170
-2.355175316741710,70,75,170,300,5,130
-2.3552444537333600,70,75,140,275,5,135
-2.3552613417288000,94,100,200,225,6,25
-2.3554188315776200,70,75,50,275,5,225
-2.355428800183640,42,50,170,225,8,55
-2.3555360461666800,52,60,70,150,8,80
-2.3558677712725500,60,65,200,450,5,250
-2.355897584949030,48,55,80,200,7,120
-2.3559528753079200,54,60,130,300,6,170
-2.356094852861500,56,65,70,125,9,55
-2.356106774598930,86,95,90,125,9,35
-2.3562196425768100,42,50,120,300,8,180
-2.356329825662400,66,75,150,175,9,25
-2.3564897256017900,80,85,130,350,5,220
-2.3565182135438800,32,40,50,425,8,375
-2.3565518293873000,32,40,120,500,8,380
-2.35666822883803,32,40,170,475,8,305
-2.3566706885099000,60,65,50,375,5,325
-2.3567035567588400,38,45,100,500,7,400
-2.3569987436179600,80,85,160,275,5,115
-2.357300129651620,70,75,100,250,5,150
-2.3574209315392500,26,35,170,350,9,180
-2.3574373694778200,94,100,90,150,6,60
-2.3574561254454200,70,75,120,250,5,130
-2.3575289848116000,92,100,50,100,8,50
-2.3577890597185100,38,45,90,475,7,385
-2.357863679158130,26,35,50,350,9,300
-2.3581157427776600,38,45,160,425,7,265
-2.358250172567270,32,40,50,400,8,350
-2.358631570694150,60,65,170,500,5,330
-2.3588973431705800,64,70,200,275,6,75
-2.359047575837780,70,75,140,225,5,85
-2.3591376009175100,26,35,90,500,9,410
-2.3592352176708200,70,75,150,325,5,175
-2.359278329659420,70,75,140,375,5,235
-2.3592854252287300,70,75,60,475,5,415
-2.3594640923763400,32,40,100,450,8,350
-2.359522835530870,66,75,70,125,9,55
-2.3595254689781800,80,85,110,300,5,190
-2.35960188954794,42,50,80,200,8,120
-2.35974521303071,70,75,200,325,5,125
-2.360013800994930,80,85,150,300,5,150
-2.3600473945038700,54,60,160,250,6,90
-2.3600477527194200,70,75,80,375,5,295
-2.360171199196200,82,90,120,150,8,30
-2.3603360710512700,38,45,170,500,7,330
-2.360371109084540,32,40,100,475,8,375
-2.3603863528423200,32,40,70,225,8,155
-2.3605418205547800,32,40,130,500,8,370
-2.360663426745540,26,35,170,500,9,330
-2.3607185081945400,48,55,120,300,7,180
-2.3608516472212500,42,50,200,275,8,75
-2.360928667909450,100,105,180,275,5,95
-2.361014855396210,60,65,120,500,5,380
-2.3611365779645500,70,75,140,250,5,110
-2.361205374579510,96,100,200,475,4,275
-2.361412897819890,78,85,110,150,7,40
-2.3620093652609200,80,85,80,325,5,245
-2.3620868267245600,38,45,180,475,7,295
-2.3622392762222700,32,40,120,225,8,105
-2.3622497692057500,70,75,110,425,5,315
-2.3622698085557500,70,75,180,350,5,170
-2.3622877591174900,70,75,200,350,5,150
-2.362477440703070,70,75,60,300,5,240
-2.362485117534010,54,60,140,325,6,185
-2.362509005273290,70,75,60,500,5,440
-2.362530546377660,38,45,120,500,7,380
-2.362545921197050,60,65,180,475,5,295
-2.3626649558628,26,35,60,325,9,265
-2.362750181342290,26,35,200,450,9,250
-2.3629615244543400,100,105,80,200,5,120
-2.3629965262301800,32,40,190,450,8,260
-2.3631923639743800,32,40,160,425,8,265
-2.3632378286138200,26,35,50,400,9,350
-2.3632391801553500,36,45,170,200,9,30
-2.3633556682215200,38,45,100,475,7,375
-2.363868566411370,36,45,100,175,9,75
-2.3638849934652400,98,105,140,175,7,35
-2.3641355776156700,70,75,160,375,5,215
-2.3642868855839900,98,105,200,225,7,25
-2.364385838819930,80,85,110,275,5,165
-2.364450697921310,60,65,170,350,5,180
-2.3645743526478300,26,35,50,425,9,375
-2.3648163028056500,32,40,130,475,8,345
-2.3648493738672500,60,65,150,500,5,350
-2.3650153493736800,96,100,170,350,4,180
-2.365054493786210,60,65,50,350,5,300
-2.3650644244665000,90,95,50,150,5,100
-2.3651323654334700,60,65,170,375,5,205
-2.365152555462700,58,65,190,225,7,35
-2.365163525406580,100,105,160,225,5,65
-2.365249629342690,60,65,100,450,5,350
-2.365274707716820,80,85,50,325,5,275
-2.3652777581478100,26,35,170,400,9,230
-2.3652937685766000,70,75,80,225,5,145
-2.3653632139804400,48,55,200,275,7,75
-2.3654664606525200,46,55,50,125,9,75
-2.3656530399986300,70,75,180,300,5,120
-2.3657018688392000,84,90,50,150,6,100
-2.365738421332450,32,40,160,400,8,240
-2.365821085324380,26,35,90,475,9,385
-2.365824937360760,96,100,190,475,4,285
-2.3658338424174000,70,75,190,325,5,135
-2.365897516233240,26,35,150,500,9,350
-2.3660111567175700,84,90,100,175,6,75
-2.3660816087091600,32,40,180,475,8,295
-2.3661014615515500,70,75,90,425,5,335
-2.3661893845660400,70,75,90,375,5,285
-2.3661931252013800,26,35,120,225,9,105
-2.3662679162117800,32,40,50,500,8,450
-2.366383564992440,38,45,150,500,7,350
-2.366409100017530,70,75,110,400,5,290
-2.36644687299849,38,45,170,400,7,230
-2.3665027230925800,80,85,70,325,5,255
-2.366586410799440,26,35,170,375,9,205
-2.3667003138704800,38,45,50,425,7,375
-2.366833374281400,54,60,150,200,6,50
-2.366844536899920,62,70,60,125,8,65
-2.3668877660012400,38,45,170,350,7,180
-2.3669246712586200,32,40,60,425,8,365
-2.3669898783707100,46,55,140,175,9,35
-2.36699317294173,72,80,120,150,8,30
-2.3670616110198100,38,45,190,450,7,260
-2.3671606758030500,48,55,170,225,7,55
-2.3672711386665300,86,95,130,150,9,20
-2.3674654171314500,80,85,70,300,5,230
-2.367469048545470,26,35,170,475,9,305
-2.3674892485467700,100,105,190,275,5,85
-2.3675316929206800,70,75,100,275,5,175
-2.3675971784011600,70,75,90,300,5,210
-2.3676391381865200,70,75,90,275,5,185
-2.367645742951410,64,70,180,250,6,70
-2.3676547897325500,70,75,80,425,5,345
-2.3676685904865100,80,85,140,300,5,160
-2.3677286933277700,52,60,200,225,8,25
-2.3677335537448400,26,35,120,500,9,380
-2.367941168987360,60,65,50,400,5,350
-2.3681737340092900,60,65,160,425,5,265
-2.368254792745090,60,65,130,500,5,370
-2.368504248061170,80,85,60,250,5,190
-2.3685996230843700,48,55,190,275,7,85
-2.3686525617581400,60,65,110,500,5,390
-2.3687011230958,70,75,140,350,5,210
-2.3687148378808400,96,100,160,500,4,340
-2.368768910789300,74,80,190,225,6,35
-2.3690023163949300,26,35,180,475,9,295
-2.3690287088616300,70,75,110,250,5,140
-2.369259352702700,62,70,120,150,8,30
-2.369445451314920,54,60,110,325,6,215
-2.369471682424200,60,65,50,425,5,375
-2.369471951239150,100,105,200,275,5,75
-2.3696848480324400,32,40,90,250,8,160
-2.3697454799909900,32,40,80,250,8,170
-2.3698017259551500,84,90,170,200,6,30
-2.369947306827140,70,75,70,250,5,180
-2.369993353534960,38,45,110,500,7,390
-2.37001580269789,54,60,170,275,6,105
-2.3701401261387500,60,65,170,400,5,230
-2.370204100207930,54,60,120,325,6,205
-2.370248445716410,80,85,130,275,5,145
-2.3702611930558500,64,70,180,225,6,45
-2.3704527751866100,26,35,100,450,9,350
-2.370480827003590,60,65,90,250,5,160
-2.3705799557636100,70,75,120,350,5,230
-2.3706827163437300,32,40,130,225,8,95
-2.370687109111550,70,75,180,325,5,145
-2.3707821743935800,38,45,170,475,7,305
-2.370824506908010,88,95,120,150,7,30
-2.370902837835570,42,50,180,225,8,45
-2.3710578723529000,90,95,90,175,5,85
-2.3711020149970400,88,95,150,175,7,25
-2.371126918530640,42,50,110,200,8,90
-2.371208476984130,80,85,170,250,5,80
-2.371315669411040,38,45,140,500,7,360
-2.37137090131844,64,70,190,275,6,85
-2.371388593551670,68,75,80,150,7,70
-2.3716504715152100,60,65,100,475,5,375
-2.3718258092399200,70,75,70,275,5,205
-2.3723921591152100,32,40,140,500,8,360
-2.37258444974101,96,105,60,100,9,40
-2.373145200895950,26,35,90,250,9,160
-2.3731899741066300,38,45,70,225,7,155
-2.373293016151200,38,45,100,450,7,350
-2.3734895174449500,70,75,200,375,5,175
-2.373515770453780,60,65,190,450,5,260
-2.3737960136797300,26,35,190,450,9,260
-2.3740672142576100,60,65,140,500,5,360
-2.3740910567824700,80,85,50,225,5,175
-2.3741302538955800,64,70,60,200,6,140
-2.374240311106770,32,40,110,500,8,390
-2.3742466176879400,58,65,120,175,7,55
-2.374249793905750,100,105,180,250,5,70
-2.374322120344210,96,100,170,500,4,330
-2.374702408306400,26,35,50,450,9,400
-2.3748806877965200,70,75,70,350,5,280
-2.3748864655625400,70,75,100,325,5,225
-2.374972404632510,38,45,50,350,7,300
-2.375096901156110,64,70,110,200,6,90
-2.37524122970913,64,70,90,200,6,110
-2.3752865658540200,80,85,60,225,5,165
-2.3754653458346900,38,45,130,500,7,370
-2.375744675430710,98,105,110,150,7,40
-2.3758450225689800,26,35,50,500,9,450
-2.3761008934914200,42,50,60,200,8,140
-2.3761429677562900,70,75,100,375,5,275
-2.3762943388345800,54,60,130,325,6,195
-2.376333634579090,70,75,60,450,5,390
-2.3764675744166000,64,70,50,200,6,150
-2.376517202267840,80,85,70,200,5,130
-2.3768674529126100,38,45,160,350,7,190
-2.376947749811770,26,35,130,500,9,370
-2.37700361320545,60,65,100,425,5,325
-2.3770277543517100,96,100,150,500,4,350
-2.377132406819550,70,75,50,250,5,200
-2.37713992112261,38,45,170,425,7,255
-2.3773220814764100,36,45,50,150,9,100
-2.3773280562137900,26,35,70,225,9,155
-2.377381015447040,60,65,70,225,5,155
-2.3775035976971300,38,45,70,500,7,430
-2.3775188850105,62,70,150,175,8,25
-2.3778425912119500,94,100,140,175,6,35
-2.377861562230820,32,40,70,500,8,430
-2.3779126640504500,70,75,50,300,5,250
-2.3780618337467400,52,60,100,150,8,50
-2.3781295641426000,86,95,60,100,9,40
-2.378177694648270,80,85,140,325,5,185
-2.37833042431683,66,75,50,100,9,50
-2.378379738186910,26,35,100,475,9,375
-2.3784366901618,80,85,150,275,5,125
-2.3784586895827000,60,65,60,425,5,365
-2.378466254824950,74,80,200,250,6,50
-2.378479094587720,32,40,50,450,8,400
-2.378576360656190,32,40,130,400,8,270
-2.378784808526680,48,55,180,225,7,45
-2.3788128054108700,32,40,70,475,8,405
-2.379040774648360,26,35,160,425,9,265
-2.3790614306746600,26,35,60,375,9,315
-2.3790804578511300,44,50,200,500,6,300
-2.379095995452510,96,100,120,450,4,330
-2.379376183316000,38,45,50,400,7,350
-2.379410273394520,80,85,160,250,5,90
-2.3794381038381400,70,75,90,325,5,235
-2.3794982313492000,32,40,50,475,8,425
-2.379553445904520,70,75,130,350,5,220
-2.3800083775155700,26,35,160,350,9,190
-2.3800726281145600,80,85,150,250,5,100
-2.3801724072837600,48,55,60,200,7,140
-2.380343111907650,32,40,170,375,8,205
-2.3804126112050900,38,45,80,250,7,170
-2.3804307594921100,60,65,50,500,5,450
-2.3805758073794700,80,85,120,325,5,205
-2.3805865905436400,80,85,130,300,5,170
-2.380631852553830,76,85,190,200,9,10
-2.3807002141599200,26,35,140,500,9,360
-2.3807633016482900,26,35,170,425,9,255
-2.380786499583140,42,50,180,250,8,70
-2.3809084282416400,100,105,150,200,5,50
-2.3809422608079800,26,35,90,350,9,260
-2.381417734348810,62,70,70,125,8,55
-2.3814563262195700,32,40,170,425,8,255
-2.3814758123428900,38,45,90,400,7,310
-2.381843082928580,60,65,70,500,5,430
-2.381879062889260,96,100,100,500,4,400
-2.3819426881820700,26,35,160,400,9,240
-2.381951351273180,60,65,160,325,5,165
-2.3820433247639200,26,35,130,225,9,95
-2.38222739058156,90,95,100,175,5,75
-2.382264297231920,36,45,190,225,9,35
-2.382309890887560,38,45,130,450,7,320
-2.3823182761063000,60,65,170,325,5,155
-2.3824066422250300,60,65,60,350,5,290
-2.3825387048896500,60,65,160,350,5,190
-2.3825644872899200,60,65,160,400,5,240
-2.3826965991615600,38,45,120,475,7,355
-2.382703102553450,68,75,50,125,7,75
-2.3828291930866500,32,40,120,475,8,355
-2.3828638098744400,70,75,110,350,5,240
-2.382908591504210,60,65,80,250,5,170
-2.382914897493920,54,60,120,300,6,180
-2.3831026106847300,48,55,180,250,7,70
-2.3831974548492400,80,85,50,250,5,200
-2.3832129119312300,32,40,60,350,8,290
-2.38322787753246,60,65,120,475,5,355
-2.3833461469911700,60,65,50,475,5,425
-2.383368982074600,82,90,150,175,8,25
-2.3835249859675500,26,35,60,425,9,365
-2.3835874331583200,70,75,80,400,5,320
-2.3836076577701100,32,40,90,450,8,360
-2.3837112392351500,60,65,170,425,5,255
-2.383901544586010,42,50,190,275,8,85
-2.3841122037329000,70,75,100,300,5,200
-2.384193193016490,26,35,120,475,9,355
-2.384201249757910,60,65,60,375,5,315
-2.384237871003190,42,50,50,200,8,150
-2.3843572233065300,32,40,170,325,8,155
-2.3846362778877,60,65,160,475,5,315
-2.3847791133344900,100,105,90,200,5,110
-2.384877560556330,26,35,60,350,9,290
-2.384884485540000,52,60,50,125,8,75
-2.3849005798100900,38,45,60,425,7,365
-2.3849185743545400,32,40,160,475,8,315
-2.3849259447525500,96,100,90,500,4,410
-2.384952310569930,26,35,130,400,9,270
-2.385103923656690,32,40,60,375,8,315
-2.385160149327720,32,40,160,350,8,190
-2.385276426874730,100,105,170,225,5,55
-2.3853849151594700,70,75,160,275,5,115
-2.385402242204230,60,65,110,475,5,365
-2.3854174398478000,26,35,70,375,9,305
-2.385509270031750,26,35,130,475,9,345
-2.3855231378015300,60,65,130,225,5,95
-2.3855664145397500,90,95,170,200,5,30
-2.3855876113050300,70,75,120,375,5,255
-2.3856115380702300,38,45,60,350,7,290
-2.3857116405713100,74,80,120,175,6,55
-2.3859301269803200,26,35,150,400,9,250
-2.386118579503110,90,95,60,150,5,90
-2.3862068206606200,58,65,200,250,7,50
-2.3862225329888100,42,50,90,200,8,110
-2.3862884565993100,60,65,50,450,5,400
-2.386390184524740,38,45,160,400,7,240
-2.3864006048513000,38,45,100,425,7,325
-2.386437187840640,32,40,200,400,8,200
-2.386530597454300,80,85,110,325,5,215
-2.3866191567134600,32,40,170,450,8,280
-2.3866570075530200,60,65,120,225,5,105
-2.3867299330838900,80,85,80,300,5,220
-2.386820289637590,32,40,130,450,8,320
-2.386931487456480,64,70,100,200,6,100
-2.3869753054443200,70,75,120,275,5,155
-2.3870083477088700,38,45,170,325,7,155
-2.3870627415511700,70,75,70,325,5,255
-2.387132806876120,80,85,60,275,5,215
-2.387151172148230,26,35,70,500,9,430
-2.3871846918065500,56,65,50,100,9,50
-2.3872957867029300,32,40,180,425,8,245
-2.387344532091320,38,45,200,400,7,200
-2.387388922487980,96,100,200,450,4,250
-2.3874399199928000,36,45,60,150,9,90
-2.3875041639657900,80,85,170,275,5,105
-2.3876394461809000,26,35,50,475,9,425
-2.3876812400737300,38,45,160,475,7,315
-2.3878528841790900,38,45,140,425,7,285
-2.388144715833320,74,80,60,150,6,90
-2.3882586113736300,32,40,50,275,8,225
-2.3882768162907800,96,100,120,500,4,380
-2.388385601160970,32,40,100,425,8,325
-2.388500910542790,96,100,50,375,4,325
-2.3885939133236300,38,45,110,475,7,365
-2.3886820129335500,100,105,110,200,5,90
-2.38881139289259,38,45,50,450,7,400
-2.3888485251602300,96,100,90,475,4,385
-2.3889359472088500,96,105,190,200,9,10
-2.388954057860920,38,45,170,375,7,205
-2.3889599911898100,32,40,180,400,8,220
-2.389074525735970,70,75,150,375,5,225
-2.3891303839976800,38,45,50,500,7,450
-2.3892212113166700,60,65,130,400,5,270
-2.3893214481209300,48,55,110,200,7,90
-2.389345200607500,60,65,150,475,5,325
-2.389431368209880,26,35,100,425,9,325
-2.3894422366842900,32,40,200,425,8,225
-2.389529843955700,64,70,160,200,6,40
-2.3895406090277100,60,65,130,375,5,245
-2.3896243479499400,60,65,150,450,5,300
-2.3896503224221500,60,65,160,300,5,140
-2.38972889686823,70,75,50,225,5,175
-2.389873363920660,36,45,200,250,9,50
-2.3900011489327400,26,35,120,400,9,280
-2.390031767624700,32,40,70,375,8,305
-2.390090637793350,26,35,170,325,9,155
-2.390119458971920,64,70,50,175,6,125
-2.3902788328703000,32,40,120,425,8,305
-2.3903833150181500,60,65,180,450,5,270
-2.3903983053156900,96,100,170,475,4,305
-2.390421444141410,60,65,130,475,5,345
-2.3908198899687300,54,60,170,225,6,55
-2.3909360805957600,60,65,130,450,5,320
-2.3910394326866600,26,35,90,400,9,310
-2.391158760073970,32,40,90,350,8,260
-2.391163957477820,84,90,60,150,6,90
-2.3912756205434100,32,40,110,475,8,365
-2.3912917876595400,26,35,160,475,9,315
-2.3914191766196400,70,75,70,400,5,330
-2.3915121925475400,78,85,180,200,7,20
-2.391584629420910,26,35,60,400,9,340
-2.3916057689486300,32,40,60,325,8,265
-2.391613220973920,70,75,100,350,5,250
-2.3916762227117800,70,75,60,225,5,165
-2.3916813221432100,26,35,110,500,9,390
-2.391835463273320,32,40,90,400,8,310
-2.3918958184464000,46,55,180,200,9,20
-2.3920566965950400,32,40,150,450,8,300
-2.392179866850640,38,45,90,250,7,160
-2.392384520345710,60,65,150,400,5,250
-2.392405553923160,48,55,50,200,7,150
-2.392561885536100,26,35,130,450,9,320
-2.3927911712315500,84,90,200,250,6,50
-2.392849057978620,68,75,100,150,7,50
-2.392915321460710,92,100,90,125,8,35
-2.3929527907158400,96,105,100,125,9,25
-2.393442648410180,96,100,180,475,4,295
-2.393462360650310,32,40,140,450,8,310
-2.3934722943624000,38,45,130,475,7,345
-2.3935295103264,42,50,100,200,8,100
-2.3935629309031500,42,50,160,200,8,40
-2.3936080477564200,42,50,50,175,8,125
-2.3937318544222600,60,65,60,325,5,265
-2.393732062601840,60,65,90,350,5,260
-2.393840783392780,38,45,120,400,7,280
-2.3940479594452800,32,40,150,475,8,325
-2.3942002297687700,60,65,200,400,5,200
-2.3943140485752400,54,60,80,200,6,120
-2.3943335100871700,32,40,150,400,8,250
-2.3945168561334200,70,75,50,325,5,275
-2.3947035702756300,38,45,60,325,7,265
-2.3947448682106100,38,45,160,325,7,165
-2.394775677995320,70,75,190,300,5,110
-2.394782863036510,60,65,90,450,5,360
-2.3948150885849600,32,40,180,450,8,270
-2.394913678710850,80,85,130,325,5,195
-2.394969286309860,76,80,200,500,4,300
-2.395005111069040,60,65,70,375,5,305
-2.395085961609450,38,45,130,400,7,270
-2.3952399853164200,26,35,110,475,9,365
-2.3952741020994600,46,55,110,150,9,40
-2.395312166552610,90,95,200,250,5,50
-2.395602419324870,26,35,120,425,9,305
-2.3956390864469100,60,65,90,400,5,310
-2.395756420250550,70,75,150,300,5,150
-2.395878337473650,38,45,50,475,7,425
-2.3959552686767800,72,80,70,125,8,55
-2.396147386851310,32,40,60,400,8,340
-2.3963684242935900,96,100,170,400,4,230
-2.3964302890450700,96,100,130,500,4,370
-2.396500824442490,70,75,110,275,5,165
-2.3965787916998000,38,45,110,450,7,340
-2.396601288128910,38,45,180,425,7,245
-2.396704195674230,48,55,90,200,7,110
-2.3967641926269500,48,55,130,200,7,70
-2.396773018137590,32,40,190,425,8,235
-2.3969992756012600,68,75,130,175,7,45
-2.397161246877260,44,50,190,500,6,310
-2.3971951153438000,96,100,70,500,4,430
-2.397214880786800,60,65,110,450,5,340
-2.3972893778000300,38,45,180,450,7,270
-2.397312537920260,60,65,60,400,5,340
-2.3973343419610000,38,45,60,375,7,315
-2.397418059802090,44,50,200,475,6,275
-2.3977939929302700,32,40,80,450,8,370
-2.397803936581970,70,75,110,375,5,265
-2.3979204157238800,38,45,180,400,7,220
-2.398008460092520,36,45,120,175,9,55
-2.398094218048730,26,35,130,250,9,120
-2.398335135498030,64,70,130,200,6,70
-2.3983392157256900,38,45,90,450,7,360
-2.398359115391670,48,55,120,200,7,80
-2.398458366305890,32,40,80,275,8,195
-2.398506439333880,38,45,150,450,7,300
-2.398553442394430,38,45,120,225,7,105
-2.398575254051330,70,75,70,200,5,130
-2.3986122904192600,96,100,190,450,4,260
-2.3989862083001300,38,45,200,300,7,100
-2.399042128779710,26,35,180,425,9,245
-2.3992273250704900,70,75,60,250,5,190
-2.3992367951088200,32,40,140,275,8,135
-2.3993248614952200,58,65,60,150,7,90
-2.3994577759013500,26,35,180,450,9,270
-2.3995540607945000,38,45,130,225,7,95
-2.3995768103717600,96,100,160,425,4,265
-2.3996821594520200,32,40,170,300,8,130
-2.399707115278740,72,80,50,100,8,50
-2.399709233034240,54,60,180,275,6,95
-2.3997350376625200,32,40,160,325,8,165
-2.399786337876680,70,75,70,300,5,230
-2.3998014614090800,38,45,130,250,7,120
-2.399838332801970,80,85,160,225,5,65
-2.3998386164756500,38,45,140,450,7,310
-2.399925442607290,96,100,160,475,4,315
-2.4000928227917400,92,100,160,175,8,15
-2.400125491435340,70,75,150,275,5,125
-2.4003766359797900,32,40,120,400,8,280
-2.4003954819216300,32,40,80,375,8,295
-2.4005364566382600,26,35,200,400,9,200
-2.4006194818262800,100,105,120,200,5,80
-2.4006578744755600,26,35,130,425,9,295
-2.4007584860857900,70,75,80,325,5,245
-2.4008736305836300,32,40,110,450,8,340
-2.400887350839930,60,65,180,375,5,195
-2.40090901572519,60,65,140,450,5,310
-2.4009831263161100,26,35,50,275,9,225
-2.400986291915510,26,35,150,225,9,75
-2.4011536853648700,70,75,170,250,5,80
-2.401175797329070,26,35,180,400,9,220
-2.401224635633360,80,85,180,275,5,95
-2.401245822449280,32,40,140,400,8,260
-2.401293616374090,60,65,180,425,5,245
-2.4013307270482400,96,100,100,475,4,375
-2.4013646522519900,38,45,60,400,7,340
-2.401385241326050,96,100,100,450,4,350
-2.4014267802210100,100,105,100,200,5,100
-2.4014286136786300,54,60,200,275,6,75
-2.4014979412124400,96,100,50,425,4,375
-2.401512376564080,100,105,50,175,5,125
-2.401928447947490,60,65,190,400,5,210
-2.4021289694091300,42,50,120,200,8,80
-2.402193306845140,96,100,140,500,4,360
-2.4022328833443500,60,65,170,450,5,280
-2.4022994411322600,60,65,70,475,5,405
-2.4024948972229900,70,75,60,275,5,215
-2.402535928591030,60,65,120,425,5,305
-2.402668671797690,70,75,130,275,5,145
-2.402894942434980,96,100,110,500,4,390
-2.4029474356038900,70,75,110,225,5,115
-2.402978282599000,38,45,130,375,7,245
-2.4031197205257500,26,35,160,325,9,165
-2.403380156233280,60,65,80,225,5,145
-2.4035382637015400,96,100,170,375,4,205
-2.4035596523049900,32,40,90,225,8,135
-2.4035854718813000,96,100,170,425,4,255
-2.4036560396715600,74,80,70,150,6,80
-2.4037466570127900,60,65,130,425,5,295
-2.4039292810832800,48,55,100,200,7,100
-2.4039888596520400,26,35,90,450,9,360
-2.404054463571900,38,45,150,475,7,325
-2.4040867901623200,64,70,140,200,6,60
-2.404090640637560,32,40,110,425,8,315
-2.4041904078068000,84,90,190,225,6,35
-2.4042828738851400,84,90,120,175,6,55
-2.404285337958470,70,75,160,225,5,65
-2.4043849138533700,60,65,120,400,5,280
-2.4044102520335100,90,95,120,175,5,55
-2.404451424564860,100,105,60,200,5,140
-2.4046839585924600,52,60,90,150,8,60
-2.4048028102962300,68,75,90,150,7,60
-2.4048069198457500,60,65,200,425,5,225
-2.404919347669950,48,55,70,175,7,105
-2.404920153919210,44,50,190,475,6,285
-2.404924652315220,26,35,80,275,9,195
-2.4050352714293800,26,35,140,400,9,260
-2.405117899201620,60,65,140,400,5,260
-2.405148439858440,38,45,70,375,7,305
-2.405153798236400,32,40,80,475,8,395
-2.4051768140814900,32,40,150,225,8,75
-2.405231402417840,32,40,150,350,8,200
-2.405322389629180,60,65,70,450,5,380
-2.4055898054365900,38,45,70,475,7,405
-2.405593325658250,96,100,50,350,4,300
-2.4056588707806500,32,40,80,500,8,420
-2.4057044987214100,64,70,120,200,6,80
-2.405715328425130,96,100,130,475,4,345
-2.405768303281470,38,45,200,425,7,225
-2.4058204071928300,38,45,150,400,7,250
-2.4058266955836000,64,70,60,175,6,115
-2.4059175802974800,32,40,70,450,8,380
-2.4059926941384000,32,40,160,300,8,140
-2.4061426644614500,32,40,130,425,8,295
-2.4063275086096100,26,35,200,300,9,100
-2.4064863412599800,26,35,140,450,9,310
-2.406496958317700,96,100,130,450,4,320
-2.406659353557600,42,50,130,200,8,70
-2.406764147423200,26,35,80,450,9,370
-2.4068239339539500,26,35,170,300,9,130
-2.406867898876620,60,65,80,450,5,370
-2.4069656876640000,70,75,140,300,5,160
-2.4071180364730300,38,45,170,450,7,280
-2.407138732853730,32,40,90,375,8,285
-2.4072466281853000,26,35,130,375,9,245
-2.407249607644890,32,40,140,475,8,335
-2.40726907545994,32,40,80,225,8,145
-2.4074300909033600,32,40,180,375,8,195
-2.407445701325990,38,45,80,500,7,420
-2.4077325798760400,32,40,150,425,8,275
-2.4077792325855400,38,45,80,475,7,395
-2.407879223300390,32,40,70,275,8,205
-2.40796727111446,60,65,80,375,5,295
-2.408269790764010,26,35,70,450,9,380
-2.4083202565521900,96,100,200,400,4,200
-2.4084861214259500,60,65,80,500,5,420
-2.4085042421156300,68,75,200,225,7,25
-2.4086333396390800,32,40,100,250,8,150
-2.408634640757180,26,35,190,400,9,210
-2.4086927900882100,54,60,60,200,6,140
-2.408824924675490,38,45,130,425,7,295
-2.409057822182670,32,40,70,425,8,355
-2.4091155524763400,26,35,70,475,9,405
-2.4091800271833700,26,35,150,350,9,200
-2.409320572788910,100,105,50,200,5,150
-2.4093868565790600,60,65,100,225,5,125
-2.409397170168500,32,40,200,300,8,100
-2.4094898200707700,94,100,110,150,6,40
-2.4095450434758100,38,45,190,425,7,235
-2.409584683962330,32,40,130,375,8,245
-2.409635188658100,54,60,110,200,6,90
-2.40971758458212,32,40,190,350,8,160
-2.41001441874785,38,45,120,425,7,305
-2.410050559045,38,45,90,350,7,260
-2.4101889387534300,32,40,90,275,8,185
-2.410294846882310,32,40,140,250,8,110
-2.4104086281292600,60,65,190,325,5,135
-2.4105912212743100,38,45,190,400,7,210
-2.4106330172225900,60,65,200,300,5,100
-2.4106677327182600,96,100,50,500,4,450
-2.410684490280720,44,50,180,500,6,320
-2.4107030029662200,96,100,170,325,4,155
-2.4107750690702200,60,65,120,250,5,130
-2.4107774927760900,60,65,180,400,5,220
-2.4108278975209400,60,65,140,425,5,285
-2.4108519700136900,32,40,190,400,8,210
-2.410880987084850,78,85,60,125,7,65
-2.4110997941839500,26,35,80,225,9,145
-2.4111245907300000,96,100,160,400,4,240
-2.4111821462820000,32,40,190,375,8,185
-2.4112637635705500,60,65,80,475,5,395
-2.4113446093437400,32,40,140,425,8,285
-2.411391601372390,60,65,160,375,5,215
-2.411815892381720,32,40,100,225,8,125
-2.4118460459967200,38,45,180,375,7,195
-2.4120002473186400,26,35,70,275,9,205
-2.4120386457735100,96,100,100,425,4,325
-2.412219837039780,26,35,110,450,9,340
-2.4122424764884000,26,35,140,250,9,110
-2.412330383154740,66,75,80,125,9,45
-2.412359709321970,80,85,120,300,5,180
-2.4123639255402700,32,40,80,425,8,345
-2.412415390177570,96,100,60,425,4,365
-2.4124571913155200,32,40,80,350,8,270
-2.4124934554355200,78,85,120,150,7,30
-2.412531028492370,38,45,140,400,7,260
-2.4126429187767800,26,35,160,300,9,140
-2.4130172067784500,60,65,130,250,5,120
-2.413022866194090,60,65,150,425,5,275
-2.4130279065709400,48,55,160,200,7,40
-2.4130328185074200,32,40,160,450,8,290
-2.4132443490161800,26,35,170,450,9,280
-2.4134405993467400,96,100,90,450,4,360
-2.4136233663596400,48,55,50,175,7,125
-2.4136656536285100,76,80,190,500,4,310
-2.413764436076630,60,65,50,275,5,225
-2.413765622888830,38,45,90,375,7,285
-2.4140053272956700,96,100,150,400,4,250
-2.4140329057824700,96,100,180,425,4,245
-2.41403735816624,96,100,120,475,4,355
-2.4141110016834400,60,65,150,350,5,200
-2.414117797179250,38,45,150,350,7,200
-2.414149412406180,26,35,60,300,9,240
-2.4142598927039000,32,40,60,300,8,240
-2.414306976517430,26,35,140,275,9,135
-2.4143113422760600,26,35,90,225,9,135
-2.414358226881180,70,75,150,250,5,100
-2.4144230523635500,26,35,80,375,9,295
-2.414462830588530,60,65,140,250,5,110
-2.4145129419576500,32,40,120,250,8,130
-2.4145666391925000,32,40,130,250,8,120
-2.414585657431330,76,85,70,100,9,30
-2.414622688814980,32,40,70,250,8,180
-2.4146366652640900,32,40,140,225,8,85
-2.414712290344680,32,40,90,300,8,210
-2.4147182877939200,60,65,140,375,5,235
-2.4147588266941700,76,85,100,125,9,25
-2.4149432995654500,80,85,170,225,5,55
-2.4149611523314300,96,100,50,450,4,400
-2.4149829345540200,26,35,100,250,9,150
-2.4150209493040600,26,35,150,450,9,300
-2.4150279756744200,32,40,70,350,8,280
-2.415050319866370,70,75,110,300,5,190
-2.415089241306780,60,65,170,300,5,130
-2.4152585834778900,70,75,80,300,5,220
-2.4153229843056600,38,45,170,300,7,130
-2.4153565103586100,60,65,180,350,5,170
-2.415443318326740,76,80,190,475,4,285
-2.4155817898253900,64,70,70,175,6,105
-2.415667327620020,54,60,190,275,6,85
-2.415717095638420,38,45,140,375,7,235
-2.4158745286233200,70,75,160,250,5,90
-2.4159225005094300,32,40,180,300,8,120
-2.415944876490620,26,35,100,225,9,125
-2.4159534322854700,38,45,150,425,7,275
-2.416069655707100,42,50,60,175,8,115
-2.416126115640560,26,35,140,425,9,285
-2.416157637641780,32,40,80,400,8,320
-2.41616316711334,48,55,60,175,7,115
-2.4162303000050100,26,35,200,425,9,225
-2.416402461490230,54,60,180,250,6,70
-2.4164134223028700,60,65,190,425,5,235
-2.416755243300180,96,100,50,400,4,350
-2.416834092993580,38,45,200,350,7,150
-2.417010564459710,38,45,90,225,7,135
-2.417060647209290,98,105,60,125,7,65
-2.4170727278003300,26,35,80,350,9,270
-2.417126131405720,26,35,110,425,9,315
-2.4172301413999700,26,35,190,425,9,235
-2.4172361572572400,32,40,150,325,8,175
-2.417240917096640,60,65,90,425,5,335
-2.417368569529080,38,45,50,275,7,225
-2.417414527353080,38,45,70,425,7,355
-2.417538356704560,60,65,100,400,5,300
-2.4178011047254300,32,40,200,325,8,125
-2.417906840171260,32,40,160,375,8,215
-2.417956588641870,26,35,80,475,9,395
-2.4179855685982900,38,45,200,375,7,175
-2.4180929831086300,96,100,150,450,4,300
-2.4181899890164000,42,50,140,200,8,60
-2.418248340940150,96,100,160,350,4,190
-2.4183023370583600,96,100,110,475,4,365
-2.418333486737720,60,65,90,375,5,285
-2.418433688545150,32,40,200,350,8,150
-2.4184927325388300,32,40,180,325,8,145
-2.418550478584030,38,45,140,225,7,85
-2.4185964731878700,38,45,70,450,7,380
-2.4186123853209400,38,45,190,350,7,160
-2.4187970438889100,96,100,60,375,4,315
-2.4188531176796800,38,45,100,400,7,300
-2.4188750679698300,68,75,140,175,7,35
-2.418884991787670,96,100,180,450,4,270
-2.4190747075213900,60,65,180,325,5,145
-2.4190942277227300,26,35,90,300,9,210
-2.4191205376626900,26,35,80,500,9,420
-2.4191474982940900,38,45,140,250,7,110
-2.4192352254972200,84,90,70,150,6,80
-2.4192553505972000,26,35,150,475,9,325
-2.4192853454788800,52,60,140,175,8,35
-2.4192870835242700,32,40,100,400,8,300
-2.4193301019099600,60,65,190,350,5,160
-2.41946657663236,44,50,90,500,6,410
-2.4195042054006300,32,40,110,250,8,140
-2.4195383430795100,26,35,90,375,9,285
-2.419540600850810,60,65,70,250,5,180
-2.419550158766080,60,65,110,425,5,315
-2.4195995728965500,60,65,60,475,5,415
-2.419755707627980,76,80,200,475,4,275
-2.419815791167230,26,35,70,425,9,355
-2.419909999117640,60,65,140,475,5,335
-2.4199726245744100,38,45,160,300,7,140
-2.419976818593590,38,45,80,450,7,370
-2.4199909385322200,96,100,80,250,4,170
-2.420058542076110,38,45,160,450,7,290
-2.420260155894690,60,65,70,425,5,355
-2.4204113549918500,62,70,50,100,8,50
-2.4204113584330400,38,45,110,425,7,315
-2.4204245540007600,54,60,90,200,6,110
-2.420623704790220,38,45,80,275,7,195
-2.420700800573400,54,60,50,200,6,150
-2.4207350640778300,54,60,180,225,6,45
-2.4207495445500000,90,95,190,225,5,35
-2.420786877737060,100,105,70,175,5,105
-2.420883046028990,26,35,150,425,9,275
-2.420926109486730,70,75,130,300,5,170
-2.4209728416821300,26,35,100,400,9,300
-2.42099710845904,80,85,200,275,5,75
-2.421010009955140,60,65,140,275,5,135
-2.421123881703150,44,50,120,450,6,330
-2.421132157637550,54,60,100,200,6,100
-2.4212367131520000,96,100,200,425,4,225
-2.421320972974940,32,40,90,425,8,335
-2.4215311425112100,32,40,140,375,8,235
-2.4217932593731000,60,65,190,375,5,185
-2.4217951298316800,60,65,150,325,5,175
-2.4218045513474700,38,45,90,425,7,335
-2.421831541794470,86,95,190,200,9,10
-2.4219011678461500,26,35,190,350,9,160
-2.4219030173691300,38,45,70,350,7,280
-2.4219890823876700,78,85,150,175,7,25
-2.4220052235265600,82,90,50,100,8,50
-2.4221058814625600,60,65,90,225,5,135
-2.4221328773699000,32,40,100,275,8,175
-2.422239047448690,48,55,140,200,7,60
-2.4222745403196800,26,35,180,375,9,195
-2.4223677995277900,96,100,120,225,4,105
-2.4223867979888100,38,45,140,475,7,335
-2.422432680749470,80,85,150,200,5,50
-2.4224611968470800,52,60,130,175,8,45
-2.422517974947110,44,50,160,500,6,340
-2.4226233826757800,38,45,60,475,7,415
-2.4226476754638100,60,65,100,250,5,150
-2.422744907505540,100,105,130,200,5,70
-2.4228852220017100,70,75,140,325,5,185
-2.4230128876320900,58,65,80,150,7,70
-2.423147874668360,96,100,90,250,4,160
-2.423200834988910,76,80,160,500,4,340
-2.4232261699207700,96,100,140,450,4,310
-2.423229040705360,26,35,60,475,9,415
-2.4232655409680100,38,45,140,275,7,135
-2.4233617758156100,32,40,60,500,8,440
-2.423402484974760,38,45,120,250,7,130
-2.4234307783319900,38,45,150,325,7,175
-2.4234686078342300,80,85,180,225,5,45
-2.4236036680532700,96,100,90,400,4,310
-2.4236680837249200,60,65,200,350,5,150
-2.423790044935990,56,65,80,125,9,45
-2.423806070473580,38,45,80,225,7,145
-2.423908087924040,26,35,180,350,9,170
-2.423949639322610,60,65,60,300,5,240
-2.4239704803812600,80,85,80,200,5,120
-2.4243347047587900,38,45,70,275,7,205
-2.4243853662131700,26,35,160,375,9,215
-2.4245139753625100,96,100,150,475,4,325
-2.4246434025835300,38,45,60,300,7,240
-2.424648063559370,44,50,100,500,6,400
-2.42474347898772,42,50,70,175,8,105
-2.424750925173820,96,100,170,450,4,280
-2.4248176948179200,70,75,110,325,5,215
-2.4249343339124100,44,50,150,500,6,350
-2.425073563725040,26,35,200,350,9,150
-2.4251075857140900,26,35,140,225,9,85
-2.425127962632480,96,100,60,400,4,340
-2.4251559581327400,96,100,70,475,4,405
-2.425280466952580,88,95,50,100,7,50
-2.425302164289190,26,35,70,250,9,180
-2.425431384772240,38,45,80,375,7,295
-2.4256203612020500,54,60,50,175,6,125
-2.4256423519320500,26,35,140,475,9,335
-2.42575420689554,60,65,110,400,5,290
-2.425780786699310,94,100,60,125,6,65
-2.4258420666656500,38,45,60,500,7,440
-2.4260416440217000,38,45,100,225,7,125
-2.4260706140188700,32,40,190,325,8,135
-2.4261782101809300,96,100,160,375,4,215
-2.426221786986110,96,100,50,475,4,425
-2.426260668271330,38,45,190,375,7,185
-2.4262804356942800,28,35,200,500,7,300
-2.4262970879914700,60,65,80,275,5,195
-2.4263308937554100,32,40,90,325,8,235
-2.426347805833230,32,40,60,475,8,415
-2.4265234037292700,58,65,70,150,7,80
-2.4265999987268100,38,45,180,350,7,170
-2.426657307730250,60,65,80,350,5,270
-2.4267084319652100,70,75,120,325,5,205
-2.426709321837150,26,35,90,325,9,235
-2.426809306217690,38,45,90,300,7,210
-2.4271091316604500,32,40,200,375,8,175
-2.427203034842190,92,100,130,150,8,20
-2.4272235982237900,96,100,90,350,4,260
-2.427274017329810,36,45,80,150,9,70
-2.4273025832824400,38,45,150,225,7,75
-2.4276283905308700,54,60,160,200,6,40
-2.427963286283640,88,95,80,125,7,45
-2.4280439276327300,96,100,130,400,4,270
-2.4283414209125600,38,45,70,250,7,180
-2.4285129618357300,38,45,160,375,7,215
-2.4285274350216700,26,35,120,250,9,130
-2.428675831606570,96,100,60,325,4,265
-2.4286824866222700,26,35,190,325,9,135
-2.428726123432690,60,65,60,500,5,440
-2.4288757584810800,60,65,140,225,5,85
-2.4289956514684200,96,100,120,425,4,305
-2.4290096553743400,38,45,120,350,7,230
-2.429268598425840,32,40,110,350,8,240
-2.429366257416890,42,50,110,175,8,65
-2.4293765375258500,98,105,180,200,7,20
-2.4294263174735200,56,65,160,175,9,15
-2.429697795409880,32,40,180,350,8,170
-2.429720979463660,96,100,60,350,4,290
-2.429809651888740,64,70,110,175,6,65
-2.42986641142811,96,100,80,475,4,395
-2.429911054965970,96,100,70,450,4,380
-2.4299654981479600,86,95,100,125,9,25
-2.4299733728815200,26,35,150,325,9,175
-2.4300045399194900,26,35,60,500,9,440
-2.4301155763849600,26,35,90,425,9,335
-2.4302569350762300,96,100,70,225,4,155
-2.4305924251617700,38,45,80,350,7,270
-2.43060378437311,100,105,180,225,5,45
-2.4306618758881300,60,65,150,225,5,75
-2.430677918417660,32,40,110,225,8,115
-2.4308654276059100,70,75,130,325,5,195
-2.4309775645585300,32,40,120,350,8,230
-2.4309799388566400,96,100,130,375,4,245
-2.430984933063010,38,45,90,275,7,185
-2.4309890611532200,38,45,180,325,7,145
-2.4310877370419700,38,45,140,350,7,210
-2.4312252817486700,96,100,160,325,4,165
-2.4312563996521400,80,85,110,200,5,90
-2.4312758699252300,76,80,180,500,4,320
-2.4313194689145000,96,100,110,450,4,340
-2.4314662115346100,60,65,100,275,5,175
-2.43154406453059,32,40,100,375,8,275
-2.431559510583600,82,90,80,125,8,45
-2.431612566665880,60,65,200,375,5,175
-2.4318307011095200,74,80,80,150,6,70
-2.431913115167680,38,45,180,300,7,120
-2.4320143993137300,26,35,90,275,9,185
-2.432025085274540,60,65,140,350,5,210
-2.432108298597280,60,65,70,275,5,205
-2.4321554703643000,96,100,120,400,4,280
-2.4322151410269500,60,65,200,325,5,125
-2.4322316206881000,26,35,120,350,9,230
-2.432290371023440,96,100,140,400,4,260
-2.432609926275630,36,45,70,150,9,80
-2.4327392020411900,60,65,90,275,5,185
-2.4328217412481800,32,40,70,400,8,330
-2.4328773963297900,38,45,100,250,7,150
-2.4328866463888800,100,105,160,200,5,40
-2.4329113045203800,38,45,110,250,7,140
-2.4331243835637800,96,100,130,425,4,295
-2.433229952647940,38,45,100,275,7,175
-2.4332591849308200,100,105,60,175,5,115
-2.433265708290290,44,50,170,350,6,180
-2.433331051770610,44,50,170,500,6,330
-2.4334444440614100,56,65,90,125,9,35
-2.4335647986047200,26,35,190,375,9,185
-2.4335695043186200,26,35,200,375,9,175
-2.433626621678350,80,85,190,275,5,85
-2.4336693195729300,42,50,80,175,8,95
-2.4337120448813600,60,65,160,450,5,290
-2.4339049435188700,26,35,100,325,9,225
-2.433940622588770,96,100,160,450,4,290
-2.4340874669960400,60,65,90,300,5,210
-2.4344814718094300,96,100,180,400,4,220
-2.4345495424379000,32,40,110,400,8,290
-2.4345980857318700,96,100,190,400,4,210
-2.4346059747983300,26,35,140,375,9,235
-2.434633567638550,60,65,80,425,5,345
-2.434668352589630,38,45,110,400,7,290
-2.434696693424240,26,35,180,325,9,145
-2.434782839033540,26,35,70,350,9,280
-2.4348295629589700,60,65,110,250,5,140
-2.4348391310934700,96,100,150,425,4,275
-2.4348483072506200,38,45,100,325,7,225
-2.4350691961562200,32,40,60,225,8,165
-2.435222739644130,44,50,140,500,6,360
-2.4356206995698100,76,80,100,500,4,400
-2.4356932660136900,44,50,90,475,6,385
-2.435693429970080,96,100,130,250,4,120
-2.435810211758600,60,65,70,350,5,280
-2.4358115708748300,26,35,100,275,9,175
-2.4361923934004300,38,45,190,325,7,135
-2.436221678272950,26,35,200,325,9,125
-2.4363248129002700,46,55,150,175,9,25
-2.4367028758315500,32,40,140,350,8,210
-2.436994515662780,96,100,180,375,4,195
-2.4371018577632400,60,65,60,450,5,390
-2.437226656217870,60,65,100,375,5,275
-2.437260464790490,44,50,200,450,6,250
-2.437294865785970,96,100,190,350,4,160
-2.4373922034223700,26,35,160,450,9,290
-2.437541480747690,96,100,140,425,4,285
-2.4375474547663300,60,65,90,325,5,235
-2.43764069473313,52,60,110,150,8,40
-2.43786979017138,96,100,70,425,4,355
-2.4378890242620000,98,105,70,125,7,55
-2.437899735315080,96,100,190,425,4,235
-2.4379492887900500,96,100,80,450,4,370
-2.4379950890262100,32,40,100,325,8,225
-2.4380407058470400,26,35,70,400,9,330
-2.438056144100050,60,65,190,300,5,110
-2.4380801663624100,38,45,200,325,7,125
-2.4381266367919300,32,40,100,300,8,200
-2.438460496270580,96,100,80,500,4,420
-2.4386730528208700,74,80,100,150,6,50
-2.4386882808837,96,100,140,375,4,235
-2.4387069110868800,78,85,70,125,7,55
-2.4388183955829100,96,100,140,475,4,335
-2.4389185157392300,44,50,100,475,6,375
-2.439002389647710,32,40,100,350,8,250
-2.439140128339540,80,85,180,250,5,70
-2.4391878602208800,64,70,90,175,6,85
-2.4391888392334500,38,45,80,400,7,320
-2.4392369231835900,96,100,70,375,4,305
-2.4392724527377500,38,45,80,425,7,345
-2.4393373420281900,96,100,150,325,4,175
-2.4394248087061100,32,40,160,275,8,115
-2.439557683830530,26,35,140,350,9,210
-2.4395868362241500,60,65,120,375,5,255
-2.4396815411912100,94,100,180,200,6,20
-2.439835336494290,26,35,110,400,9,290
-2.439836165578340,60,65,70,400,5,330
-2.4398741309447900,26,35,110,225,9,115
-2.4401712170393000,32,40,50,300,8,250
-2.440276726295140,38,45,100,375,7,275
-2.4403294855016300,96,100,200,350,4,150
-2.4404035554610300,96,100,160,300,4,140
-2.440442285754850,96,100,130,225,4,95
-2.4407175064949300,96,100,200,300,4,100
-2.4407443485244100,26,35,80,425,9,345
-2.440760827977060,72,80,80,125,8,45
-2.4411343317867100,64,70,80,175,6,95
-2.4412017253451300,32,40,120,375,8,255
-2.441273163006390,32,40,70,325,8,255
-2.4414801021862800,90,95,80,150,5,70
-2.4416518704463400,44,50,170,475,6,305
-2.441692169042360,96,100,150,350,4,200
-2.4417861739752500,76,80,120,450,4,330
-2.441888911193910,96,100,90,425,4,335
-2.441926341318060,32,40,50,325,8,275
-2.4421949029301100,26,35,50,225,9,175
-2.442276840413510,60,65,180,300,5,120
-2.4424298152189200,32,40,60,450,8,390
-2.4424686680078700,60,65,80,400,5,320
-2.442535686773430,32,40,120,275,8,155
-2.4426512193241600,32,40,190,300,8,110
-2.442821338117200,96,100,170,300,4,130
-2.4430767124652,80,85,90,200,5,110
-2.4430827500180400,26,35,110,250,9,140
-2.4430869374343800,26,35,100,300,9,200
-2.443111925510920,96,105,70,100,9,30
-2.4432854764138300,44,50,120,500,6,380
-2.4434105880473500,100,105,140,200,5,60
-2.4435606588774300,44,50,100,450,6,350
-2.443570546149160,60,65,110,375,5,265
-2.4436307817744600,76,80,170,350,4,180
-2.443661971458370,86,95,70,100,9,30
-2.443701368619610,60,65,50,300,5,250
-2.4438314586758400,38,45,100,300,7,200
-2.443848080854760,96,100,110,425,4,315
-2.4439250766336000,80,85,60,200,5,140
-2.444164327466930,38,45,110,375,7,265
-2.4441884894602100,80,85,50,200,5,150
-2.444433541900430,26,35,50,300,9,250
-2.444467914883970,76,80,90,500,4,410
-2.444494058667110,26,35,80,400,9,320
-2.444642580742570,70,75,170,275,5,105
-2.444728868690010,46,55,120,150,9,30
-2.4447346713675400,70,75,170,225,5,55
-2.4447473917156200,44,50,170,400,6,230
-2.444803529675140,60,65,100,325,5,225
-2.4449706468815400,64,70,190,250,6,60
-2.4450247590791600,54,60,120,200,6,80
-2.4452813292964500,96,100,100,400,4,300
-2.445302374278690,96,100,180,350,4,170
-2.445444032359870,56,65,130,150,9,20
-2.4456281893376100,44,50,160,425,6,265
-2.4456652673604900,60,65,100,300,5,200
-2.4457809374340000,38,45,60,450,7,390
-2.4458405298282800,54,60,140,200,6,60
-2.4458533814315900,100,105,80,175,5,95
-2.4458726054581700,96,100,70,275,4,205
-2.4460050463591700,76,80,200,450,4,250
-2.44601909483808,60,65,120,350,5,230
-2.446368361335790,44,50,50,425,6,375
-2.4463899351865900,96,100,190,375,4,185
-2.446527434479060,60,65,110,225,5,115
-2.4467042001067800,44,50,80,250,6,170
-2.44689966417298,96,100,60,475,4,415
-2.4469981016854100,44,50,160,350,6,190
-2.4470788804194400,60,65,110,275,5,165
-2.4471995861851400,44,50,100,425,6,325
-2.4472204684390300,38,45,190,300,7,110
-2.4473392658865400,96,100,80,275,4,195
-2.4473865527941600,58,65,100,150,7,50
-2.4474065013314500,48,55,110,175,7,65
-2.4474403077092300,46,55,60,125,9,65
-2.4475337330851600,44,50,70,500,6,430
-2.4476755768296100,26,35,70,325,9,255
-2.4477064675047300,96,100,180,325,4,145
-2.44776211153498,44,50,50,375,6,325
-2.4478558162293500,32,40,50,250,8,200
-2.447872519736490,38,45,130,350,7,220
-2.447919419238500,96,100,140,275,4,135
-2.448014718513,96,100,140,250,4,110
-2.448116086962510,76,80,170,500,4,330
-2.4482009369498000,60,65,110,350,5,240
-2.448297590622620,98,105,150,175,7,25
-2.4484933482271700,74,80,50,125,6,75
-2.448581115086400,32,40,110,275,8,165
-2.4487172486532600,26,35,180,300,9,120
-2.448778759786590,32,40,150,300,8,150
-2.448849449774640,96,100,60,300,4,240
-2.4490196520131100,38,45,50,325,7,275
-2.4495251521835700,68,75,110,150,7,40
-2.449671521594690,48,55,190,250,7,60
-2.4497025794408800,80,85,100,200,5,100
-2.4497488468114900,38,45,100,350,7,250
-2.449766365770720,84,90,80,150,6,70
-2.449779002197870,76,80,180,475,4,295
-2.4498242351863600,96,100,200,375,4,175
-2.4498375781876700,66,75,160,175,9,15
-2.4499164999258100,26,35,70,200,9,130
-2.449923173450300,44,50,190,450,6,260
-2.44992535757924,44,50,170,325,6,155
-2.4500618100850300,38,45,120,375,7,255
-2.4502749179987500,92,100,60,100,8,40
-2.450297503776040,70,75,180,275,5,95
-2.450319328843050,60,65,70,325,5,255
-2.450339263804840,26,35,160,275,9,115
-2.450374581836840,94,100,70,125,6,55
-2.4503816520755400,76,80,120,500,4,380
-2.4504800052553500,90,95,70,150,5,80
-2.4506039292935900,96,100,60,500,4,440
-2.4506170200903300,66,75,130,150,9,20
-2.4506325767287000,60,65,100,350,5,250
-2.4507740270386600,60,65,50,325,5,275
-2.4507755371836800,60,65,150,300,5,150
-2.4507758690353300,38,45,70,400,7,330
-2.450824469306600,60,65,130,350,5,220
-2.4508660836270100,44,50,180,475,6,295
-2.451298329314470,26,35,50,325,9,275
-2.451323240139360,70,75,150,200,5,50
-2.45132863332199,44,50,120,475,6,355
-2.4514367151807600,32,40,130,350,8,220
-2.4515404051261700,38,45,60,225,7,165
-2.4515879222257800,26,35,100,350,9,250
-2.451688098413780,44,50,170,425,6,255
-2.451813244717060,96,100,90,225,4,135
-2.451942721056070,26,35,60,275,9,215
-2.451946871451230,96,100,80,375,4,295
-2.4520141745098500,52,60,180,200,8,20
-2.4521110899906200,32,40,60,250,8,190
-2.4522048328057700,38,45,50,300,7,250
-2.452205800474230,44,50,170,375,6,205
-2.452331170693930,96,100,120,250,4,130
-2.4523726616347300,68,75,180,200,7,20
-2.4524107743508700,26,35,60,450,9,390
-2.452436873304230,64,70,50,150,6,100
-2.452481617117500,48,55,90,175,7,85
-2.452631453496180,46,55,70,125,9,55
-2.452636863382510,38,45,110,275,7,165
-2.4526574203787600,32,40,50,225,8,175
-2.4528951022198100,60,65,60,225,5,165
-2.4530661140578700,38,45,90,325,7,235
-2.4531420467843600,38,45,120,275,7,155
-2.453320819200390,60,65,120,275,5,155
-2.453329373682160,100,105,190,250,5,60
-2.4533347208188100,38,45,60,250,7,190
-2.4533669313648600,96,100,90,375,4,285
-2.453584114315280,38,45,160,275,7,115
-2.4541166804814900,32,40,110,300,8,190
-2.454179972349940,32,40,80,325,8,245
-2.4542032914167700,60,65,50,225,5,175
-2.4542709861601500,90,95,100,150,5,50
-2.4543494375574900,60,65,50,250,5,200
-2.454438314028490,38,45,110,225,7,115
-2.454438443187160,74,80,200,225,6,25
-2.4544640527309200,76,80,100,450,4,350
-2.454592262466320,44,50,110,500,6,390
-2.454745704971310,76,80,90,475,4,385
-2.454819236257340,44,50,60,425,6,365
-2.454875290228800,80,85,60,175,5,115
-2.454879088990630,32,40,110,375,8,265
-2.455039672221210,70,75,50,200,5,150
-2.4550456345632300,70,75,80,200,5,120
-2.45510038167725,54,60,130,200,6,70
-2.4551060692940400,96,100,100,250,4,150
-2.455123546848180,42,50,190,250,8,60
-2.455157501289490,96,100,70,250,4,180
-2.455295721813030,64,70,170,200,6,30
-2.455333932487630,96,100,100,225,4,125
-2.4553563240510800,44,50,130,500,6,370
-2.4555003848005500,44,50,160,475,6,315
-2.455620855490230,96,100,50,275,4,225
-2.455772126809560,32,40,140,300,8,160
-2.455802140953110,38,45,70,325,7,255
-2.4558629500687700,96,100,120,350,4,230
-2.4558789793524900,26,35,70,300,9,230
-2.455966712343600,60,65,160,275,5,115
-2.4560187353402100,38,45,150,300,7,150
-2.456054690015350,48,55,80,175,7,95
-2.456075705280250,32,40,70,200,8,130
-2.456101161828650,96,100,80,350,4,270
-2.456169526983670,44,50,150,400,6,250
-2.4564037570391100,82,90,90,125,8,35
-2.4564187181191500,100,105,90,175,5,85
-2.4564557360030200,26,35,110,350,9,240
-2.456558794434630,26,35,150,300,9,150
-2.45682519844871,26,35,60,225,9,165
-2.456936250889450,26,35,120,275,9,155
-2.4570138966493700,62,70,80,125,8,45
-2.457286325026980,38,45,110,350,7,240
-2.45738283226217,80,85,120,200,5,80
-2.4574374637649200,32,40,150,375,8,225
-2.4574396573357800,96,100,180,300,4,120
-2.4575038336599500,26,35,60,250,9,190
-2.457505350110330,26,35,140,300,9,160
-2.4576068579443300,36,45,100,150,9,50
-2.4576484826358500,70,75,120,300,5,180
-2.457959928068970,76,80,100,475,4,375
-2.4580682625755700,32,40,60,275,8,215
-2.4582333759005600,76,80,160,425,4,265
-2.458294179188300,96,100,80,425,4,345
-2.4584326529734900,96,100,200,325,4,125
-2.4584856551902100,44,50,50,350,6,300
-2.4585145046424800,38,45,70,300,7,230
-2.458602640720100,96,100,140,350,4,210
-2.458797857681830,66,75,90,125,9,35
-2.4588858128706900,44,50,180,450,6,270
-2.458904532060690,60,65,70,300,5,230
-2.4591678895965200,44,50,130,475,6,345
-2.4595708213040800,96,100,90,300,4,210
-2.4596061328733800,28,35,200,475,7,275
-2.459657899996570,96,100,60,450,4,390
-2.4596643509893300,38,45,150,375,7,225
-2.4597434618673100,76,80,150,500,4,350
-2.4600473133441900,96,100,190,325,4,135
-2.460195544057990,44,50,120,400,6,280
-2.460491538743100,96,100,70,400,4,330
-2.4610618208725800,44,50,60,375,6,315
-2.461149511534460,60,65,60,250,5,190
-2.461180298717630,38,45,140,300,7,160
-2.4612144861505600,76,80,170,400,4,230
-2.461384063564510,44,50,60,325,6,265
-2.4615206212198300,26,35,110,275,9,165
-2.4615356155509600,58,65,200,225,7,25
-2.4617427666747800,44,50,50,500,6,450
-2.4621777721411700,26,35,100,375,9,275
-2.4622056060120900,44,50,90,250,6,160
-2.4624146164074100,96,100,100,275,4,175
-2.462464270635030,38,45,70,200,7,130
-2.4624670017746300,96,100,110,350,4,240
-2.462713012449970,58,65,50,125,7,75
-2.4630633468759500,26,35,50,250,9,200
-2.463120673080100,26,35,190,300,9,110
-2.4631514934510200,38,45,50,250,7,200
-2.463205798536400,94,100,120,150,6,30
-2.4632247118467300,54,60,60,175,6,115
-2.463273238010590,44,50,150,475,6,325
-2.463297671631230,44,50,200,400,6,200
-2.4633047630350300,38,45,50,225,7,175
-2.4633172474683500,44,50,70,225,6,155
-2.4634309807446900,60,65,150,375,5,225
-2.463651122384730,80,85,160,200,5,40
-2.463667826077340,44,50,160,400,6,240
-2.463668975981680,32,40,170,250,8,80
-2.4636918623535800,96,100,110,400,4,290
-2.4637369637067600,32,40,70,300,8,230
-2.4640768164997900,42,50,90,175,8,85
-2.464178085570210,26,35,130,350,9,220
-2.464286871300700,44,50,130,400,6,270
-2.464501284089340,44,50,70,375,6,305
-2.4645350229563900,94,100,150,175,6,25
-2.4645360264985200,76,80,170,475,4,305
-2.4647928124740100,76,80,190,450,4,260
-2.4648801277243500,54,60,70,175,6,105
-2.4650534138817100,70,75,60,200,5,140
-2.465074137915840,60,65,170,250,5,80
-2.4651549865013400,32,40,150,275,8,125
-2.465197856040920,60,65,80,325,5,245
-2.4653586965751800,96,100,70,350,4,280
-2.465612979847070,76,80,130,450,4,320
-2.4656179874954800,44,50,90,400,6,310
-2.465798341961080,44,50,50,400,6,350
-2.4658294131808900,98,105,120,150,7,30
-2.4659455684946600,26,35,120,375,9,255
-2.4659914431867400,96,100,120,375,4,255
-2.466015097668730,60,65,110,300,5,190
-2.4661303127960300,26,35,110,300,9,190
-2.46623829373131,80,85,130,200,5,70
-2.4663313509556200,76,80,140,500,4,360
-2.4663406388988500,76,80,100,425,4,325
-2.4664080099258800,76,80,50,375,4,325
-2.466551391161130,76,80,130,500,4,370
-2.46666801727854,44,50,60,400,6,340
-2.466698206056140,96,100,110,250,4,140
-2.466802229084440,76,80,170,375,4,205
-2.4668345063867700,44,50,180,425,6,245
-2.4669523455148600,26,35,170,250,9,80
-2.4669722589408500,44,50,50,450,6,400
-2.467144142366960,86,90,200,500,4,300
-2.4672611127831200,38,45,110,300,7,190
-2.4673837028200600,96,100,190,300,4,110
-2.4674735914832600,58,65,130,175,7,45
-2.4675779890959000,96,100,150,375,4,225
-2.467654675589070,44,50,90,450,6,360
-2.467656904998310,60,65,70,200,5,130
-2.4676738760590200,28,35,190,500,7,310
-2.467862721936210,44,50,130,225,6,95
-2.4678648257432300,44,50,180,400,6,220
-2.4680459178515200,60,65,140,300,5,160
-2.46806563915555,38,45,80,325,7,245
-2.4684017800770200,96,100,80,225,4,145
-2.468468841864880,58,65,90,150,7,60
-2.4684885914304400,76,80,160,475,4,315
-2.468641701604720,44,50,130,450,6,320
-2.4686889913077200,96,100,80,400,4,320
-2.4687994646768100,44,50,110,475,6,365
-2.4691137500638700,98,105,80,125,7,45
-2.469326812246140,36,45,140,175,9,35
-2.469587554044120,44,50,60,350,6,290
-2.469909595762120,44,50,160,325,6,165
-2.4700273710914300,70,75,200,275,5,75
-2.4700546385196900,96,100,80,325,4,245
-2.470341449008580,76,80,130,475,4,345
-2.4703660237215200,78,85,50,100,7,50
-2.470371098154010,96,100,90,275,4,185
-2.470601532321190,76,80,50,400,4,350
-2.4706031912486100,80,85,50,175,5,125
-2.4706965493971200,60,65,60,275,5,215
-2.470757666903880,96,100,100,375,4,275
-2.4708631437264200,42,50,170,200,8,30
-2.4710384443641400,60,65,150,250,5,100
-2.4710950110964600,76,80,50,425,4,375
-2.4711926003986700,96,100,100,325,4,225
-2.47123812548369,38,45,170,250,7,80
-2.47124075009858,88,95,160,175,7,15
-2.471461458150230,26,35,80,325,9,245
-2.471611511187440,70,75,190,275,5,85
-2.4717080667031,76,80,110,500,4,390
-2.471946710985870,76,80,110,475,4,365
-2.4719567285227900,76,80,180,450,4,270
-2.472104560646160,44,50,50,475,6,425
-2.4721824914831100,70,75,110,200,5,90
-2.4721849202732800,76,80,170,325,4,155
-2.4723660762112500,38,45,150,275,7,125
-2.472472611507770,76,80,170,425,4,255
-2.4725663239931200,100,105,110,175,5,65
-2.472850929272010,38,45,60,275,7,215
-2.4729399749672800,44,50,70,475,6,405
-2.4730724263710200,76,80,130,400,4,270
-2.473085861620340,32,40,80,300,8,220
-2.4731084687169000,44,50,200,300,6,100
-2.473132980970540,26,35,110,375,9,265
-2.473153322417200,60,65,80,300,5,220
-2.473213386752910,44,50,90,350,6,260
-2.4732313249730100,60,65,150,275,5,125
-2.473311421049290,74,80,90,150,6,60
-2.4733203546442300,96,100,140,225,4,85
-2.4733775991978400,76,80,160,350,4,190
-2.473715828615080,52,60,120,150,8,30
-2.473914517524820,76,80,60,425,4,365
-2.4741018716116600,38,45,160,250,7,90
-2.474198975788090,74,80,140,175,6,35
-2.474225863298110,96,100,100,350,4,250
-2.4743948707804600,76,80,120,475,4,355
-2.474411569264570,68,75,60,125,7,65
-2.474454656628720,44,50,120,225,6,105
-2.4745575867983100,76,80,50,500,4,450
-2.4746516941886500,36,45,90,150,9,60
-2.4746960189095800,96,100,90,325,4,235
-2.4749224284064400,76,80,70,500,4,430
-2.47500905390078,28,35,190,475,7,285
-2.4750777812134000,76,80,90,250,4,160
-2.4751206965351900,28,35,180,500,7,320
-2.4752357352996800,96,100,110,375,4,265
-2.4755178569600600,96,100,150,225,4,75
-2.4756510921008200,96,100,150,300,4,150
-2.4757636998138800,64,70,100,175,6,75
-2.475825787502800,82,90,130,150,8,20
-2.4759637273642900,84,90,50,125,6,75
-2.4759952289114200,44,50,80,500,6,420
-2.4760489037221000,44,50,150,450,6,300
-2.476363638154770,92,100,190,200,8,10
-2.476484617410490,96,100,70,325,4,255
-2.4765676999332800,44,50,130,425,6,295
-2.476696161906390,74,80,130,175,6,45
-2.4767284961571600,44,50,170,450,6,280
-2.47675337614098,86,90,190,500,4,310
-2.4768861646926600,26,35,150,375,9,225
-2.477043036271650,76,80,50,350,4,300
-2.477295846175310,44,50,140,450,6,310
-2.4773236236711000,26,35,150,275,9,125
-2.4774075737084200,54,60,80,175,6,95
-2.4776461865992300,76,80,180,425,4,245
-2.478036700556440,76,80,160,325,4,165
-2.4782758843854300,48,55,170,200,7,30
-2.478288981234070,76,80,160,400,4,240
-2.4785873735958000,76,80,60,350,4,290
-2.4786320246975000,32,40,150,250,8,100
-2.478690154096720,96,100,100,300,4,200
-2.478946609170450,60,65,120,325,5,205
-2.478990979165430,72,80,90,125,8,35
-2.4790711045863700,54,60,110,175,6,65
-2.479113863892920,44,50,110,450,6,340
-2.4791159229394100,76,80,120,400,4,280
-2.4792253795005500,32,40,140,325,8,185
-2.4792419112978000,76,80,150,450,4,300
-2.4793107363282200,44,50,150,425,6,275
-2.479337828802240,96,100,140,300,4,160
-2.479555621927400,94,100,80,125,6,45
-2.4796216225811700,96,100,130,350,4,220
-2.4799662083453500,60,65,130,275,5,145
-2.480190737525090,32,40,160,250,8,90
-2.4804011480089400,96,100,120,275,4,155
-2.4804300726430100,44,50,90,225,6,135
-2.4804826935297900,86,90,200,475,4,275
-2.4805780675605800,44,50,120,425,6,305
-2.480664036107140,38,45,150,250,7,100
-2.480895038725910,62,70,130,150,8,20
-2.481009361270380,96,100,50,300,4,250
-2.481028856622050,42,50,100,175,8,75
-2.4810333366027500,76,80,50,475,4,425
-2.4811314988633700,76,80,150,400,4,250
-2.4811975941285300,32,40,160,225,8,65
-2.4812405710381900,44,50,200,425,6,225
-2.481251023907250,96,100,110,225,4,115
-2.4813758666149400,96,100,160,275,4,115
-2.4816659213048000,70,75,180,250,5,70
-2.4817036459342000,84,90,100,150,6,50
-2.4817386579225300,28,35,120,450,7,330
-2.4817659280741900,32,40,130,300,8,170
-2.4818130532207300,44,50,110,425,6,315
-2.4819455366241000,76,80,50,450,4,400
-2.482204190516750,76,80,200,425,4,225
-2.4822224087118100,70,75,50,175,5,125
-2.4823639912539800,76,80,150,475,4,325
-2.4824138998487900,76,80,140,450,4,310
-2.4824287855448500,38,45,80,300,7,220
-2.482577500881490,28,35,50,375,7,325
-2.482619230428820,60,65,160,250,5,90
-2.4826472482654000,62,70,90,125,8,35
-2.482734893094620,96,100,110,275,4,165
-2.482737496784330,76,80,90,450,4,360
-2.4828566964570200,32,40,120,325,8,205
-2.4832079341439800,80,85,140,200,5,60
-2.48330490270095,44,50,130,375,6,245
-2.4833397935330800,44,50,180,375,6,195
-2.4833585920880100,38,45,130,300,7,170
-2.4837493797050900,28,35,160,500,7,340
-2.483856359954200,58,65,140,175,7,35
-2.483868758282100,82,90,160,175,8,15
-2.4838937481366800,44,50,70,450,6,380
-2.4839043709521800,88,95,90,125,7,35
-2.4840042177549600,26,35,150,250,9,100
-2.4840437005744600,60,65,110,325,5,215
-2.4841258604670800,70,75,90,200,5,110
-2.484305046490780,32,40,130,275,8,145
-2.484322326196320,52,60,60,125,8,65
-2.484573237367020,76,80,70,225,4,155
-2.484739295206690,44,50,140,400,6,260
-2.484822404276470,60,65,130,300,5,170
-2.485315996846390,48,55,50,150,7,100
-2.4853984930083500,44,50,80,475,6,395
-2.4855881453497700,44,50,190,400,6,210
-2.48573863448512,76,80,170,450,4,280
-2.4861384571276800,76,80,200,400,4,200
-2.4862806067814700,76,80,130,225,4,95
-2.486401064487120,44,50,160,300,6,140
-2.4864399488495400,44,50,70,425,6,355
-2.4864475566613100,70,75,180,225,5,45
-2.4864817149638500,44,50,160,450,6,290
-2.486615971899560,72,80,60,100,8,40
-2.4867052775251400,84,90,130,175,6,45
-2.486860898711670,44,50,80,450,6,370
-2.4870012877915500,76,80,120,225,4,105
-2.487058834544630,38,45,130,275,7,145
-2.48708824659795,90,95,130,175,5,45
-2.487139879891790,26,35,130,275,9,145
-2.487202834994160,36,45,200,225,9,25
-2.487287591953740,44,50,130,250,6,120
-2.4874382073952200,44,50,140,425,6,285
-2.4875908108997100,44,50,150,350,6,200
-2.4876849961061900,76,80,140,400,4,260
-2.4880612808884800,100,105,200,250,5,50
-2.488069835378550,76,80,60,375,4,315
-2.4883740622053000,96,100,60,250,4,190
-2.4885129797055900,88,95,130,150,7,20
-2.488517614303890,76,80,60,325,4,265
-2.4885195103102000,44,50,190,350,6,160
-2.488568235138790,44,50,120,250,6,130
-2.4886230165719300,60,65,160,225,5,65
-2.4886440735947000,28,35,170,500,7,330
-2.488715509865440,76,80,180,400,4,220
-2.488952518325600,36,45,130,175,9,45
-2.4890541641497600,76,80,110,425,4,315
-2.489121653065720,62,70,160,175,8,15
-2.489164766584760,86,90,180,500,4,320
-2.489173447518710,96,100,50,325,4,275
-2.489184691582700,80,85,70,175,5,105
-2.4892622109296800,68,75,120,150,7,30
-2.489317099560600,38,45,120,325,7,205
-2.4894408252839800,44,50,170,300,6,130
-2.489460091334490,84,90,90,150,6,60
-2.4894898777540100,42,50,190,225,8,35
-2.4895214548749700,76,80,120,425,4,305
-2.4896254110233600,76,80,130,425,4,295
-2.4896409829674200,26,35,160,250,9,90
-2.48973888560802,44,50,140,275,6,135
-2.4897806069207000,76,80,80,250,4,170
-2.489846829322440,76,80,70,375,4,305
-2.4898486630781800,32,40,170,275,8,105
-2.4903949765773800,44,50,150,325,6,175
-2.4904125251290300,76,80,70,475,4,405
-2.490479856088020,28,35,100,500,7,400
-2.4908073350088900,76,80,90,400,4,310
-2.490824217754070,84,90,200,225,6,25
-2.490878623556600,26,35,80,300,9,220
-2.4909269138283200,86,90,190,475,4,285
-2.490930071872520,92,100,100,125,8,25
-2.4910607967776400,76,80,80,475,4,395
-2.4910627699323600,44,50,140,375,6,235
-2.4910708567293400,70,75,100,200,5,100
-2.4910853070992600,36,45,50,125,9,75
-2.4910905516464400,96,100,110,300,4,190
-2.491121697391580,38,45,170,275,7,105
-2.491215709796140,82,90,60,100,8,40
-2.4913069697322300,26,35,110,325,9,215
-2.491373374576330,44,50,190,425,6,235
-2.4913960914275800,38,45,140,325,7,185
-2.4914170014718000,44,50,90,425,6,335
-2.49149343245831,48,55,100,175,7,75
-2.4916322344946700,44,50,50,275,6,225
-2.491666008517130,28,35,90,475,7,385
-2.4918414666167200,32,40,150,200,8,50
-2.4921452962579300,54,60,90,175,6,85
-2.4921864530337200,44,50,180,325,6,145
-2.4922391943767500,70,75,160,200,5,40
-2.492493390180540,96,100,50,250,4,200
-2.4924971493881500,96,100,50,225,4,175
-2.4926034703755300,32,40,110,325,8,215
-2.49282727660945,26,35,160,225,9,65
-2.492847769116010,44,50,80,275,6,195
-2.4928765630771500,44,50,140,475,6,335
-2.4929562631558800,44,50,60,500,6,440
-2.493508196232660,96,100,160,250,4,90
-2.4935609369286200,42,50,200,250,8,50
-2.4942916741410600,44,50,140,250,6,110
-2.4942928370787800,54,60,190,250,6,60
-2.4943227064782800,96,100,150,250,4,100
-2.4943914582673200,44,50,100,225,6,125
-2.4945598449043100,72,80,130,150,8,20
-2.4946979049966900,52,60,150,175,8,25
-2.494721733324650,44,50,60,300,6,240
-2.4947512007911600,100,105,50,150,5,100
-2.4952339151976500,86,95,80,100,9,20
-2.49528696097133,44,50,100,400,6,300
-2.495661076602860,76,80,200,300,4,100
-2.495738774908010,100,105,100,175,5,75
-2.4957753077685100,26,35,170,225,9,55
-2.4958401417386700,28,35,90,250,7,160
-2.496033515707800,76,80,60,400,4,340
-2.496166564595880,44,50,160,375,6,215
-2.4961764746425800,76,80,90,350,4,260
-2.4963801495943600,44,50,200,350,6,150
-2.4967812479333700,32,40,130,325,8,195
-2.496801497495880,64,70,200,250,6,50
-2.496925037982960,60,65,170,225,5,55
-2.497018446469700,42,50,50,150,8,100
-2.49730375306109,60,65,140,325,5,185
-2.4973703721212000,80,85,110,175,5,65
-2.4975781342471800,72,80,160,175,8,15
-2.497743842218170,26,35,130,300,9,170
-2.4977487700832200,96,100,70,300,4,230
-2.4979685275635500,38,45,160,225,7,65
-2.4979759603004100,96,100,150,275,4,125
-2.4980790184429900,76,80,130,375,4,245
-2.498251287708280,76,80,180,375,4,195
-2.4986170719818800,44,50,150,225,6,75
-2.498713727418330,44,50,190,375,6,185
-2.4989630666307500,28,35,90,500,7,410
-2.499015063143070,44,50,80,375,6,295
-2.4990249012229600,60,65,80,200,5,120
-2.4991368656969100,28,35,170,350,7,180
-2.499197638194510,76,80,150,325,4,175
-2.499197647693450,86,90,160,500,4,340
-2.4992618612230200,32,40,80,200,8,120
-2.499335778608770,38,45,130,325,7,195
-2.4996502367635000,96,100,70,200,4,130
-2.4998881611901000,76,80,130,250,4,120
-2.499926282097750,80,85,190,250,5,60
-2.500217763135050,76,80,110,450,4,340
-2.500403206037660,76,80,150,425,4,275
-2.5004557248785600,28,35,50,350,7,300
-2.5005073190692200,44,50,180,350,6,170
-2.500529171210250,44,50,80,225,6,145
-2.500619447190740,60,65,170,275,5,105
-2.50075273322977,96,100,170,250,4,80
-2.500857931617,76,80,160,300,4,140
-2.5009265830177700,28,35,60,425,7,365
-2.5009503802467500,90,95,90,150,5,60
-2.501157677293620,38,45,110,325,7,215
-2.501362797444140,76,80,70,450,4,380
-2.501563629010490,68,75,70,125,7,55
-2.5015796125808500,44,50,60,475,6,415
-2.5015877340576500,28,35,50,425,7,375
-2.501808975175210,26,35,130,325,9,195
-2.5019037410212100,90,95,140,175,5,35
-2.501967977272930,80,85,80,175,5,95
-2.5020410795773000,26,35,120,325,9,205
-2.5020669720270600,28,35,50,400,7,350
-2.5020713500346700,44,50,90,275,6,185
-2.5023450145435700,76,80,190,425,4,235
-2.5024505260548600,76,80,50,275,4,225
-2.5026460417550200,28,35,200,450,7,250
-2.50310127492163,60,65,130,325,5,195
-2.503115970288970,44,50,90,375,6,285
-2.5031243982813800,44,50,190,325,6,135
-2.5031322728540100,42,50,120,175,8,55
-2.50313386248556,44,50,80,350,6,270
-2.5034739447087300,96,100,130,275,4,145
-2.503477057750040,76,80,80,500,4,420
-2.5035198917964900,28,35,70,225,7,155
-2.5035232959754600,32,40,180,275,8,95
-2.5035634519913900,86,90,120,450,4,330
-2.5035773439154100,44,50,100,250,6,150
-2.5036713637583000,48,55,190,225,7,35
-2.5039706595438600,76,80,70,425,4,355
-2.50397893560497,44,50,110,400,6,290
-2.5041429449268700,38,45,120,300,7,180
-2.504216105884820,26,35,170,275,9,105
-2.504479693224210,76,80,140,425,4,285
-2.5046282138027900,26,35,140,325,9,185
-2.5046597595073400,66,75,190,200,9,10
-2.504911930445570,96,100,60,275,4,215
-2.504979578949550,44,50,90,300,6,210
-2.504980280018290,74,80,110,150,6,40
-2.504981890776250,28,35,170,400,7,230
-2.5051360086056500,56,65,190,200,9,10
-2.5052260691605200,70,75,120,200,5,80
-2.505241385185230,32,40,200,275,8,75
-2.505652931427720,98,105,90,125,7,35
-2.505700281790980,76,80,90,225,4,135
-2.5057104398774500,44,50,70,300,6,230
-2.5057444280622500,64,70,120,175,6,55
-2.505799322306370,28,35,120,500,7,380
-2.505888460057070,90,95,200,225,5,25
-2.5061800477343700,76,80,150,350,4,200
-2.5063169843299600,44,50,120,350,6,230
-2.5063429442618600,44,50,200,375,6,175
-2.5065758813982800,66,75,60,100,9,40
-2.506669670787880,60,65,150,200,5,50
-2.506755192868490,76,80,190,400,4,210
-2.5068910326131800,44,50,70,275,6,205
-2.506954301519440,28,35,70,500,7,430
-2.5070678548899300,44,50,70,350,6,280
-2.5071192139808900,86,90,90,500,4,410
-2.5071297435956400,76,80,60,475,4,415
-2.507232160344060,76,80,190,350,4,160
-2.5073390858259200,90,95,50,125,5,75
-2.507505902703590,70,75,130,200,5,70
-2.5075238788251400,64,70,190,225,6,35
-2.507689923570030,100,105,120,175,5,55
-2.5077986673622500,28,35,60,350,7,290
-2.5078726798096900,44,50,70,250,6,180
-2.507974246818600,96,100,80,300,4,220
-2.508115474692720,96,100,120,325,4,205
-2.508139007969030,68,75,150,175,7,25
-2.508218616687850,76,80,140,475,4,335
-2.5083777984753800,96,100,60,225,4,165
-2.508456601638100,76,80,100,400,4,300
-2.5085778377253200,44,50,140,350,6,210
-2.5086193010518100,32,40,170,225,8,55
-2.5086572628025100,86,90,170,500,4,330
-2.508687771359180,84,90,140,175,6,35
-2.5088159079080500,44,50,70,325,6,255
-2.509023752984340,28,35,180,475,7,295
-2.509028386240820,76,80,90,425,4,335
-2.509043181291690,36,45,180,200,9,20
-2.50905651055031,28,35,50,500,7,450
-2.5091697380355600,44,50,80,425,6,345
-2.5092602541268000,76,80,120,250,4,130
-2.509303658353450,32,40,120,300,8,180
-2.509405624187520,96,100,140,325,4,185
-2.5094808721837100,28,35,170,475,7,305
-2.5096295667671,46,55,50,100,9,50
-2.509735750374410,86,90,180,475,4,295
-2.5100001296677600,76,80,60,300,4,240
-2.510005336806000,28,35,150,500,7,350
-2.5100470317391200,86,90,100,500,4,400
-2.5100572167233200,64,70,60,150,6,90
-2.510117906892640,44,50,140,225,6,85
-2.510369972282980,56,65,60,100,9,40
-2.5103830299300200,44,50,120,375,6,255
-2.510936556182150,26,35,150,200,9,50
-2.51093912996626,76,80,140,250,4,110
-2.510975261296630,44,50,110,250,6,140
-2.511011066334280,76,80,160,375,4,215
-2.511043473984300,86,90,150,500,4,350
-2.5112907601584800,76,80,180,350,4,170
-2.5114023601029800,80,85,90,175,5,85
-2.511711961394690,26,35,80,200,9,120
-2.5117298066056700,28,35,80,250,7,170
-2.5117462539261600,60,65,120,300,5,180
-2.5118393152969000,96,100,110,325,4,215
-2.511872729854700,86,90,200,450,4,250
-2.5119965948774000,76,80,170,300,4,130
-2.5121357221180700,76,80,80,275,4,195
-2.512297582629710,76,80,80,450,4,370
-2.5128447233174200,54,60,50,150,6,100
-2.512848777382040,96,100,130,300,4,170
-2.5128777423703,38,45,150,200,7,50
-2.5129525620179000,28,35,160,425,7,265
-2.5130577902368300,76,80,200,350,4,150
-2.513347531648410,76,80,120,350,4,230
-2.51381407167849,28,35,190,450,7,260
-2.5139554995074300,38,45,80,200,7,120
-2.513997419300790,44,50,60,450,6,390
-2.514033627343360,76,80,140,375,4,235
-2.5140397183308200,78,85,80,125,7,45
-2.5142320431041600,60,65,200,275,5,75
-2.5144773671979600,44,50,100,325,6,225
-2.5144844610696700,76,80,80,350,4,270
-2.514881469154140,28,35,120,225,7,105
-2.515015887016640,86,90,90,475,4,385
-2.515085958336320,44,50,100,275,6,175
-2.515097799339520,50,55,200,500,5,300
-2.515151723427200,44,50,200,325,6,125
-2.5153177538474100,28,35,60,325,7,265
-2.5153605777571000,70,75,60,175,5,115
-2.51537252988028,76,80,180,300,4,120
-2.515525474795580,76,80,140,350,4,210
-2.515668365247030,76,80,160,450,4,290
-2.515736782318170,26,35,180,275,9,95
-2.515761024159690,76,80,190,375,4,185
-2.51589163441772,74,80,180,200,6,20
-2.515901413579750,28,35,160,400,7,240
-2.516022912307100,38,45,170,225,7,55
-2.5160777423856000,44,50,100,375,6,275
-2.51618225181822,86,90,120,500,4,380
-2.5162264830169300,28,35,100,450,7,350
-2.5162338943350500,32,40,60,200,8,140
-2.516453795748730,76,80,80,375,4,295
-2.5165965154227700,80,85,50,150,5,100
-2.516736509421760,44,50,180,300,6,120
-2.516751853440540,76,80,100,250,4,150
-2.516808700027520,38,45,180,275,7,95
-2.516914642779000,44,50,190,300,6,110
-2.5173548924313100,100,105,60,150,5,90
-2.517386657486320,76,80,200,375,4,175
-2.517443698607110,44,50,130,350,6,220
-2.5175138095116900,48,55,60,150,7,90
-2.5175491735554500,96,100,170,275,4,105
-2.5175707940340100,44,50,100,350,6,250
-2.517627824922230,76,80,200,325,4,125
-2.5176816277587100,76,80,190,325,4,135
-2.518000532228450,100,105,170,200,5,30
-2.518031324745630,28,35,60,375,7,315
-2.5181531685470400,54,60,170,200,6,30
-2.5182127313175700,44,50,100,300,6,200
-2.5183729062498400,70,75,70,175,5,105
-2.5183744898595500,76,80,90,375,4,285
-2.5185346957709200,28,35,170,375,7,205
-2.5187051932187200,76,80,150,225,4,75
-2.5191809122861600,44,50,80,400,6,320
-2.519216813892330,28,35,130,500,7,370
-2.519363173382120,58,65,180,200,7,20
-2.5195956346387200,76,80,100,225,4,125
-2.519789959465190,86,90,170,350,4,180
-2.5198143943804500,28,35,110,500,7,390
-2.520009264346060,78,85,130,150,7,20
-2.520335769503600,48,55,200,250,7,50
-2.520435813689650,76,80,140,275,4,135
-2.5204755993180100,76,80,60,500,4,440
-2.5205833661343400,44,50,110,350,6,240
-2.5206404055606900,28,35,130,225,7,95
-2.5206772153419300,86,90,170,475,4,305
-2.5208057560433900,76,80,80,425,4,345
-2.520815718337240,98,105,50,100,7,50
-2.5208253958337000,44,50,110,375,6,265
-2.5209696733518700,28,35,140,500,7,360
-2.5212929892746900,76,80,100,300,4,200
-2.521303056988290,76,80,90,275,4,185
-2.5213440465694600,96,100,180,275,4,95
-2.521378042421880,86,90,100,475,4,375
-2.5215489916298600,48,55,120,175,7,55
-2.521657171758160,76,80,60,450,4,390
-2.5216908008698400,86,90,100,450,4,350
-2.5217799671806800,28,35,160,350,7,190
-2.5219409286945400,86,90,140,500,4,360
-2.5220478549074100,62,70,60,100,8,40
-2.522053652194350,28,35,50,450,7,400
-2.522084861343910,76,80,80,225,4,145
-2.5223142150082000,60,65,180,275,5,95
-2.5225079669641900,58,65,110,150,7,40
-2.522712502711230,76,80,180,325,4,145
-2.524069780238800,86,90,130,500,4,370
-2.5240790952797900,100,105,80,150,5,70
-2.524108302909120,26,35,60,200,9,140
-2.5241370736104800,100,105,190,225,5,35
-2.5242749757842300,44,50,150,300,6,150
-2.524303751798090,28,35,100,475,7,375
-2.524462014587210,96,100,130,325,4,195
-2.524715541647550,66,70,200,500,4,300
-2.5248339847891700,86,90,50,375,4,325
-2.524965671940750,28,35,50,475,7,425
-2.5251193415501700,42,50,60,150,8,90
-2.525130916874420,86,90,170,400,4,230
-2.525149905724260,86,90,50,425,4,375
-2.525249746613930,76,80,100,375,4,275
-2.5252919554817800,86,90,130,475,4,345
-2.5253640079610700,52,60,70,125,8,55
-2.525433430257930,76,80,100,325,4,225
-2.5256728744199400,28,35,170,325,7,155
-2.52571705932291,50,55,200,475,5,275
-2.52575051226749,86,90,160,475,4,315
-2.5261249250644200,28,35,150,400,7,250
-2.526305165635820,86,90,130,450,4,320
-2.5265575276554600,44,50,160,275,6,115
-2.5265616329217800,70,75,140,200,5,60
-2.5266108077511100,76,80,140,225,4,85
-2.526709110656440,86,90,110,500,4,390
-2.5268433395454500,28,35,90,400,7,310
-2.5271354169978200,60,65,60,200,5,140
-2.527501954151270,44,50,70,400,6,330
-2.527612293725770,44,50,110,275,6,165
-2.5276382135710100,54,60,190,225,6,35
-2.52801605113046,86,90,160,425,4,265
-2.5280762976163800,76,80,90,300,4,210
-2.5282712632003200,76,80,100,275,4,175
-2.528288369326270,28,35,120,475,7,355
-2.5283464836880900,76,80,70,275,4,205
-2.5283865495828200,44,50,90,325,6,235
-2.528472213933100,76,80,70,350,4,280
-2.5285259806119400,44,50,120,275,6,155
-2.5288121938981300,32,40,110,200,8,90
-2.5288168674875500,32,40,190,275,8,85
-2.5288870522813800,86,90,190,450,4,260
-2.528949181431200,38,45,60,200,7,140
-2.5291152453306700,32,40,180,225,8,45
-2.5292791522442600,76,80,70,250,4,180
-2.5293493199792300,94,100,50,100,6,50
-2.5293955882532900,44,50,150,375,6,225
-2.529511406038790,44,50,110,300,6,190
-2.529613104377580,76,80,120,375,4,255
-2.529971766911230,76,80,110,250,4,140
-2.530025011427080,86,90,180,425,4,245
-2.530488686606080,86,90,170,450,4,280
-2.5305283004512300,88,95,60,100,7,40
-2.530699577480680,44,50,110,225,6,115
-2.531338254322720,78,85,90,125,7,35
-2.531421206428170,68,75,50,100,7,50
-2.531504928030460,28,35,100,425,7,325
-2.5315548401323000,28,35,160,475,7,315
-2.5315786996932100,54,60,100,175,6,75
-2.5315908374238400,54,60,120,175,6,55
-2.531620721726850,46,55,80,125,9,45
-2.53164305211832,32,40,50,200,8,150
-2.5317632654281000,44,50,60,225,6,165
-2.5318621225523400,96,100,160,225,4,65
-2.532051401099840,26,35,120,300,9,180
-2.5321913638030900,32,40,160,200,8,40
-2.532263314481420,96,100,120,300,4,180
-2.532586983272180,26,35,160,200,9,40
-2.532773783315160,28,35,130,450,7,320
-2.5328719470218500,28,35,170,425,7,255
-2.532875389169860,82,90,190,200,8,10
-2.5329765343339600,78,85,160,175,7,15
-2.53304733155853,60,65,50,200,5,150
-2.533142969034230,76,80,110,400,4,290
-2.5334465011785500,86,90,70,500,4,430
-2.533991315353800,86,90,110,475,4,365
-2.534170847572600,86,90,130,400,4,270
-2.534211207393180,60,65,110,200,5,90
-2.5342743419943500,96,100,150,200,4,50
-2.53431681254794,78,85,60,100,7,40
-2.5345954421654500,38,45,200,275,7,75
-2.534625803952050,28,35,160,325,7,165
-2.534941494984860,28,35,70,375,7,305
-2.534970826007220,26,35,50,200,9,150
-2.535264457211000,96,100,80,200,4,120
-2.5353772276544700,76,80,120,275,4,155
-2.53538168850499,42,50,70,150,8,80
-2.535603047790560,44,50,140,300,6,160
-2.535679399792330,86,90,170,425,4,255
-2.535725732420920,46,55,160,175,9,15
-2.5358419286559100,28,35,130,475,7,345
-2.5359764681731100,28,35,90,450,7,360
-2.536196338350090,28,35,120,400,7,280
-2.536314096955620,92,100,70,100,8,30
-2.536724917496410,62,70,190,200,8,10
-2.536747124374640,60,65,190,275,5,85
-2.536918336485680,80,85,60,150,5,90
-2.536947595263990,44,50,80,325,6,245
-2.536956389792110,28,35,130,400,7,270
-2.5371851115629200,76,80,70,400,4,330
-2.537313804243260,32,40,180,250,8,70
-2.5373400856905000,76,80,160,275,4,115
-2.53737147389824,86,90,90,450,4,360
-2.5374323763335200,90,95,110,150,5,40
-2.537737002371530,50,55,190,500,5,310
-2.537878956327590,86,90,170,375,4,205
-2.537880152559770,76,80,190,300,4,110
-2.5380369265039100,44,50,50,300,6,250
-2.538581972389910,44,50,70,200,6,130
-2.5386100305410300,28,35,170,300,7,130
-2.5386476210381100,66,70,200,475,4,275
-2.538650576659450,76,80,110,300,4,190
-2.538787497753480,86,90,140,450,4,310
-2.538938953048470,86,90,160,350,4,190
-2.5389597402140000,26,35,180,225,9,45
-2.539058470800940,80,85,100,175,5,75
-2.539109971997600,28,35,60,400,7,340
-2.5393064906996500,26,35,200,275,9,75
-2.5394673443237800,28,35,110,475,7,365
-2.5396819276501300,38,45,110,200,7,90
-2.539722008346370,76,80,110,350,4,240
-2.539754667583680,38,45,160,200,7,40
-2.5398839661916200,86,90,50,500,4,450
-2.540020632736900,44,50,50,325,6,275
-2.5400284001595100,86,90,50,450,4,400
-2.5403582598475200,96,100,180,250,4,70
-2.5405271064140800,28,35,90,350,7,260
-2.540633539029610,86,90,50,400,4,350
-2.5407825583846700,28,35,200,400,7,200
-2.540850999094160,76,80,80,400,4,320
-2.5410301327422200,94,100,90,125,6,35
-2.5410447309645700,64,70,70,150,6,80
-2.541105950202620,28,35,150,350,7,200
-2.541123760779300,66,75,100,125,9,25
-2.5411558472618600,32,40,90,200,8,110
-2.541166322420700,76,80,50,300,4,250
-2.5412856833219900,60,65,180,225,5,45
-2.541313598783240,86,90,50,475,4,425
-2.541364021912260,36,45,110,150,9,40
-2.541431704085430,60,65,180,250,5,70
-2.5414384710864000,50,55,190,475,5,285
-2.5414411733583600,86,90,160,400,4,240
-2.5414617386062,70,75,170,200,5,30
-2.541703988964960,76,80,90,325,4,235
-2.541753742445230,32,40,50,175,8,125
-2.542000433603050,86,90,150,350,4,200
-2.5422326193297600,46,55,90,125,9,35
-2.542307819148660,86,90,160,325,4,165
-2.54235999991616,28,35,110,450,7,340
-2.542514260291880,76,80,50,225,4,175
-2.5426250959444300,76,80,110,275,4,165
-2.5426648839137900,82,90,70,100,8,30
-2.54272139012667,34,40,200,500,6,300
-2.5428953439949900,28,35,140,450,7,310
-2.5429272587885700,26,35,110,200,9,90
-2.54300966405293,28,35,130,425,7,295
-2.5431914273461500,44,50,50,225,6,175
-2.5433531732167500,60,65,160,200,5,40
-2.5433927038045700,28,35,150,450,7,300
-2.543397289096790,28,35,130,250,7,120
-2.543408490450050,28,35,180,400,7,220
-2.5434460287238300,38,45,90,200,7,110
-2.543654126217160,44,50,60,275,6,215
-2.543756284371840,86,90,150,450,4,300
-2.5437726578137400,38,45,180,225,7,45
-2.543852516158830,86,90,100,425,4,325
-2.543886028615160,28,35,140,225,7,85
-2.543901457629390,86,90,120,475,4,355
-2.5441390934951400,28,35,200,300,7,100
-2.544244645283130,84,90,110,150,6,40
-2.544290671776930,38,45,190,275,7,85
-2.544329084667710,28,35,80,475,7,395
-2.544437589909490,76,80,130,350,4,220
-2.544501393331400,44,50,60,250,6,190
-2.544643645355000,86,90,180,450,4,270
-2.5448876766954800,86,90,120,425,4,305
-2.544924813105650,28,35,60,300,7,240
-2.5449995385747500,28,35,100,225,7,125
-2.5450871789176400,76,80,60,275,4,215
-2.545136081422140,64,70,80,150,6,70
-2.5453471127955600,60,65,90,200,5,110
-2.5453648067682000,28,35,150,225,7,75
-2.5453677594547500,44,50,170,250,6,80
-2.545752592536930,86,90,200,400,4,200
-2.5457898047654700,86,90,170,325,4,155
-2.5458174401989700,100,105,70,150,5,80
-2.545846616171840,54,60,200,250,6,50
-2.5460169514660700,38,45,180,250,7,70
-2.546093242686100,70,75,110,175,5,65
-2.5461517166957800,28,35,70,250,7,180
-2.5462567316055900,28,35,70,450,7,380
-2.546523685826390,28,35,140,425,7,285
-2.546524372548050,76,80,70,325,4,255
-2.546614732547750,44,50,150,275,6,125
-2.5466501517268500,76,80,140,300,4,160
-2.5467189460111600,32,40,130,200,8,70
-2.5471300398954300,28,35,90,225,7,135
-2.547223251652040,28,35,180,425,7,245
-2.54724379738766,28,35,50,275,7,225
-2.5472907067526700,28,35,140,400,7,260
-2.5474446612986600,96,100,60,200,4,140
-2.547501750706880,56,65,100,125,9,25
-2.547524342997100,28,35,90,375,7,285
-2.5475630856532300,58,65,120,150,7,30
-2.547660844022850,70,75,80,175,5,95
-2.5477431747718200,28,35,120,425,7,305
-2.54789062151145,44,50,50,250,6,200
-2.547901545920760,48,55,70,150,7,80
-2.5479174319812300,86,90,150,400,4,250
-2.5480541852054600,86,90,150,475,4,325
-2.5483631073889700,28,35,160,300,7,140
-2.5483939208691300,82,90,100,125,8,25
-2.548597657150340,28,35,200,425,7,225
-2.548715855161960,76,80,150,375,4,225
-2.5487194364975200,76,80,100,350,4,250
-2.548865312854330,28,35,80,450,7,370
-2.548871733900160,38,45,50,200,7,150
-2.549078428000600,28,35,70,475,7,405
-2.549306099675840,86,90,80,475,4,395
-2.549322281419200,28,35,150,425,7,275
-2.5493629597428200,86,90,60,425,4,365
-2.549390320522090,58,65,150,175,7,25
-2.5494011969596600,96,100,170,225,4,55
-2.549471817055300,50,55,180,500,5,320
-2.549620804794580,28,35,140,250,7,110
-2.5497652838032600,28,35,180,450,7,270
-2.5498934177735700,86,90,80,250,4,170
-2.550073106436250,76,80,110,225,4,115
-2.5501654239115900,26,35,180,250,9,70
-2.5502994860859200,72,80,190,200,8,10
-2.550350374636950,88,95,100,125,7,25
-2.5504648308277300,50,55,200,450,5,250
-2.550500940739700,38,45,100,200,7,100
-2.5505374209775000,50,55,90,500,5,410
-2.5511489728218900,26,35,190,275,9,85
-2.5511793383940500,76,80,150,300,4,150
-2.5512215280420700,32,40,100,200,8,100
-2.5512545075036300,44,50,120,325,6,205
-2.551608758837010,86,90,60,350,4,290
-2.5518476191285700,68,75,80,125,7,45
-2.551911513594120,86,90,120,400,4,280
-2.552102862884980,76,80,110,375,4,265
-2.5521145270389800,86,90,80,500,4,420
-2.5521820911784100,26,35,50,175,9,125
-2.552554185829440,86,90,200,425,4,225
-2.5529673559008700,38,45,120,200,7,80
-2.553124526625940,86,90,70,475,4,405
-2.55313667396517,28,35,100,400,7,300
-2.5533813655410300,76,80,60,225,4,165
-2.5534436758813600,44,50,150,250,6,100
-2.553527713059580,28,35,110,425,7,315
-2.5535545760302500,28,35,170,450,7,280
-2.5535783838819900,74,80,120,150,6,30
-2.5536437366555400,50,55,160,500,5,340
-2.5539344289293600,54,60,60,150,6,90
-2.5539969338785800,86,90,50,350,4,300
-2.554088644978550,28,35,80,275,7,195
-2.554181424980150,28,35,190,350,7,160
-2.554360814180180,28,35,80,375,7,295
-2.5544203525667500,44,50,80,300,6,220
-2.5544511555029600,28,35,100,250,7,150
-2.554566981344790,86,90,120,225,4,105
-2.55459230065513,86,90,180,375,4,195
-2.554640121872530,96,100,190,275,4,85
-2.5547532717363500,86,90,130,425,4,295
-2.5548834811184200,44,50,160,250,6,90
-2.5548844830730200,44,50,130,275,6,145
-2.5549049112278700,84,90,70,125,6,55
-2.554919575195380,32,40,120,200,8,80
-2.5549589479490000,86,90,90,250,4,160
-2.5550343482595900,76,80,50,325,4,275
-2.5550810941567600,28,35,70,275,7,205
-2.5551381918603200,86,90,110,450,4,340
-2.555239498304460,26,35,100,200,9,100
-2.5554669051155300,48,55,80,150,7,70
-2.5557050753875700,86,90,190,400,4,210
-2.555755306843480,60,65,50,175,5,125
-2.555944214390940,50,55,120,450,5,330
-2.5559731341889500,86,90,140,475,4,335
-2.5560430596044400,50,55,170,350,5,180
-2.5562215566441500,26,35,120,200,9,80
-2.556272386791070,28,35,90,300,7,210
-2.5563819109768400,84,90,60,125,6,65
-2.556607018604300,74,80,60,125,6,65
-2.5567640066678400,32,40,140,200,8,60
-2.5568610779171000,84,90,180,200,6,20
-2.556982892966000,86,90,70,225,4,155
-2.5571351524477000,86,90,140,425,4,285
-2.5572797537870400,28,35,80,500,7,420
-2.5575135131156600,96,100,200,275,4,75
-2.5575154657671000,28,35,100,275,7,175
-2.557691938906450,60,65,120,200,5,80
-2.557915318158970,52,60,50,100,8,50
-2.557926806649430,70,75,90,175,5,85
-2.558061199106810,28,35,80,225,7,145
-2.558190356869600,80,85,200,250,5,50
-2.5582007505951800,66,70,190,500,4,310
-2.558271815481410,86,90,180,400,4,220
-2.558285476814540,70,75,50,150,5,100
-2.5585712078876000,80,85,170,200,5,30
-2.558740600656260,86,90,130,375,4,245
-2.55935538982344,76,80,70,300,4,230
-2.559432596617960,28,35,200,350,7,150
-2.5596741158762200,28,35,150,475,7,325
-2.559843373221120,74,80,70,125,6,55
-2.5598626823603300,28,35,70,425,7,355
-2.560022279134460,28,35,60,500,7,440
-2.5600224756357800,28,35,150,325,7,175
-2.56003877066993,66,70,190,475,4,285
-2.560242723827810,28,35,140,475,7,335
-2.5603124290217900,76,80,70,200,4,130
-2.560515943411980,86,90,60,375,4,315
-2.560623574905740,76,80,80,325,4,245
-2.560681851887970,44,50,160,225,6,65
-2.560721355579770,28,35,160,375,7,215
-2.5610634459153700,76,80,50,250,4,200
-2.561222825021820,86,90,160,450,4,290
-2.5612277623540200,34,40,190,475,6,285
-2.5614494932903600,28,35,130,375,7,245
-2.561651126075640,86,90,190,425,4,235
-2.5617489922374500,50,55,100,500,5,400
-2.5619059973969000,28,35,120,250,7,130
-2.5619937513223100,86,90,90,400,4,310
-2.562006378609900,86,90,70,450,4,380
-2.562074523935510,76,80,60,250,4,190
-2.5621075319541800,86,90,140,375,4,235
-2.5624786447033600,28,35,90,425,7,335
-2.5625597225478300,96,105,110,125,9,15
-2.5626191806329400,28,35,180,375,7,195
-2.5626332435173100,70,75,190,250,5,60
-2.5629479011883200,44,50,110,325,6,215
-2.5632527389237000,32,40,60,175,8,115
-2.563383732003430,74,80,150,175,6,25
-2.563495700591670,28,35,190,425,7,235
-2.563497422997700,66,70,180,500,4,320
-2.563775271281750,96,100,50,200,4,150
-2.5638450178421200,86,90,80,450,4,370
-2.563877527421470,28,35,140,275,7,135
-2.563881922598330,86,90,160,375,4,215
-2.5639386565938100,28,35,140,350,7,210
-2.5639525358302600,38,45,50,175,7,125
-2.564008622482880,86,90,70,375,4,305
-2.5640482154279300,76,80,170,250,4,80
-2.564073838413750,86,90,140,400,4,260
-2.5642591991979800,44,50,130,300,6,170
-2.564389774212200,86,90,150,425,4,275
-2.5645975003580400,86,90,60,325,4,265
-2.564618511452860,86,90,200,375,4,175
-2.564641681291840,86,90,190,350,4,160
-2.5648007409706900,28,35,80,350,7,270
-2.5648257692242100,50,55,90,475,5,385
-2.56490227346474,86,90,130,250,4,120
-2.5650269089261800,36,45,120,150,9,30
-2.565221344910230,86,90,110,425,4,315
-2.565244463773930,72,80,100,125,8,25
-2.565266553075050,86,90,190,375,4,185
-2.5654598688730300,80,85,190,225,5,35
-2.565719648166440,76,80,150,275,4,125
-2.5657312260097000,60,65,130,200,5,70
-2.5658478964165000,60,65,100,200,5,100
-2.565997390776150,86,90,60,400,4,340
-2.566046573859860,86,90,90,350,4,260
-2.566330432142050,28,35,70,350,7,280
-2.5663703811851100,26,35,90,200,9,110
-2.5664180073692300,46,55,130,150,9,20
-2.5665738213941300,96,100,90,200,4,110
-2.5666648528995200,62,70,100,125,8,25
-2.5666947575968200,50,55,170,500,5,330
-2.5668805605397800,86,90,130,225,4,95
-2.566975746521560,66,70,150,500,4,350
-2.5669886369242,42,50,80,150,8,70
-2.5670521268744200,96,105,80,100,9,20
-2.5671099260153700,36,45,150,175,9,25
-2.567178513516690,44,50,140,325,6,185
-2.5674479668511100,98,105,130,150,7,20
-2.5676788939688000,48,55,200,225,7,25
-2.5678973888867200,86,90,190,325,4,135
-2.5679632629144100,76,80,130,275,4,145
-2.5680550816612400,66,70,120,450,4,330
-2.5684674384829100,50,55,150,500,5,350
-2.56847567236312,76,80,140,325,4,185
-2.5686669149394400,50,55,50,375,5,325
-2.5687201881001100,28,35,190,325,7,135
-2.5687983543735900,34,40,200,475,6,275
-2.5688389959684900,50,55,120,500,5,380
-2.5690135010081100,34,40,50,375,6,325
-2.5690238619701500,66,70,160,500,4,340
-2.569090173953890,28,35,190,400,7,210
-2.5694441929603900,50,55,190,450,5,260
-2.5694797174685700,44,50,130,325,6,195
-2.56957981371779,86,90,150,325,4,175
-2.5697615431929100,34,40,190,500,6,310
-2.569982343724630,28,35,160,450,7,290
-2.570148085780470,86,90,80,375,4,295
-2.570170019310840,76,80,110,325,4,215
-2.570432052159890,76,80,150,250,4,100
-2.5705033173542400,50,55,100,450,5,350
-2.570607504619740,66,70,90,475,4,385
-2.5707714121679300,96,100,50,175,4,125
-2.5710211552567100,28,35,140,375,7,235
-2.5710333755785900,86,90,200,300,4,100
-2.571065809136510,86,90,100,400,4,300
-2.5711164831762300,50,55,170,475,5,305
-2.571194931149330,86,90,160,300,4,140
-2.5712837414054400,28,35,50,300,7,250
-2.5712997384384400,28,35,60,475,7,415
-2.5714017742609900,84,90,150,175,6,25
-2.5718597000302300,86,90,70,425,4,355
-2.5718626244178200,88,95,190,200,7,10
-2.572188771905370,28,35,180,350,7,170
-2.5724083716612100,66,70,90,500,4,410
-2.5724157378206100,94,100,160,175,6,15
-2.5724414214978400,54,60,80,150,6,70
-2.572489317008810,28,35,50,225,7,175
-2.572555532458380,76,80,120,325,4,205
-2.5728236341410300,50,55,160,425,5,265
-2.5729343797130800,80,85,120,175,5,55
-2.573126919089840,86,90,140,250,4,110
-2.573380613223760,26,35,130,200,9,70
-2.573477187057000,60,65,70,175,5,105
-2.573486328054900,86,90,170,300,4,130
-2.5737289256698700,44,50,170,275,6,105
-2.5740275086393400,76,80,80,300,4,220
-2.5743208185058900,96,100,110,200,4,90
-2.5743358892647000,90,95,180,200,5,20
-2.574689887965050,76,85,80,100,9,20
-2.5746943702276800,28,35,110,250,7,140
-2.574731134825060,86,90,180,350,4,170
-2.574732261262660,86,90,60,475,4,415
-2.5751750608061000,50,55,130,475,5,345
-2.5752687014743500,86,90,180,300,4,120
-2.575716664122220,60,65,60,175,5,115
-2.5761952886521400,50,55,100,475,5,375
-2.5761998479070300,58,65,60,125,7,65
-2.576230571952280,34,40,180,500,6,320
-2.576233564763210,28,35,200,325,7,125
-2.576350949596630,50,55,180,475,5,295
-2.5764506576609800,38,45,140,200,7,60
-2.5764772674102400,86,90,60,500,4,440
-2.57666111233251,28,35,180,325,7,145
-2.5768186859928900,58,65,70,125,7,55
-2.577060467479340,28,35,80,425,7,345
-2.5772041891378400,76,80,160,225,4,65
-2.5772338089489000,86,90,90,425,4,335
-2.5773052104320800,38,45,130,200,7,70
-2.577427273682210,28,35,90,275,7,185
-2.5775580308745900,86,90,200,350,4,150
-2.5775679640377200,50,55,170,375,5,205
-2.577818159837700,28,35,100,325,7,225
-2.577906963119460,76,80,160,250,4,90
-2.5780077340332400,66,70,170,350,4,180
-2.578098262817020,86,90,140,350,4,210
-2.578573514670770,32,40,70,175,8,105
-2.579292897721310,44,50,150,200,6,50
-2.5794237330982600,86,90,90,375,4,285
-2.5794661751824600,76,80,130,300,4,170
-2.579597744001990,26,35,70,175,9,105
-2.5797034164281800,50,55,50,500,5,450
-2.579722273306620,96,100,180,225,4,45
-2.579724663774670,86,90,180,325,4,145
-2.579745635301320,86,90,80,425,4,345
-2.5798359646935200,50,55,50,425,5,375
-2.5798547116276700,66,70,200,450,4,250
-2.580165386718820,26,35,60,175,9,115
-2.5804475784811800,86,90,50,275,4,225
-2.5805950968930400,64,70,100,150,6,50
-2.5807865360314500,28,35,80,400,7,320
-2.5808368756789200,52,60,90,125,8,35
-2.5810659078183300,50,55,50,400,5,350
-2.5812477215692900,98,105,160,175,7,15
-2.5814206729805000,44,50,180,275,6,95
-2.5814386714803600,48,55,100,150,7,50
-2.5815716832771700,66,70,100,500,4,400
-2.581573709254700,66,70,170,500,4,330
-2.5817018590201500,36,45,60,125,9,65
-2.5817035432675400,50,55,70,225,5,155
-2.5819218534894200,50,55,160,350,5,190
-2.582058409545850,66,70,160,425,4,265
-2.5821455665299100,28,35,190,375,7,185
-2.582177518261820,28,35,200,375,7,175
-2.582496065275690,44,50,120,300,6,180
-2.5824963185838800,28,35,50,325,7,275
-2.5826202385089600,66,70,100,450,4,350
-2.582666956469590,42,50,90,150,8,60
-2.5827136119871700,86,90,140,275,4,135
-2.5827512575549200,86,90,80,350,4,270
-2.5828942059194400,76,80,170,275,4,105
-2.5829732039159300,70,75,100,175,5,75
-2.582983730469360,28,35,60,275,7,215
-2.5830636943009500,50,55,140,500,5,360
-2.5831843723963200,50,55,50,350,5,300
-2.583217387545170,86,90,60,450,4,390
-2.5832233697096400,50,55,90,250,5,160
-2.5833246613256900,42,50,100,150,8,50
-2.5833839829769900,86,90,120,350,4,230
-2.583460484083150,96,100,100,200,4,100
-2.5836555976797300,50,55,170,400,5,230
-2.5836761563746200,66,70,50,375,4,325
-2.583722931484750,86,90,80,225,4,145
-2.5840495334795400,90,95,60,125,5,65
-2.5842844243792600,66,75,70,100,9,30
-2.5842994441737000,52,60,160,175,8,15
-2.5843948694799000,86,90,80,275,4,195
-2.584541699926820,38,45,70,175,7,105
-2.5845778881183900,50,55,70,500,5,430
-2.5847567626199200,76,80,130,325,4,195
-2.5847854308425300,28,35,180,300,7,120
-2.5849428657117200,50,55,120,475,5,355
-2.584989708662720,50,55,180,450,5,270
-2.5849958119368600,100,105,100,150,5,50
-2.5850646045553800,88,95,70,100,7,30
-2.585207529739340,38,45,60,175,7,115
-2.585335690040890,50,55,170,425,5,255
-2.585458064650480,96,100,120,200,4,80
-2.586252356254700,50,55,110,500,5,390
-2.586274748823580,28,35,110,400,7,290
-2.586353762497560,50,55,130,450,5,320
-2.5864821521027900,86,90,150,375,4,225
-2.5864895381133500,86,90,100,225,4,125
-2.5865631972616500,28,35,70,200,7,130
-2.586648546042470,28,35,60,450,7,390
-2.586670013676940,28,35,100,300,7,200
-2.5870360273971700,50,55,60,425,5,365
-2.5870362491286600,50,55,160,400,5,240
-2.5870908701769600,48,55,90,150,7,60
-2.5871306993054200,50,55,50,450,5,400
-2.587401878654660,44,50,170,225,6,55
-2.5874467751868700,76,85,110,125,9,15
-2.587456334414220,50,55,160,475,5,315
-2.587514693124630,66,70,170,400,4,230
-2.5876720423570800,86,90,100,250,4,150
-2.587721643790780,50,55,80,250,5,170
-2.5880253077310400,70,75,190,225,5,35
-2.588150418885320,28,35,70,400,7,330
-2.588205206321570,86,90,200,325,4,125
-2.5885204220182400,64,70,130,175,6,45
-2.588562681663590,86,90,60,300,4,240
-2.5886614898770200,86,90,90,300,4,210
-2.5886741391973900,28,35,120,350,7,230
-2.588768794255660,64,70,90,150,6,60
-2.589059365597870,86,90,110,400,4,290
-2.589159358770010,70,75,60,150,5,90
-2.589254769115670,50,55,130,500,5,370
-2.5894696714956600,38,45,110,175,7,65
-2.589509023131940,34,40,160,500,6,340
-2.589651834568880,96,100,60,175,4,115
-2.589868288559070,52,60,80,125,8,45
-2.589974121964740,26,35,110,175,9,65
-2.5902844770196100,60,65,140,200,5,60
-2.590461058724960,50,55,170,325,5,155
-2.5906119215003900,28,35,120,375,7,255
-2.590618546561710,34,40,120,450,6,330
-2.590620137554860,50,55,110,475,5,365
-2.590689322044320,28,35,90,325,7,235
-2.5907148225719500,28,35,120,275,7,155
-2.590795394476830,34,40,100,500,6,400
-2.5910306458045900,86,90,120,375,4,255
-2.591071644345880,86,90,90,275,4,185
-2.591361688205810,32,40,110,175,8,65
-2.5914022720831200,86,90,120,250,4,130
-2.5914291935677600,60,65,110,175,5,65
-2.591488115744930,44,50,80,200,6,120
-2.5915713784878200,54,60,70,150,6,80
-2.591679881585090,28,35,50,250,7,200
-2.5918753637003500,76,80,120,300,4,180
-2.59188273506113,86,95,110,125,9,15
-2.5919140119025600,66,70,170,475,4,305
-2.5921816152452700,50,55,150,450,5,300
-2.5922586331687600,86,90,70,350,4,280
-2.5923972905666900,50,55,160,325,5,165
-2.592398495775710,78,85,70,100,7,30
-2.5924180553915600,28,35,160,275,7,115
-2.5924578794251200,28,35,60,250,7,190
-2.5925857994697600,56,65,70,100,9,30
-2.5927844675590800,28,35,150,300,7,150
-2.5928946692060700,64,70,50,125,6,75
-2.5929932311437700,66,70,140,500,4,360
-2.5930411618382400,86,90,110,250,4,140
-2.5931060506741400,50,55,70,375,5,305
-2.593157871997550,28,35,70,325,7,255
-2.5932203876586100,50,55,60,400,5,340
-2.593305034122620,86,90,90,225,4,135
-2.5933076256436900,28,35,70,300,7,230
-2.593312405181460,96,100,70,175,4,105
-2.593463192075650,34,40,90,500,6,410
-2.5934721391231700,28,35,190,300,7,110
-2.5935654900830200,32,40,80,175,8,95
-2.593819670739050,74,80,50,100,6,50
-2.593825022998420,50,55,180,400,5,220
-2.5939167872360700,34,40,90,475,6,385
-2.5941180864323100,34,40,170,400,6,230
-2.5941876007789,26,35,140,200,9,60
-2.594634316737920,50,55,180,425,5,245
-2.5948036000338600,86,90,190,300,4,110
-2.594859236773600,66,70,110,500,4,390
-2.5950844407936500,90,95,70,125,5,55
-2.595104595396270,66,70,180,475,4,295
-2.5953843310483600,34,40,50,350,6,300
-2.5954055815673600,50,55,130,250,5,120
-2.59547138354648,28,35,60,225,7,165
-2.5955686354350900,28,35,80,325,7,245
-2.595604616103070,66,70,120,500,4,380
-2.5958905545392000,48,55,140,175,7,35
-2.5959467302643900,50,55,120,400,5,280
-2.5960762934091400,68,75,160,175,7,15
-2.5962370729613800,80,85,70,150,5,80
-2.596259919847520,86,90,100,375,4,275
-2.5962731034414900,42,50,50,125,8,75
-2.5963559727602300,76,80,200,275,4,75
-2.5964919381806600,28,35,100,375,7,275
-2.596660229453810,86,90,100,275,4,175
-2.596724110692600,50,55,130,225,5,95
-2.5968274969575300,100,105,90,150,5,60
-2.597093368184650,86,90,70,275,4,205
-2.5971954743839400,66,70,130,500,4,370
-2.5973997420611400,34,40,170,500,6,330
-2.597644911731170,48,55,130,175,7,45
-2.5978416411361600,96,100,160,200,4,40
-2.5979091052370600,28,35,100,350,7,250
-2.5982099652405400,66,70,190,450,4,260
-2.598297714454140,86,90,80,400,4,320
-2.5983567079083900,86,90,150,225,4,75
-2.598575851768230,56,60,200,500,4,300
-2.5986495787320000,50,55,90,400,5,310
-2.598657400057940,68,75,90,125,7,35
-2.598856593904130,86,90,70,250,4,180
-2.5988784918172800,50,55,100,425,5,325
-2.5988896555467900,70,75,120,175,5,55
-2.5989391495757700,50,55,60,350,5,290
-2.5991328713396600,100,105,130,175,5,45
-2.5993059976536700,92,100,90,100,8,10
-2.599391557925430,28,35,110,225,7,115
-2.5995723478867800,70,75,200,250,5,50
-2.599949951747640,86,90,110,350,4,240
-2.6003302795819100,86,90,110,375,4,265
-2.6005409553852100,28,35,130,350,7,220
-2.600575291401160,34,40,170,350,6,180
-2.6006117052580600,66,70,180,450,4,270
-2.6007327277748900,96,100,130,200,4,70
-2.6007842972370900,86,90,110,275,4,165
-2.6008233534315100,94,100,130,150,6,20
-2.6008643092698500,28,35,110,350,7,240
-2.6010473852239100,50,55,90,450,5,360
-2.601211331364400,86,90,130,350,4,220
-2.6012466693381500,66,70,160,475,4,315
-2.601322920149400,66,70,120,225,4,105
-2.601441276517450,44,50,190,275,6,85
-2.6015058740143600,86,90,100,325,4,225
-2.6016729616578300,66,70,170,425,4,255
-2.6016732923659500,66,70,100,475,4,375
-2.601842415271760,90,95,120,150,5,30
-2.602286128147840,60,65,80,175,5,95
-2.602385569557480,64,70,140,175,6,35
-2.602466151298810,50,55,80,450,5,370
-2.6026213220342000,50,55,60,375,5,315
-2.602786326198580,50,55,110,450,5,340
-2.602801443394380,90,95,150,175,5,25
-2.602944907691620,42,50,130,175,8,45
-2.603153864527630,22,30,200,500,8,300
-2.603259400716170,72,80,70,100,8,30
-2.603385343721830,86,90,140,300,4,160
-2.6034296813738900,28,35,110,275,7,165
-2.603518003887640,50,55,120,225,5,105
-2.603903451110240,26,35,80,175,9,95
-2.6039632900942100,50,55,150,400,5,250
-2.604136301800130,62,70,70,100,8,30
-2.6042437923532100,50,55,50,475,5,425
-2.604303909727240,86,90,70,400,4,330
-2.6043251284459,34,40,200,450,6,250
-2.6044997766315500,96,100,140,200,4,60
-2.604723448980510,86,90,120,275,4,155
-2.604729869601330,34,40,120,225,6,105
-2.604749589005830,48,55,50,125,7,75
-2.604830734101370,46,55,60,100,9,40
-2.604865654102450,50,55,150,350,5,200
-2.6048866262234600,68,75,130,150,7,20
-2.6050479409597700,34,40,100,450,6,350
-2.6052085762769000,44,50,200,275,6,75
-2.605239947941460,86,90,70,325,4,255
-2.605248921062610,64,70,200,225,6,25
-2.605314908378750,66,70,50,400,4,350
-2.6053467897002900,66,70,50,425,4,375
-2.6055438816276400,42,50,200,225,8,25
-2.605546170392460,28,35,140,300,7,160
-2.605561826167690,76,80,150,200,4,50
-2.605590262899070,66,70,120,475,4,355
-2.6056804433727400,86,90,150,300,4,150
-2.6058148820168600,86,90,100,350,4,250
-2.605840119383410,34,40,120,500,6,380
-2.6059535734263700,86,90,150,275,4,125
-2.606416854670020,84,90,120,150,6,30
-2.606550067888000,50,55,140,400,5,260
-2.6066470842549100,66,70,130,450,4,320
-2.6067540455916200,28,35,170,250,7,80
-2.606831640648440,50,55,170,450,5,280
-2.606873894981670,58,65,50,100,7,50
-2.607026136010140,32,40,190,250,8,60
-2.607093135998140,50,55,130,375,5,245
-2.607115261494890,46,55,190,200,9,10
-2.6072363988641500,50,55,200,400,5,200
-2.6073149046392700,92,95,200,500,3,300
-2.6073734071842200,50,55,200,425,5,225
-2.607517721851720,50,55,140,425,5,285
-2.6075908767725400,66,70,100,425,4,325
-2.607626159946570,42,50,140,175,8,35
-2.60764934857167,34,40,130,500,6,370
-2.6076542477850400,50,55,130,400,5,270
-2.6077219612494500,50,55,90,350,5,260
-2.6083389064699100,50,55,70,475,5,405
-2.6084249204569200,50,55,170,300,5,130
-2.6084372099463000,66,70,170,375,4,205
-2.6085679293973500,50,55,60,325,5,265
-2.6085747454529400,50,55,130,425,5,295
-2.6088000433140900,66,70,70,500,4,430
-2.608860988542720,34,40,50,400,6,350
-2.608930580371520,66,70,130,475,4,345
-2.6089506579999100,34,40,50,425,6,375
-2.609309091635620,52,60,130,150,8,20
-2.6093265487946100,50,55,70,450,5,380
-2.6097217096847900,28,35,110,375,7,265
-2.609938377325570,66,70,160,400,4,240
-2.609952756513140,78,85,100,125,7,25
-2.610063608262370,78,85,190,200,7,10
-2.610175635687820,88,95,80,100,7,20
-2.6102908763344600,34,40,190,450,6,260
-2.610430474037760,66,70,50,350,4,300
-2.6106182024967600,34,40,160,425,6,265
-2.6106300878814500,38,45,80,175,7,95
-2.611023703433710,66,70,60,425,4,365
-2.6114911681967100,34,40,140,500,6,360
-2.6114912057494300,86,90,140,225,4,85
-2.611504178871790,50,55,150,425,5,275
-2.6115599962241500,50,55,150,475,5,325
-2.6116562074794,28,35,150,375,7,225
-2.611689897576820,86,90,160,275,4,115
-2.6117137181786900,86,90,110,225,4,115
-2.6118269505167800,66,70,70,225,4,155
-2.61189927758031,34,40,150,500,6,350
-2.611984011010500,50,55,200,300,5,100
-2.6119859493916300,50,55,190,400,5,210
-2.612184914577770,50,55,120,425,5,305
-2.612204645914720,66,70,50,500,4,450
-2.6123450752666800,50,55,80,375,5,295
-2.612665677530770,22,30,200,475,8,275
-2.6128297380644400,86,90,90,325,4,235
-2.612853061816940,60,65,90,175,5,85
-2.6128636090708300,66,70,110,475,4,365
-2.612886488554740,66,70,140,450,4,310
-2.612952084558960,66,70,170,325,4,155
-2.61310191548456,36,45,70,125,9,55
-2.613136598293580,86,90,100,300,4,200
-2.6131572885377600,44,50,110,200,6,90
-2.613356682477750,50,55,190,425,5,235
-2.613416361556290,28,35,150,275,7,125
-2.613506674212630,50,55,180,375,5,195
-2.6135367526375400,76,80,80,200,4,120
-2.6135846536445500,50,55,80,475,5,395
-2.6137450110972700,50,55,80,500,5,420
-2.613920509907980,76,80,170,225,4,55
-2.613930333676480,28,35,150,250,7,100
-2.6140951184770500,66,70,150,400,4,250
-2.614213593652450,28,35,110,300,7,190
-2.614367298738720,80,85,50,125,5,75
-2.6143912541621300,66,70,50,475,4,425
-2.6144098495659200,66,70,170,450,4,280
-2.614474007223960,86,90,70,300,4,230
-2.614573172838540,76,80,180,275,4,95
-2.614675393647240,66,70,180,425,4,245
-2.614755085583700,98,105,60,100,7,40
-2.6150566883644500,22,30,190,500,8,310
-2.6150880154881200,34,40,90,450,6,360
-2.615478993475970,50,55,180,325,5,145
-2.6156399314237600,66,70,160,350,4,190
-2.615708928340900,56,60,200,475,4,275
-2.6157492701900100,44,50,60,200,6,140
-2.615959579816290,100,105,110,150,5,40
-2.615966283684770,34,40,170,475,6,305
-2.6160440623366100,86,90,60,250,4,190
-2.6162277442767700,50,55,100,225,5,125
-2.6162503274670900,56,60,190,500,4,310
-2.6162609625002000,66,70,60,375,4,315
-2.61627546115725,66,70,90,450,4,360
-2.616346886835040,34,40,80,250,6,170
-2.6168561440387800,44,50,100,200,6,100
-2.616899053647480,86,90,110,300,4,190
-2.616948468622690,100,105,50,125,5,75
-2.6169489338517200,76,80,180,250,4,70
-2.617014703803450,26,35,170,200,9,30
-2.6170606203623400,44,50,90,200,6,110
-2.6172933502757500,50,55,140,375,5,235
-2.617355072974670,34,40,70,225,6,155
-2.6174271979523100,50,55,140,450,5,310
-2.617818197470360,100,105,200,225,5,25
-2.6178198665137500,34,40,100,475,6,375
-2.6181215930337900,54,60,200,225,6,25
-2.6185219960731000,50,55,90,375,5,285
-2.6185856883208700,34,40,50,450,6,400
-2.618793523214,66,70,200,425,4,225
-2.618856246167700,66,70,60,350,4,290
-2.619078727178570,50,55,100,400,5,300
-2.6192550907848600,66,70,50,450,4,400
-2.6192872027181300,38,45,90,175,7,85
-2.6194359321969200,66,70,90,250,4,160
-2.6195755320374000,86,90,70,200,4,130
-2.6198354370287100,56,60,190,475,4,285
-2.620108400590450,66,70,80,250,4,170
-2.620181409532080,66,70,120,400,4,280
-2.62025964340538,34,40,90,250,6,160
-2.620356667524800,54,60,100,150,6,50
-2.620526034844450,44,50,160,200,6,40
-2.6205606866153100,44,50,180,225,6,45
-2.620616279742110,86,90,50,325,4,275
-2.6207956142152500,66,70,90,400,4,310
-2.6208090764446700,86,90,50,300,4,250
-2.6209397851348600,66,70,130,225,4,95
-2.62096905278703,64,70,110,150,6,40
-2.62100825882235,66,70,200,400,4,200
-2.621238423899730,38,45,190,250,7,60
-2.6212481388412400,66,70,160,300,4,140
-2.621250519381890,50,55,160,300,5,140
-2.6213617540603400,34,40,180,475,6,295
-2.621446332034070,60,65,190,250,5,60
-2.6214822761428500,86,90,170,250,4,80
-2.621633829544600,80,85,80,150,5,70
-2.6217990792380200,44,50,180,250,6,70
-2.6218596453948200,34,40,130,475,6,345
-2.621904820911730,50,55,150,325,5,175
-2.6219724820888100,50,55,70,425,5,355
-2.6219887879011200,50,55,110,425,5,315
-2.6221622679013300,50,55,60,300,5,240
-2.6224632042933300,50,55,200,350,5,150
-2.6224767277586700,50,55,60,500,5,440
-2.622531208522800,86,90,150,250,4,100
-2.6225393510311800,92,95,190,500,3,310
-2.6225810901430000,28,35,80,300,7,220
-2.622600040832880,26,35,190,250,9,60
-2.6226119242717600,66,70,140,400,4,260
-2.62276244705228,76,80,110,200,4,90
-2.6228044092418000,66,70,150,475,4,325
-2.622880795255200,94,100,60,100,6,40
-2.62297266321589,66,70,60,325,4,265
-2.6230684969473600,66,70,160,325,4,165
-2.623111383916390,34,40,160,400,6,240
-2.6231420899927700,86,90,120,325,4,205
-2.6231652668078700,74,80,80,125,6,45
-2.6232970982933600,28,35,130,275,7,145
-2.623484902452830,34,40,110,500,6,390
-2.6237075804493000,66,70,150,450,4,300
-2.6240018779659200,86,90,80,325,4,245
-2.6242910157057400,50,55,160,375,5,215
-2.6244395949621600,50,55,190,350,5,160
-2.624495020779670,50,55,90,275,5,185
-2.6245439351073600,50,55,190,325,5,135
-2.6245934459196800,50,55,140,250,5,110
-2.624651180138700,66,70,130,400,4,270
-2.6246820954192600,28,35,170,225,7,55
-2.624759282892310,28,35,120,325,7,205
-2.624815028134350,86,90,50,250,4,200
-2.6249649846343700,50,55,150,225,5,75
-2.625039201462420,66,70,140,425,4,285
-2.6253487240978300,66,70,110,450,4,340
-2.6256656861949300,50,55,90,425,5,335
-2.6257375637553000,32,40,170,200,8,30
-2.6257383459091000,76,80,60,200,4,140
-2.625988404514600,34,40,160,475,6,315
-2.6261185135086700,44,50,50,200,6,150
-2.6263316411941900,86,90,60,275,4,215
-2.6265797014705400,96,100,80,175,4,95
-2.6266791377690900,32,40,90,175,8,85
-2.626730875270280,66,70,120,425,4,305
-2.6267486510236500,66,70,150,425,4,275
-2.6269733789114600,34,40,60,425,6,365
-2.62717535041689,66,70,130,375,4,245
-2.627248452658820,86,90,130,275,4,145
-2.627371870045270,50,55,190,375,5,185
-2.6274728368720300,66,70,80,475,4,395
-2.627505027830700,34,40,70,500,6,430
-2.627552065897920,66,70,180,400,4,220
-2.627587486352050,28,35,160,250,7,90
-2.62781549831897,28,35,160,225,7,65
-2.6278540684207800,54,60,90,150,6,60
-2.62791390648907,50,55,90,225,5,135
-2.6279877767593900,34,40,130,450,6,320
-2.628094454854410,50,55,100,250,5,150
-2.6281243196762500,50,55,50,275,5,225
-2.6282218322996000,50,55,110,400,5,290
-2.6283097509882400,22,30,190,475,8,285
-2.6284227112555700,50,55,180,350,5,170
-2.6286726611072500,94,100,100,125,6,25
-2.628692703883170,68,75,60,100,7,40
-2.6288379977918300,66,70,190,400,4,210
-2.628839130615610,76,80,190,275,4,85
-2.6289152661965000,50,55,120,250,5,130
-2.628922154911530,50,55,80,275,5,195
-2.628959910247660,32,40,100,175,8,75
-2.629052636074820,50,55,200,375,5,175
-2.6292718933459500,86,90,50,225,4,175
-2.629449379722700,50,55,140,475,5,335
-2.629772099410570,76,80,50,200,4,150
-2.629773840146260,34,40,170,375,6,205
-2.6298908206012600,66,70,70,475,4,405
-2.629935581469790,50,55,60,450,5,390
-2.6306431198638300,32,40,50,150,8,100
-2.630761520143890,50,55,140,350,5,210
-2.6308843263118900,50,55,70,275,5,205
-2.631200505584360,56,60,160,500,4,340
-2.6312044669017900,96,100,190,250,4,60
-2.631253329984260,34,40,130,225,6,95
-2.63147158862668,28,35,110,325,7,215
-2.631769676751370,86,90,160,250,4,90
-2.631859844204130,42,50,110,150,8,40
-2.631941914096920,100,105,140,175,5,35
-2.6319518382326800,66,70,150,350,4,200
-2.631969824987730,50,55,80,350,5,270
-2.6321154031824600,28,35,130,300,7,170
-2.6321625048249800,34,40,170,325,6,155
-2.632293154405220,66,70,130,425,4,295
-2.632409599485710,50,55,140,275,5,135
-2.632418159635820,50,55,80,225,5,145
-2.6324402678049900,66,70,70,375,4,305
-2.6324670835438900,34,40,50,500,6,450
-2.6325770386699100,44,50,130,200,6,70
-2.632712634880550,66,70,60,400,4,340
-2.6327491065209600,66,70,140,275,4,135
-2.63277036669506,66,70,180,375,4,195
-2.632877345410580,86,90,170,275,4,105
-2.633056597728200,34,40,150,450,6,300
-2.6331225955304300,50,55,160,450,5,290
-2.633191202991680,54,60,130,175,6,45
-2.6334007930325600,28,35,140,325,7,185
-2.633429917604140,76,80,50,175,4,125
-2.633586184382650,92,100,80,100,8,20
-2.6336396931157600,50,55,70,350,5,280
-2.6339053231486900,60,65,170,200,5,30
-2.634035028218960,26,35,50,150,9,100
-2.6341314892405700,96,100,110,175,4,65
-2.634262036658750,34,40,60,325,6,265
-2.6348259828945000,28,35,170,275,7,105
-2.634963092602000,50,55,90,300,5,210
-2.6353731413061,50,55,70,250,5,180
-2.6355144819654300,66,70,80,450,4,370
-2.6355631845561900,26,35,90,175,9,85
-2.6355952427593000,70,75,80,150,5,70
-2.6355955405447500,54,60,50,125,6,75
-2.635642153109740,86,90,130,325,4,195
-2.6356673355443500,34,40,100,425,6,325
-2.635717034248010,34,40,60,350,6,290
-2.635798818596790,44,50,120,200,6,80
-2.635944784664230,34,40,130,400,6,270
-2.6360298196542700,66,70,190,350,4,160
-2.636228177386030,86,90,80,300,4,220
-2.6363246974027400,86,90,130,300,4,170
-2.636377313261660,86,90,60,225,4,165
-2.6364061661060900,38,45,170,200,7,30
-2.636423769905900,50,55,120,350,5,230
-2.6364434767455100,34,40,110,475,6,365
-2.636471821837620,66,70,80,500,4,420
-2.636671764566910,38,45,100,175,7,75
-2.6366728925185300,34,40,170,425,6,255
-2.6367918366785700,34,40,160,350,6,190
-2.6371873214833400,50,55,60,475,5,415
-2.637210058525410,76,80,180,225,4,45
-2.6374652243911500,92,95,200,475,3,275
-2.637475147742150,66,70,90,425,4,335
-2.637497899629870,86,90,110,325,4,215
-2.637561255816070,34,40,60,375,6,315
-2.637612315264910,34,40,50,475,6,425
-2.6376631958794300,50,55,120,275,5,155
-2.637788866578080,96,100,90,175,4,85
-2.6378735475599300,92,100,110,125,8,15
-2.6382410583436700,96,100,50,150,4,100
-2.638488568837630,92,95,190,475,3,285
-2.63851583308287,50,55,200,325,5,125
-2.6390100955337700,66,70,190,425,4,235
-2.639227318510030,76,80,90,200,4,110
-2.639312533455750,34,40,170,300,6,130
-2.639499933136750,66,70,110,425,4,315
-2.6396179076384300,66,70,190,375,4,185
-2.63966120791718,66,70,200,350,4,150
-2.6397738761187300,66,70,200,300,4,100
-2.639836393904500,34,40,180,450,6,270
-2.639956986282300,80,85,100,150,5,50
-2.640036016562430,50,55,100,275,5,175
-2.640104684713050,66,70,170,300,4,130
-2.640197199430920,58,65,80,125,7,45
-2.6403246351500300,86,90,140,325,4,185
-2.6404482844463200,34,40,140,450,6,310
-2.6404936431006500,66,70,140,375,4,235
-2.640505711121330,28,35,130,325,7,195
-2.6405110304388300,98,105,100,125,7,25
-2.640574381977350,64,70,180,200,6,20
-2.64070650150992,22,30,180,500,8,320
-2.6407978962658800,66,70,100,225,4,125
-2.6412181748243200,50,55,80,400,5,320
-2.6415643501566100,34,40,120,400,6,280
-2.6420820719641200,66,70,140,475,4,335
-2.6420855151980600,34,40,120,475,6,355
-2.6423852549491700,56,60,180,500,4,320
-2.6424220240127200,34,40,120,250,6,130
-2.64244846161471,34,40,180,425,6,245
-2.64250335543766,96,105,140,150,9,10
-2.6427930159581800,56,60,170,350,4,180
-2.642805862737450,66,70,70,450,4,380
-2.6428218026155500,66,70,90,350,4,260
-2.6429525732287300,98,105,190,200,7,10
-2.642966745880670,34,40,200,300,6,100
-2.6433054519545900,50,55,80,425,5,345
-2.6437479824720600,66,70,140,250,4,110
-2.6438904972492900,66,70,90,375,4,285
-2.643925123559170,70,75,70,150,5,80
-2.6440442800701800,66,70,50,275,4,225
-2.6440848290393900,66,70,180,350,4,170
-2.644164466470960,84,90,50,100,6,50
-2.6441896761204100,48,55,110,150,7,40
-2.644382283431120,60,65,100,175,5,75
-2.6448205032123600,34,40,130,375,6,245
-2.6449084752237100,50,55,100,300,5,200
-2.6449855408005300,34,40,150,475,6,325
-2.645089735105430,66,70,100,250,4,150
-2.6451555243350500,66,70,190,325,4,135
-2.6451764113496300,66,70,80,275,4,195
-2.645183492702610,66,70,90,300,4,210
-2.6452307375220800,60,65,50,150,5,100
-2.645302073890030,44,50,60,175,6,115
-2.6453686596779600,66,70,80,425,4,345
-2.6454426577116300,66,70,100,400,4,300
-2.6455096369111800,28,35,150,200,7,50
-2.6455263913224,34,40,150,400,6,250
-2.645642094349160,38,45,190,225,7,35
-2.645647912989110,22,30,50,375,8,325
-2.645782697877510,44,50,50,175,6,125
-2.6458810242820900,46,55,100,125,9,25
-2.645960981212680,34,40,90,225,6,135
-2.6460884895758000,34,40,60,400,6,340
-2.6462749936650000,50,55,180,300,5,120
-2.646310424799140,34,40,70,475,6,405
-2.646439068880460,34,40,200,425,6,225
-2.646905168857470,66,70,130,250,4,120
-2.646954575634640,34,40,90,350,6,260
-2.6470846773634500,50,55,120,375,5,255
-2.647104208218240,80,85,90,150,5,60
-2.6473359753507200,36,45,50,100,9,50
-2.6473433924010300,50,55,140,225,5,85
-2.647413900768590,34,40,90,400,6,310
-2.6474240339766700,66,70,90,225,4,135
-2.6475327507147100,34,40,200,400,6,200
-2.647661585567210,66,70,160,375,4,215
-2.6477358601765900,56,60,90,500,4,410
-2.6478121814212800,50,55,110,250,5,140
-2.647846204459330,34,40,190,425,6,235
-2.647965143102950,34,40,70,375,6,305
-2.6480413318153600,66,70,120,250,4,130
-2.648043986875370,34,40,180,400,6,220
-2.648182104506430,34,40,140,250,6,110
-2.6482985201010000,22,30,90,500,8,410
-2.6484015288234800,66,70,180,325,4,145
-2.648404804644460,66,70,60,475,4,415
-2.6484336605334800,76,80,160,200,4,40
-2.6486421464435400,32,40,190,225,8,35
-2.648703201114560,94,100,190,200,6,10
-2.648853074188330,56,60,120,450,4,330
-2.648989032490260,56,60,100,500,4,400
-2.649219847883750,66,70,200,375,4,175
-2.649233759818610,66,70,70,425,4,355
-2.649330988840500,22,30,50,425,8,375
-2.64938278525317,90,95,80,125,5,45
-2.649495582011940,66,70,110,400,4,290
-2.6495093714729100,34,40,120,425,6,305
-2.649566813839290,66,70,160,450,4,290
-2.6495676258306900,50,55,70,325,5,255
-2.649665388883510,50,55,50,300,5,250
-2.6501303250733100,50,55,100,375,5,275
-2.6505846062586300,66,70,80,350,4,270
-2.6506182761266500,86,90,180,275,4,95
-2.650674518241920,92,95,170,500,3,330
-2.650687884411190,50,55,110,350,5,240
-2.650883148339450,34,40,90,300,6,210
-2.6509455317913300,34,40,140,275,6,135
-2.651198164397810,50,55,110,300,5,190
-2.6511982069844800,84,90,80,125,6,45
-2.651286010511570,22,30,90,250,8,160
-2.6513953058675000,34,40,70,450,6,380
-2.651537507862680,50,55,100,325,5,225
-2.6515489957523800,50,55,100,350,5,250
-2.651562944326000,22,30,160,500,8,340
-2.6515991006752600,34,40,160,325,6,165
-2.6516412662875400,34,40,170,450,6,280
-2.6520865149510100,34,40,70,275,6,205
-2.652262985131690,38,45,200,250,7,50
-2.6524193765692500,34,40,180,375,6,195
-2.6526290761719600,66,70,150,325,4,175
-2.65277320615521,76,80,100,200,4,100
-2.652806078209010,34,40,190,350,6,160
-2.652841037461060,66,70,180,300,4,120
-2.652922029035170,50,55,190,300,5,110
-2.653018916823200,80,85,130,175,5,45
-2.6531366832103400,54,60,140,175,6,35
-2.653194836040740,66,70,100,325,4,225
-2.6532566610426500,50,55,70,400,5,330
-2.6534159149725400,28,35,80,200,7,120
-2.6534297522944000,22,30,50,350,8,300
-2.653551318742100,92,95,180,500,3,320
-2.6536862876366900,34,40,160,300,6,140
-2.6537246515427100,66,70,120,350,4,230
-2.6538214421362600,42,50,180,200,8,20
-2.6538507740741500,66,70,60,500,4,440
-2.653948591688240,34,40,190,375,6,185
-2.6540372357391800,66,70,80,375,4,295
-2.6542231890445500,34,40,80,350,6,270
-2.654349101361550,34,40,90,425,6,335
-2.654693849124500,34,40,150,425,6,275
-2.6547174574057300,56,60,170,500,4,330
-2.654721911285150,34,40,150,350,6,200
-2.654848171514150,26,35,100,175,9,75
-2.6549742044423400,22,30,120,450,8,330
-2.6551422561174400,58,65,130,150,7,20
-2.6551680979265700,44,50,70,175,6,105
-2.655495870659790,34,40,80,225,6,145
-2.655552840058960,50,55,130,350,5,220
-2.65566901577058,82,90,80,100,8,20
-2.6556920671830000,50,55,90,325,5,235
-2.6557332786535000,34,40,190,400,6,210
-2.6559122004628900,76,80,130,200,4,70
-2.6559815181598500,34,40,100,225,6,125
-2.6560380316362100,56,60,200,450,4,250
-2.656104946123700,34,40,110,450,6,340
-2.6561802510889700,92,95,120,450,3,330
-2.656235359100090,38,45,50,150,7,100
-2.656306312300700,28,35,180,275,7,95
-2.656383525236650,22,30,70,225,8,155
-2.6563964277516500,50,55,150,375,5,225
-2.6564036325197200,34,40,140,400,6,260
-2.6565234015947100,60,65,190,225,5,35
-2.65654901161877,92,95,160,500,3,340
-2.6565773088921400,44,50,140,200,6,60
-2.6568731206708600,56,60,150,500,4,350
-2.6571047780641400,56,60,120,225,4,105
-2.6571904609175800,34,40,130,425,6,295
-2.6572762277584900,34,40,50,275,6,225
-2.657327672808500,76,80,120,200,4,80
-2.6573722467350800,86,90,120,300,4,180
-2.6573979414302900,50,55,110,375,5,265
-2.6575664154016800,56,60,50,375,4,325
-2.658125004668730,66,70,60,300,4,240
-2.6581441398595400,56,60,90,475,4,385
-2.658153791794230,56,60,50,425,4,375
-2.658434791193600,34,40,100,250,6,150
-2.6585197290799000,34,40,130,250,6,120
-2.658524236903210,22,30,170,350,8,180
-2.65908732268106,26,35,120,175,9,55
-2.6591727757905900,66,70,200,325,4,125
-2.659183272998080,34,40,80,450,6,370
-2.6592684897124000,92,95,200,450,3,250
-2.659275361368450,32,40,60,150,8,90
-2.659294682735050,66,70,80,225,4,145
-2.65931713627925,86,90,80,200,4,120
-2.659756736762340,86,90,160,225,4,65
-2.6599563382039300,34,40,80,375,6,295
-2.6599680171877600,34,40,150,225,6,75
-2.660059778910060,66,70,140,350,4,210
-2.6600739534133900,50,55,150,300,5,150
-2.6600776344218200,66,70,100,275,4,175
-2.6601676525712100,96,100,100,175,4,75
-2.660379473331660,50,55,150,275,5,125
-2.6609820581702100,34,40,80,500,6,420
-2.661024106683910,34,40,70,250,6,180
-2.6612655154100600,56,60,170,475,4,305
-2.6614482985225900,34,40,200,350,6,150
-2.6614492402006500,50,55,110,225,5,115
-2.6617569586754700,92,95,150,500,3,350
-2.6618587437035200,66,70,100,375,4,275
-2.662003453801540,50,55,160,275,5,115
-2.662038353419280,34,40,140,475,6,335
-2.6621203556196500,52,60,190,200,8,10
-2.6621475513461700,66,70,150,225,4,75
-2.662277190251070,34,40,80,475,6,395
-2.6624413652785000,60,65,120,175,5,55
-2.662480961604170,22,30,200,450,8,250
-2.662486230714310,92,95,90,500,3,410
-2.6625043336183500,34,40,100,400,6,300
-2.6625472407018600,34,40,90,375,6,285
-2.6626218259226900,34,40,150,325,6,175
-2.662865587505850,66,70,140,225,4,85
-2.662969034717690,50,55,110,275,5,165
-2.662988698090080,66,70,70,250,4,180
-2.6630245856409800,56,60,120,500,4,380
-2.663085104000040,28,35,60,200,7,140
-2.663603278441980,50,55,60,275,5,215
-2.6636286187787200,48,55,180,200,7,20
-2.6638737064224400,28,35,50,200,7,150
-2.6638813941675100,22,30,100,500,8,400
-2.66403198724553,50,55,50,325,5,275
-2.664094114926770,36,45,80,125,9,45
-2.6641070342019200,34,40,90,275,6,185
-2.6651708086238500,22,30,80,250,8,170
-2.6654145033545,74,80,160,175,6,15
-2.665481268766170,66,70,70,275,4,205
-2.665534535280440,92,95,100,500,3,400
-2.665582133891170,76,80,140,200,4,60
-2.6656194613374300,32,40,200,250,8,50
-2.6657480256011500,34,40,100,275,6,175
-2.6658413826737700,66,70,90,275,4,185
-2.6659334905732200,66,70,110,250,4,140
-2.6659444312805300,40,45,200,500,5,300
-2.6663013266986200,52,60,60,100,8,40
-2.666342552620230,56,60,160,425,4,265
-2.666480965973220,66,70,190,300,4,110
-2.6664872130491800,34,40,70,425,6,355
-2.666560742072750,34,40,140,375,6,235
-2.66661648422408,34,40,80,275,6,195
-2.666786077839220,34,40,60,300,6,240
-2.6668040165120800,34,40,60,500,6,440
-2.666824569603510,36,45,130,150,9,20
-2.667075493931720,34,40,110,425,6,315
-2.6671398285555000,34,40,200,325,6,125
-2.6671840247989900,32,40,120,175,8,55
-2.667301084649690,56,60,170,375,4,205
-2.667460927784610,56,60,100,450,4,350
-2.667530079887650,92,95,50,375,3,325
-2.667551952997950,34,40,80,425,6,345
-2.6675842876878000,56,60,190,450,4,260
-2.6677025676221600,54,60,110,150,6,40
-2.6679373613023100,34,40,180,325,6,145
-2.6679884808321200,44,50,110,175,6,65
-2.668213579687440,22,30,150,500,8,350
-2.668333279460990,16,25,200,500,9,300
-2.6683442485572500,50,55,60,250,5,190
-2.668379522899680,50,55,70,300,5,230
-2.6684472683031700,66,70,60,450,4,390
-2.6685462800529900,28,35,120,300,7,180
-2.668547891177120,56,60,180,475,4,295
-2.6688123314289100,74,80,90,125,6,35
-2.668844032043120,34,40,180,350,6,170
-2.668924986403800,66,70,70,350,4,280
-2.6689350391388000,34,40,70,350,6,280
-2.669036074775080,22,30,90,475,8,385
-2.669067001478460,60,65,200,250,5,50
-2.6693958259453800,56,60,80,250,4,170
-2.6698013669212900,34,40,160,450,6,290
-2.6698025023081000,22,30,60,375,8,315
-2.6699317952148500,22,30,130,225,8,95
-2.6699691648693600,66,70,110,275,4,165
-2.6700988287565200,66,70,110,350,4,240
-2.670144142009420,28,35,200,275,7,75
-2.6702099136919200,66,70,70,400,4,330
-2.670280096619070,84,90,90,125,6,35
-2.670354910703780,34,40,140,425,6,285
-2.670612682981650,80,85,140,175,5,35
-2.670720755887430,56,60,160,400,4,240
-2.6709999165587700,34,40,160,375,6,215
-2.6710030524438900,66,70,130,350,4,220
-2.671030715286930,56,60,100,425,4,325
-2.6712054830652600,66,70,90,325,4,235
-2.6713386341823800,50,55,140,300,5,160
-2.671637633254820,76,80,60,175,4,115
-2.6718622024687600,34,40,200,375,6,175
-2.672280218899120,50,55,170,250,5,80
-2.6724691590441400,86,90,200,275,4,75
-2.6725178290991300,92,95,90,475,3,385
-2.6726017476349700,80,85,200,225,5,25
-2.672704891639570,56,60,50,400,4,350
-2.6727590226764400,92,95,120,500,3,380
-2.672834211303840,50,55,150,250,5,100
-2.6728527676870100,56,60,160,350,4,190
-2.6730498068257400,34,40,140,225,6,85
-2.673054074491470,66,70,120,275,4,155
-2.673444481831200,90,95,50,100,5,50
-2.6734499714740400,66,70,80,400,4,320
-2.6735753736548200,22,30,170,475,8,305
-2.673753896839230,34,40,60,475,6,415
-2.673895045085740,56,60,50,350,4,300
-2.6739546605451500,50,55,50,225,5,175
-2.674000686822010,56,60,140,500,4,360
-2.6740102397573300,66,70,110,375,4,265
-2.674188610101000,96,100,120,175,4,55
-2.6741918457617400,56,60,130,500,4,370
-2.6742203432795700,58,65,90,125,7,35
-2.674300381279210,22,30,120,225,8,105
-2.674621517346210,50,55,80,325,5,245
-2.6746288436192800,70,75,100,150,5,50
-2.6746439806163000,26,35,190,225,9,35
-2.6747260628034500,50,55,130,275,5,145
-2.674727796436170,100,105,60,125,5,65
-2.674800258632080,38,45,120,175,7,55
-2.6749595401829200,26,35,60,150,9,90
-2.6749931505795400,38,45,60,150,7,90
-2.6750862925400600,28,35,160,200,7,40
-2.675327365253160,16,25,200,475,9,275
-2.675346724620760,66,70,100,350,4,250
-2.675355811320820,66,70,120,375,4,255
-2.6753847076529700,22,30,60,425,8,365
-2.6754346088480300,22,30,100,450,8,350
-2.6757448196683700,64,70,120,150,6,30
-2.675791399944110,56,60,100,475,4,375
-2.6758547313305100,76,85,140,150,9,10
-2.6759210784786700,22,30,190,450,8,260
-2.6760238880395800,56,60,70,500,4,430
-2.676048193364300,66,70,150,375,4,225
-2.676428885210170,22,30,50,450,8,400
-2.6764445084221200,56,60,170,400,4,230
-2.6766788627043300,60,65,60,150,5,90
-2.676714098045980,22,30,170,500,8,330
-2.6767209146532200,22,30,160,425,8,265
-2.676822780178530,44,50,80,175,6,95
-2.6769658241326700,56,60,90,250,4,160
-2.6770435262516300,86,90,190,275,4,85
-2.677085375750940,50,55,60,225,5,165
-2.6773225044973900,22,30,50,500,8,450
-2.6773742238223400,92,95,160,425,3,265
-2.6773828006079600,86,90,170,225,4,55
-2.677485483615650,34,40,100,325,6,225
-2.6775330160043300,22,30,50,400,8,350
-2.6777500427385500,56,60,170,425,4,255
-2.6777516111040400,22,30,120,500,8,380
-2.677952528887290,92,95,180,475,3,295
-2.6780151299135100,92,95,170,350,3,180
-2.6781198093818100,70,75,200,225,5,25
-2.6784454461489300,22,30,170,400,8,230
-2.6786045056778400,66,70,70,325,4,255
-2.6786281590795900,56,60,110,500,4,390
-2.6788185485705000,66,70,160,275,4,115
-2.6788494745251300,56,60,60,425,4,365
-2.6790265348695300,92,95,190,450,3,260
-2.6794460059393000,34,40,190,325,6,135
-2.679446382807530,92,95,160,350,3,190
-2.6794634681795000,92,95,170,400,3,230
-2.67970920522091,92,95,130,500,3,370
-2.6799027744246600,56,60,70,225,4,155
-2.6799055956924200,50,55,70,200,5,130
-2.6799950796008600,94,100,70,100,6,30
-2.6801349630782,66,70,110,225,4,115
-2.680189121842000,66,70,150,300,4,150
-2.6802658157492700,70,75,50,125,5,75
-2.680434605101230,92,95,180,450,3,270
-2.6804377669027300,86,90,110,200,4,90
-2.680488859589040,96,100,200,250,4,50
-2.6805490632070300,96,100,190,225,4,35
-2.680651767704930,34,40,50,300,6,250
-2.680759959847800,56,60,50,450,4,400
-2.680837124243110,92,95,170,475,3,305
-2.6810026612175700,44,50,190,250,6,60
-2.6810767555408900,26,35,200,250,9,50
-2.6811482587970500,34,40,70,325,6,255
-2.681278910743390,34,40,180,300,6,120
-2.681317802634720,96,100,170,200,4,30
-2.6813190546097800,56,60,130,400,4,270
-2.681341215795920,22,30,50,475,8,425
-2.681710639739780,64,70,150,175,6,25
-2.681767409160810,34,40,140,350,6,210
-2.681836310345040,92,95,110,500,3,390
-2.68184536627029,74,80,60,100,6,40
-2.6818642429245000,48,55,60,125,7,65
-2.6822700324754800,28,35,180,225,7,45
-2.6825599992322000,56,60,160,475,4,315
-2.6826212483543700,34,40,100,375,6,275
-2.6826498413086300,36,45,90,125,9,35
-2.6826788829690900,56,60,170,325,4,155
-2.682763409450300,66,70,50,325,4,275
-2.682809375183460,34,40,160,275,6,115
-2.6828402728657400,22,30,170,325,8,155
-2.6828672441073300,22,30,60,325,8,265
-2.683122610887660,32,40,70,150,8,80
-2.6831231016826600,50,55,50,250,5,200
-2.6831774875208500,42,50,150,175,8,25
-2.6833619276235100,66,70,100,300,4,200
-2.6835127074060800,34,40,110,400,6,290
-2.683515448129830,58,65,160,175,7,15
-2.6835641988939400,50,55,80,300,5,220
-2.683579390675000,66,70,110,300,4,190
-2.6836356925835300,100,105,180,200,5,20
-2.6836536508387100,66,70,140,300,4,160
-2.6837423971276200,22,30,160,400,8,240
-2.683861097259760,42,50,120,150,8,30
-2.6840881031562900,34,40,100,350,6,250
-2.6842846111825900,22,30,70,500,8,430
-2.6843362401416500,56,60,130,475,4,345
-2.684521101728360,28,35,90,200,7,110
-2.6845893319745900,28,35,110,200,7,90
-2.6847117666790700,92,95,100,450,3,350
-2.68496814784831,56,60,60,350,4,290
-2.685037133436720,70,75,90,150,5,60
-2.685156083737650,22,30,180,475,8,295
-2.6852153200614600,66,70,50,300,4,250
-2.6852332328387900,56,60,120,475,4,355
-2.685234242389850,22,30,140,500,8,360
-2.685274159672200,92,95,100,475,3,375
-2.6854100627425800,70,75,130,175,5,45
-2.686101102237140,50,55,140,325,5,185
-2.686188318621960,34,40,70,400,6,330
-2.686250960582770,56,60,180,450,4,270
-2.6863433122678900,50,55,160,250,5,90
-2.6863996367242800,34,40,110,225,6,115
-2.68640060330727,92,95,50,400,3,350
-2.686441213091480,66,70,60,275,4,215
-2.686561717931630,92,95,70,225,3,155
-2.686819666550830,50,55,110,325,5,215
-2.6868356516640800,56,60,60,375,4,315
-2.6868896391929300,86,95,140,150,9,10
-2.686954374332470,98,105,70,100,7,30
-2.6869880691905700,56,60,50,500,4,450
-2.6870919591793100,28,35,130,200,7,70
-2.687170046552240,34,40,110,250,6,140
-2.6873433568769800,56,60,110,475,4,365
-2.687358089386580,96,100,60,150,4,90
-2.6873604833326800,76,80,80,175,4,95
-2.68737185056928,34,40,80,400,6,320
-2.6875990154440100,66,70,80,325,4,245
-2.6876184124217400,56,60,130,425,4,295
-2.6876758839263500,34,40,60,450,6,390
-2.6877428532499900,76,80,70,175,4,105
-2.687819940296650,22,30,100,475,8,375
-2.687990326712890,56,60,130,225,4,95
-2.6880132264686800,64,70,60,125,6,65
-2.6880961101167600,36,45,160,175,9,15
-2.6882132426335900,66,70,170,250,4,80
-2.688284022794980,50,55,160,225,5,65
-2.688328495510640,92,95,50,350,3,300
-2.6887100286273600,70,75,140,175,5,35
-2.6888286835253200,86,90,150,200,4,50
-2.6888492542273900,56,60,90,450,4,360
-2.6888868039874200,56,60,130,450,4,320
-2.689156029397970,80,85,110,150,5,40
-2.6892354180780100,22,30,160,350,8,190
-2.6892649577704500,68,75,190,200,7,10
-2.6893033264492500,56,60,70,375,4,305
-2.6893551922825900,22,30,100,425,8,325
-2.6894658971827100,76,80,110,175,4,65
-2.6894866776747300,92,95,140,500,3,360
-2.6895070758242900,22,30,130,500,8,370
-2.689646036242050,34,40,60,225,6,165
-2.690000593372010,34,40,120,350,6,230
-2.690190797467880,22,30,50,275,8,225
-2.6902450014094700,86,90,180,250,4,70
-2.690255284775920,92,95,170,425,3,255
-2.6904045201682700,22,30,170,375,8,205
-2.6906788959178300,90,95,90,125,5,35
-2.6907698248759000,46,55,70,100,9,30
-2.690806906247110,86,90,50,175,4,125
-2.690941197264830,28,35,50,175,7,125
-2.6914540812180900,22,30,60,350,8,290
-2.691456938603070,16,25,190,500,9,310
-2.691510359624160,66,70,60,225,4,165
-2.6916718856277200,66,70,50,225,4,175
-2.6917152339464400,54,60,180,200,6,20
-2.6917734028913400,34,40,100,300,6,200
-2.6918205751633600,56,60,90,400,4,310
-2.6918572131593000,56,60,50,475,4,425
-2.691887328519980,92,95,50,425,3,375
-2.691890005830320,34,40,90,325,6,235
-2.6919465464255200,34,40,120,375,6,255
-2.692090083255490,16,25,50,375,9,325
-2.692378850685570,56,60,70,475,4,405
-2.6924225641086100,66,75,80,100,9,20
-2.6924827548550300,60,65,70,150,5,80
-2.692525175369080,56,60,120,425,4,305
-2.6925315076007400,34,40,50,250,6,200
-2.692586994563510,28,35,180,250,7,70
-2.692836643690740,92,95,140,450,3,310
-2.692978625818250,86,90,60,200,4,140
-2.6930709576040800,22,30,170,425,8,255
-2.6931033593229500,56,60,140,400,4,260
-2.6931283929343300,74,80,130,150,6,20
-2.693149134803100,40,45,190,500,5,310
-2.6931524041208500,48,55,150,175,7,25
-2.6933030261163900,56,60,180,425,4,245
-2.6934076644440800,52,60,100,125,8,25
-2.6935680000811200,66,70,60,250,4,190
-2.69357221758488,92,95,170,375,3,205
-2.6935736046836000,92,95,160,325,3,165
-2.6935805447050300,66,70,70,300,4,230
-2.693724648565700,22,30,160,325,8,165
-2.6937593349571800,86,90,90,200,4,110
-2.6937616568696800,34,40,190,300,6,110
-2.6942641970495200,66,70,70,200,4,130
-2.6944957784515200,42,50,70,125,8,55
-2.694572341227820,66,70,150,275,4,125
-2.6945797426941000,22,30,130,400,8,270
-2.694583531164370,50,55,130,300,5,170
-2.694798616854700,56,60,140,450,4,310
-2.694817319914240,22,30,130,450,8,320
-2.6948531110690800,92,95,70,500,3,430
-2.694901044322160,56,60,200,300,4,100
-2.6951225849584800,92,95,130,475,3,345
-2.695294241560900,92,95,130,450,3,320
-2.695526817065520,56,60,150,450,4,300
-2.6955637808034500,22,30,110,475,8,365
-2.6958159152861100,22,30,110,500,8,390
-2.6959123708831700,92,95,50,475,3,425
-2.6960197680717500,50,55,120,325,5,205
-2.6960327602501300,34,40,120,275,6,155
-2.696097849735920,56,60,170,450,4,280
-2.696151974298570,66,70,120,325,4,205
-2.696224299596160,34,40,50,325,6,275
-2.6962340616711300,22,30,120,475,8,355
-2.696324055378340,34,40,110,350,6,240
-2.6963733460442400,56,60,160,325,4,165
-2.696519847885850,34,40,130,350,6,220
-2.696586374517760,92,95,120,475,3,355
-2.69691079265771,40,45,200,475,5,275
-2.697013932908690,48,55,70,125,7,55
-2.697025141623960,86,90,100,200,4,100
-2.6973118474010400,92,95,160,475,3,315
-2.6975183396155400,56,60,60,400,4,340
-2.6975975000936800,86,90,50,200,4,150
-2.69794861189727,68,75,100,125,7,25
-2.6980201451548300,56,60,90,350,4,260
-2.698053315761450,56,60,60,325,4,265
-2.6982051590160200,50,55,130,325,5,195
-2.6982067815410000,16,25,190,475,9,285
-2.6982783355815100,28,35,190,275,7,85
-2.6986125573865500,92,95,200,425,3,225
-2.698713592959290,56,60,140,425,4,285
-2.698732067581150,92,95,150,400,3,250
-2.698831012393720,40,45,190,475,5,285
-2.6990923118248500,56,60,80,475,4,395
-2.6992217523411000,92,95,60,375,3,315
-2.699338894211420,92,95,170,325,3,155
-2.6993569252131400,92,95,80,500,3,420
-2.6995979961341000,66,70,50,250,4,200
-2.6995982378403800,22,30,90,450,8,360
-2.6996534414362400,34,40,70,300,6,230
-2.699960915292960,92,95,60,350,3,290
-2.7000001411443900,92,95,50,500,3,450
-2.7000014874807700,92,95,130,400,3,270
-2.7000065503803900,34,40,150,300,6,150
-2.7000659345724400,22,30,160,475,8,315
-2.7000955282734600,22,30,90,400,8,310
-2.7001153686181200,56,60,200,400,4,200
-2.700338000673310,92,95,60,425,3,365
-2.700357312709800,50,55,170,275,5,105
-2.700360503288820,56,60,120,400,4,280
-2.700394331522840,56,60,150,400,4,250
-2.700689056350790,56,60,200,425,4,225
-2.7007187245784000,92,95,100,425,3,325
-2.700727160223800,22,30,60,300,8,240
-2.7007830442052200,56,60,180,375,4,195
-2.701011384220560,44,50,90,175,6,85
-2.7010526409562000,22,30,90,225,8,135
-2.701176267869350,28,35,100,200,7,100
-2.7012853784119100,16,25,50,350,9,300
-2.7015172482999000,92,95,110,475,3,365
-2.7016481169079600,92,95,80,250,3,170
-2.7016907471727400,34,40,110,375,6,265
-2.70186176170492,22,30,60,400,8,340
-2.701936377524900,66,70,140,325,4,185
-2.7021254984016600,34,40,150,375,6,225
-2.7023112581390000,44,50,170,200,6,30
-2.7023310693921800,76,80,190,250,4,60
-2.7023324098685800,34,40,60,275,6,215
-2.7023906152776400,84,90,160,175,6,15
-2.702622942703010,92,95,180,375,3,195
-2.702684586782800,92,95,50,450,3,400
-2.7028333225913500,56,65,80,100,9,20
-2.7029906703279300,92,95,180,425,3,245
-2.7030429843166000,34,40,140,300,6,160
-2.70308393887455,42,50,60,125,8,65
-2.703086765281600,40,45,180,500,5,320
-2.703109665521260,56,60,130,250,4,120
-2.7031589126647300,92,95,140,400,3,260
-2.703438375924680,100,105,70,125,5,55
-2.7034696550126200,66,75,110,125,9,15
-2.7035399356130600,34,40,50,225,6,175
-2.7036812189078800,92,95,60,400,3,340
-2.703681628719830,92,95,150,450,3,300
-2.7039943759576300,34,40,110,275,6,165
-2.704241675370150,92,95,130,225,3,95
-2.70424843137841,92,95,170,450,3,280
-2.7043778485518400,92,95,150,475,3,325
-2.7044423031130100,34,40,60,250,6,190
-2.7044522481437400,56,60,80,500,4,420
-2.704644815914100,22,30,70,475,8,405
-2.7046669823854900,56,60,100,250,4,150
-2.7047319516790600,64,70,70,125,6,55
-2.705106739135320,92,95,160,400,3,240
-2.7051814244751900,56,60,110,450,4,340
-2.705454634875990,22,30,200,300,8,100
-2.7054891445618000,56,60,100,400,4,300
-2.7055260870388100,56,60,130,375,4,245
-2.7055992630243700,66,70,80,300,4,220
-2.705731677948000,92,95,80,475,3,395
-2.705770746320200,66,70,150,250,4,100
-2.7060156507453100,48,55,120,150,7,30
-2.7061728434261100,22,30,170,450,8,280
-2.7063334394450400,56,60,50,275,4,225
-2.706404776212950,22,30,180,450,8,270
-2.7064162698765400,66,70,130,325,4,195
-2.7066334483765300,34,40,70,200,6,130
-2.707121513025960,66,70,160,250,4,90
-2.707154095320500,92,95,200,400,3,200
-2.707166476356660,56,60,150,475,4,325
-2.7073083082193200,22,30,100,225,8,125
-2.7073549569073300,56,60,110,425,4,315
-2.707359191159540,22,30,90,350,8,260
-2.707382008214560,34,40,110,300,6,190
-2.7075001045775400,90,95,130,150,5,20
-2.707574471287940,56,60,100,225,4,125
-2.707605994380700,86,90,120,200,4,80
-2.7076685989355700,22,30,70,375,8,305
-2.7078611383299100,56,60,160,300,4,140
-2.7079624429723300,22,30,130,250,8,120
-2.708025700971140,28,35,120,200,7,80
-2.7081791150952400,22,30,120,400,8,280
-2.708183712359270,22,30,130,475,8,345
-2.708189745355360,38,45,70,150,7,80
-2.708224975755700,16,25,50,400,9,350
-2.7082263566194200,56,60,150,350,4,200
-2.7082972605974000,22,30,140,250,8,110
-2.708299537392670,16,25,180,500,9,320
-2.7083585216158900,56,60,90,225,4,135
-2.7083764365553400,34,40,150,275,6,125
-2.7086196786635900,22,30,90,300,8,210
-2.7086899241326500,56,60,180,400,4,220
-2.70870922297928,66,70,110,325,4,215
-2.7087556183501300,34,40,80,300,6,220
-2.708792345360600,96,100,70,150,4,80
-2.7088224763581600,92,95,90,250,3,160
-2.708864119188810,92,95,120,400,3,280
-2.7090264482628300,22,30,140,275,8,135
-2.7092208929386000,22,30,200,400,8,200
-2.709299444650890,90,95,160,175,5,15
-2.7094901315552000,56,65,110,125,9,15
-2.7096442733970100,92,95,90,450,3,360
-2.709731703426550,26,35,70,150,9,80
-2.710312342976100,22,30,110,450,8,340
-2.7103482932131800,56,60,190,425,4,235
-2.710500856637930,56,60,140,250,4,110
-2.71054446485893,92,95,150,425,3,275
-2.7105860140597600,16,25,120,450,9,330
-2.710656608801410,66,70,130,275,4,145
-2.7108523389240000,56,60,80,450,4,370
-2.711131267631660,92,95,90,400,3,310
-2.7113069848041100,76,80,90,175,4,85
-2.7113521132117900,92,95,70,475,3,405
-2.711435407186800,92,95,150,350,3,200
-2.7115589610779400,22,30,180,425,8,245
-2.7115835432265400,92,95,120,425,3,305
-2.7121146864285400,92,95,170,300,3,130
-2.7121949923211800,22,30,150,225,8,75
-2.712228959765830,92,95,110,450,3,340
-2.71247322772553,92,95,130,425,3,295
-2.712863769881900,50,55,80,200,5,120
-2.7130440421971100,16,25,160,500,9,340
-2.713224337225180,92,95,190,425,3,235
-2.713279230070940,22,30,130,425,8,295
-2.713291850683800,56,60,170,300,4,130
-2.713300952555740,22,30,140,400,8,260
-2.7135768106503800,56,60,200,350,4,150
-2.7135971755946400,66,70,130,300,4,170
-2.713635912797490,44,50,100,175,6,75
-2.7137292812600200,92,95,70,375,3,305
-2.713819851205170,22,30,150,450,8,300
-2.7141074257111000,22,30,150,400,8,250
-2.714112782854020,92,95,50,275,3,225
-2.7141366750250100,84,90,130,150,6,20
-2.71414765118991,92,95,190,350,3,160
-2.714153376949830,100,105,150,175,5,25
-2.714246731768820,56,60,70,425,4,355
-2.7142790429464300,92,95,60,325,3,265
-2.714698590275590,22,30,150,350,8,200
-2.714883568666500,56,60,150,425,4,275
-2.714922555843870,66,70,160,225,4,65
-2.7149847296965000,16,25,70,225,9,155
-2.714988563894140,56,60,140,275,4,135
-2.715332368280030,22,30,140,450,8,310
-2.715376344829750,56,60,70,450,4,380
-2.715475114561520,56,60,80,225,4,145
-2.7155990029146800,34,40,80,325,6,245
-2.71561171328393,16,25,170,350,9,180
-2.7156140006066900,40,45,160,500,5,340
-2.7156459748037100,60,65,80,150,5,70
-2.715715605637520,92,95,180,400,3,220
-2.7157500876105300,22,30,190,400,8,210
-2.7160072025010200,34,40,150,250,6,100
-2.716285115292300,76,80,170,200,4,30
-2.716306441386830,22,30,80,225,8,145
-2.7163075530733300,92,95,70,450,3,380
-2.7165020717808600,92,95,120,225,3,105
-2.7167280833463400,22,30,190,325,8,135
-2.7168567255624900,22,30,140,425,8,285
-2.7168574598064000,66,70,170,275,4,105
-2.7171719682382300,56,60,180,325,4,145
-2.717291031080800,56,60,190,350,4,160
-2.7173418677942400,54,60,60,125,6,65
-2.7173969009971000,34,40,160,225,6,65
-2.7174906583387800,22,30,140,225,8,85
-2.717533616935640,22,30,160,300,8,140
-2.7175670942629100,44,50,190,225,6,35
-2.717580209964570,40,45,120,450,5,330
-2.7177140093064800,56,60,190,400,4,210
-2.7178126418273700,22,30,70,450,8,380
-2.717888302893550,22,30,170,300,8,130
-2.7179229323106500,16,25,200,450,9,250
-2.7179363741000600,16,25,50,425,9,375
-2.7182124201049100,56,60,60,300,4,240
-2.718370568703230,56,60,90,375,4,285
-2.7184630360228600,82,90,110,125,8,15
-2.718630302695900,92,95,190,375,3,185
-2.7186337057352500,22,30,80,475,8,395
-2.7186956888501000,16,25,90,500,9,410
-2.718806268076910,56,60,80,350,4,270
-2.7189388387953600,84,90,60,100,6,40
-2.7190839838920300,56,60,90,425,4,335
-2.7192243333074500,22,30,180,375,8,195
-2.7193120429635400,56,60,180,350,4,170
-2.7193541135021200,86,90,180,225,4,45
-2.719426156703330,56,60,160,450,4,290
-2.7194700841378100,92,95,160,300,3,140
-2.719511835698340,56,60,190,375,4,185
-2.719524473120350,22,30,130,375,8,245
-2.71963374963248,16,25,90,475,9,385
-2.7196380892257500,56,60,140,475,4,335
-2.7196774608645400,22,30,120,425,8,305
-2.719729339132450,44,50,120,175,6,55
-2.7197754429551700,76,80,100,175,4,75
-2.7198311654908400,56,60,150,325,4,175
-2.719965248931390,92,95,80,375,3,295
-2.719972457936170,44,50,50,150,6,100
-2.720013361354440,16,25,120,225,9,105
-2.7201823183767500,16,25,80,250,9,170
-2.7203713647674600,92,95,190,400,3,210
-2.7205124488140900,16,25,100,500,9,400
-2.720520306461040,86,90,160,200,4,40
-2.720615593386210,64,70,50,100,6,50
-2.720775879426450,38,45,80,150,7,70
-2.721064582000530,50,55,120,300,5,180
-2.721235508007530,22,30,200,425,8,225
-2.7212937453701600,28,35,60,175,7,115
-2.7213383845817200,16,25,60,350,9,290
-2.721385541851130,22,30,100,250,8,150
-2.721541682002210,22,30,70,425,8,355
-2.721558003309260,100,105,120,150,5,30
-2.721591532807190,80,85,60,125,5,65
-2.721619019185580,34,40,120,325,6,205
-2.7217186186313400,92,95,150,325,3,175
-2.721761675457830,92,95,130,375,3,245
-2.7217636546089900,34,40,110,325,6,215
-2.721803385631330,50,55,60,200,5,140
-2.7218744013959200,92,95,90,350,3,260
-2.7221305785562100,40,45,90,500,5,410
-2.72217008118452,22,30,70,250,8,180
-2.722182514950140,76,80,50,150,4,100
-2.722213515672500,56,60,70,275,4,205
-2.7224113171046200,22,30,150,475,8,325
-2.7225232559295400,92,95,160,450,3,290
-2.7225342044676900,22,30,120,250,8,130
-2.7225420782167500,56,60,140,375,4,235
-2.722606265774080,22,30,190,350,8,160
-2.722637618296320,22,30,80,450,8,370
-2.722859770094540,36,45,60,100,9,40
-2.722937225323080,86,90,60,175,4,115
-2.723066547470880,28,35,70,175,7,105
-2.723095797257580,86,90,130,200,4,70
-2.7232659035440300,56,60,140,225,4,85
-2.723294442030890,34,40,170,250,6,80
-2.7233195834211700,56,60,160,375,4,215
-2.723373042569730,40,45,100,500,5,400
-2.7233741943868500,56,60,150,225,4,75
-2.7237119502343700,92,95,200,300,3,100
-2.723895757912430,22,30,80,350,8,270
-2.723942418785400,22,30,110,425,8,315
-2.724036474271620,56,60,80,375,4,295
-2.724190095284610,80,85,180,200,5,20
-2.7243868013822700,56,60,90,300,4,210
-2.7244058301778600,40,45,200,450,5,250
-2.7245437142183700,56,60,80,275,4,195
-2.72467346799388,92,95,100,225,3,125
-2.724700313591870,16,25,90,250,9,160
-2.72470775954241,22,30,80,275,8,195
-2.724869213840280,50,55,170,225,5,55
-2.7248695864859000,56,60,90,275,4,185
-2.7248929907899500,56,60,120,250,4,130
-2.725427135315030,82,85,200,500,3,300
-2.7254517059970600,34,40,130,275,6,145
-2.7254566136700000,70,75,110,150,5,40
-2.725532680205060,34,40,160,250,6,90
-2.7255479224841300,22,30,70,275,8,205
-2.7255694723730300,56,60,110,400,4,290
-2.725757598466340,22,30,150,425,8,275
-2.7257964050230200,50,55,200,275,5,75
-2.7258566684060500,22,30,180,400,8,220
-2.7258821508238600,56,60,140,350,4,210
-2.7262817943127400,92,95,100,400,3,300
-2.726296279850800,56,60,80,400,4,320
-2.7264983853772700,56,60,80,425,4,345
-2.7265642190667800,26,35,80,150,9,70
-2.7265922415216500,22,30,180,350,8,170
-2.7267015410934900,92,95,80,450,3,370
-2.7267197672158200,34,40,130,300,6,170
-2.726745826904720,56,60,60,500,4,440
-2.7267521793984200,66,70,80,200,4,120
-2.7269158336336000,92,95,140,275,3,135
-2.726919322662670,40,45,170,500,5,330
-2.726933542953990,40,45,150,500,5,350
-2.727076611581800,40,45,120,500,5,380
-2.7270969586880500,22,30,100,400,8,300
-2.727175628322530,72,80,80,100,8,20
-2.727234945778180,22,30,80,500,8,420
-2.727239634023410,96,100,80,150,4,70
-2.7272915506347900,56,60,200,375,4,175
-2.727589450069860,92,95,160,375,3,215
-2.7276031538124900,56,60,60,475,4,415
-2.7277229323492000,28,35,140,200,7,60
-2.7277730863055300,50,55,180,250,5,70
-2.7277868865168900,56,60,70,250,4,180
-2.728012413242970,50,55,150,200,5,50
-2.728302801967410,50,55,110,200,5,90
-2.7283292554736000,92,95,140,375,3,235
-2.728342714091550,56,60,200,325,4,125
-2.7285512764912000,22,30,180,325,8,145
-2.728774086061100,56,60,110,250,4,140
-2.728878920822860,62,70,110,125,8,15
-2.7290160863116600,16,25,50,450,9,400
-2.7290414823557700,92,95,140,425,3,285
-2.729127157064260,22,30,90,375,8,285
-2.7293069341885900,92,95,140,475,3,335
-2.72936079055401,40,45,170,475,5,305
-2.729471458002030,92,95,60,475,3,415
-2.7294978998520500,92,95,200,350,3,150
-2.7296850600863600,92,95,90,425,3,335
-2.729823470052170,22,30,150,325,8,175
-2.729960128569190,92,95,130,250,3,120
-2.7299887090472900,40,45,100,475,5,375
-2.7300163926978900,22,30,200,350,8,150
-2.730053225825980,50,55,180,275,5,95
-2.730219404528080,92,95,180,350,3,170
-2.7302822310352400,56,60,180,300,4,120
-2.730443312055680,40,45,50,400,5,350
-2.7304741107745200,40,45,90,475,5,385
-2.7304945952026100,92,95,70,425,3,355
-2.730558499524260,92,95,140,250,3,110
-2.730849426350740,56,60,100,325,4,225
-2.7309012018658200,16,25,50,500,9,450
-2.73104974519143,16,25,100,450,9,350
-2.7310861227302900,60,65,100,150,5,50
-2.7311816731167800,22,30,160,375,8,215
-2.7311892986809800,86,90,140,200,4,60
-2.7314776762645100,92,95,110,425,3,315
-2.731778488612150,92,95,100,250,3,150
-2.731835128734520,22,30,190,425,8,235
-2.7318593302351100,22,30,80,375,8,295
-2.7319915952434900,40,45,100,450,5,350
-2.7321111228004500,92,95,200,375,3,175
-2.732293432646670,16,25,150,500,9,350
-2.7324691652986200,54,60,120,150,6,30
-2.7324717522862500,66,70,200,275,4,75
-2.732492514163940,56,60,190,325,4,135
-2.7325617147043100,66,70,180,275,4,95
-2.7327648344892,32,40,80,150,8,70
-2.7330539891460600,92,95,60,500,3,440
-2.7330681281244200,22,30,60,225,8,165
-2.73353967563519,92,95,180,325,3,145
-2.7339159277107800,56,60,110,350,4,240
-2.734010561631500,56,60,70,350,4,280
-2.734034253716930,92,95,70,350,3,280
-2.7342787605739200,32,40,100,150,8,50
-2.734302289218180,92,95,90,225,3,135
-2.734729935693030,16,25,130,225,9,95
-2.735070935116850,22,30,100,325,8,225
-2.735095550991350,22,30,140,475,8,335
-2.735183225818410,22,30,190,375,8,185
-2.7354036412166900,56,60,100,275,4,175
-2.7355882714800500,40,45,50,375,5,325
-2.735602839027120,92,95,120,350,3,230
-2.735604057204090,92,95,80,225,3,145
-2.735748652679490,92,95,70,250,3,180
-2.7359257147455200,34,40,140,325,6,185
-2.7359852717210600,56,60,50,300,4,250
-2.7362485448143300,22,30,90,275,8,185
-2.736811442120310,22,30,90,425,8,335
-2.737149835158900,58,65,190,200,7,10
-2.737211216093130,100,105,90,125,5,35
-2.7375897400534100,40,45,170,350,5,180
-2.7376020017545900,58,65,60,100,7,40
-2.7376572383892200,66,70,120,300,4,180
-2.737739964051150,22,30,60,500,8,440
-2.7377542323381000,56,60,120,350,4,230
-2.7377751196963500,22,30,110,250,8,140
-2.7378357047505100,66,70,170,225,4,55
-2.737862795996480,16,25,170,400,9,230
-2.7378912725731200,28,35,80,175,7,95
-2.7381094078077900,92,95,140,350,3,210
-2.738187561737040,22,30,200,325,8,125
-2.738394280288210,66,70,150,200,4,50
-2.73848373089547,74,80,190,200,6,10
-2.738740354323340,16,25,50,275,9,225
-2.7387789214126000,92,95,90,275,3,185
-2.738819409607540,22,30,100,275,8,175
-2.738887375157120,92,95,60,450,3,390
-2.738939010171820,92,95,80,275,3,195
-2.739150564623350,40,45,170,400,5,230
-2.739267141622380,92,95,80,350,3,270
-2.739299440542160,88,95,110,125,7,15
-2.739472487074170,16,25,60,325,9,265
-2.7394868613947000,22,30,140,375,8,235
-2.739572731738000,92,95,90,375,3,285
-2.739610631093320,72,80,110,125,8,15
-2.7396222551114100,16,25,170,500,9,330
-2.739632968470090,22,30,50,225,8,175
-2.7396481708073000,52,60,70,100,8,30
-2.7398879905119800,56,60,190,300,4,110
-2.740225727073920,86,90,190,250,4,60
-2.7403638631273200,54,60,70,125,6,55
-2.7405313039211300,16,25,180,475,9,295
-2.7406363863612800,16,25,170,325,9,155
-2.7406374260321500,16,25,70,500,9,430
-2.7407341737772700,50,55,190,275,5,85
-2.7408857457124500,100,105,80,125,5,45
-2.740930074181950,32,40,50,125,8,75
-2.740956010396460,92,95,60,300,3,240
-2.7409843912124600,60,65,90,150,5,60
-2.7410629355347800,56,60,100,375,4,275
-2.7410716155562800,22,30,160,450,8,290
-2.741274364336300,56,60,120,375,4,255
-2.7416878540821100,56,60,140,300,4,160
-2.741829114588140,92,95,80,425,3,345
-2.741894870015080,56,60,160,275,4,115
-2.742101025403510,62,70,80,100,8,20
-2.7421696451512200,40,45,160,475,5,315
-2.7426579211981600,40,45,180,475,5,295
-2.7429601788143100,16,25,160,350,9,190
-2.7430253984491600,22,30,60,475,8,415
-2.7431629006441600,22,30,70,350,8,280
-2.7431958050358500,22,30,50,250,8,200
-2.7432387027781400,22,30,50,300,8,250
-2.7432894774784000,16,25,100,475,9,375
-2.74336900274976,92,95,70,275,3,205
-2.743557388230970,34,40,130,325,6,195
-2.7437410479067300,32,40,200,225,8,25
-2.7440534273766800,92,95,150,225,3,75
-2.7442006684985200,16,25,160,425,9,265
-2.744242936416340,92,95,200,325,3,125
-2.744260936240500,22,30,70,200,8,130
-2.74445039043294,34,40,150,200,6,50
-2.7445384909108600,40,45,110,500,5,390
-2.7447203151710200,16,25,170,475,9,305
-2.7448049687018000,22,30,180,300,8,120
-2.7448276482743100,76,85,90,100,9,10
-2.744910874738870,22,30,80,400,8,320
-2.7452691131992300,22,30,80,425,8,345
-2.7453981296987800,16,25,120,500,9,380
-2.7455207064486700,70,75,180,200,5,20
-2.745787388892190,22,30,100,300,8,200
-2.7461138392400100,92,95,80,400,3,320
-2.74616888474468,60,65,50,125,5,75
-2.746262261414320,22,30,90,325,8,235
-2.746475485489210,54,60,150,175,6,25
-2.746702545491980,22,30,110,400,8,290
-2.746722160406310,22,30,100,375,8,275
-2.7467271486975400,44,50,200,250,6,50
-2.7468194149508700,76,80,190,225,4,35
-2.7469284525549400,92,95,120,250,3,130
-2.746953655289690,56,60,60,450,4,390
-2.747043232546910,56,60,150,375,4,225
-2.7471202431715500,16,25,170,425,9,255
-2.7472772535114800,56,60,110,375,4,265
-2.747396673692100,28,35,110,175,7,65
-2.7476327224655000,92,95,180,300,3,120
-2.747713227679040,40,45,50,425,5,375
-2.7477658906937200,92,95,160,275,3,115
-2.7479415376151100,40,45,130,500,5,370
-2.7479429172069100,92,95,100,275,3,175
-2.748074750126140,82,85,190,500,3,310
-2.748093990826560,92,95,190,325,3,135
-2.748128128594710,40,45,50,350,5,300
-2.7481897381889400,40,45,70,500,5,430
-2.7483363012651400,16,25,60,375,9,315
-2.7483420082173500,40,45,60,375,5,315
-2.7483788234354600,22,30,140,350,8,210
-2.7483813901427600,50,55,180,225,5,45
-2.748599017286570,16,25,60,425,9,365
-2.748675502172960,92,95,150,300,3,150
-2.7486825805756700,22,30,50,325,8,275
-2.748750287125260,40,45,160,425,5,265
-2.748986111712020,96,105,90,100,9,10
-2.7490279250379700,92,95,90,300,3,210
-2.7490802040466800,66,70,180,225,4,45
-2.74918189898172,22,30,120,350,8,230
-2.7493740574005800,92,95,110,400,3,290
-2.7494791189249500,92,95,140,225,3,85
-2.749645791110350,40,45,190,450,5,260
-2.749693184587660,40,45,170,425,5,255
-2.7497676189028100,60,65,140,175,5,35
-2.749805553615990,40,45,140,500,5,360
-2.7498753121135900,86,90,70,175,4,105
-2.7500885595089500,92,95,110,350,3,240
-2.7501467615063400,32,40,90,150,8,60
-2.750271280209110,22,30,70,325,8,255
-2.750331590152150,60,65,130,175,5,45
-2.750363579049710,22,30,110,225,8,115
-2.750421712628630,56,60,110,225,4,115
-2.7504405938036500,56,60,100,350,4,250
-2.75053533725692,16,25,170,375,9,205
-2.7506770218003800,56,60,50,225,4,175
-2.7506943449384500,22,30,60,250,8,190
-2.7508217748628500,42,50,50,100,8,50
-2.7508477387697400,40,45,130,450,5,320
-2.75111680072485,56,60,60,225,4,165
-2.7511623818950400,40,45,90,250,5,160
-2.7513749069939200,74,80,100,125,6,25
-2.75151480470211,80,85,150,175,5,25
-2.7516012487952900,38,45,130,175,7,45
-2.7516223151308700,92,95,50,300,3,250
-2.7516931555155200,40,45,50,450,5,400
-2.751752056425370,56,60,70,400,4,330
-2.7517707805662100,40,45,170,325,5,155
-2.7519593670013400,26,35,100,150,9,50
-2.7521541778564300,38,45,200,225,7,25
-2.752288138005520,76,80,200,250,4,50
-2.7523513431067800,68,75,70,100,7,30
-2.752378505838010,38,45,90,150,7,60
-2.7524172681154100,26,35,200,225,9,25
-2.7527257350940000,34,40,170,275,6,105
-2.752996966935270,60,65,200,225,5,25
-2.7531005989142300,92,95,130,350,3,220
-2.753195982596750,56,60,120,275,4,155
-2.753265671492660,22,30,200,375,8,175
-2.753267122943090,50,55,90,200,5,110
-2.7533490438732300,92,95,70,400,3,330
-2.7533843647327200,36,45,190,200,9,10
-2.7535676172347400,40,45,170,375,5,205
-2.7536481112799900,76,80,120,175,4,55
-2.753724176704630,56,60,100,300,4,200
-2.753866136008270,66,70,180,250,4,70
-2.753869031075480,38,45,100,150,7,50
-2.7541104067247700,50,55,50,200,5,150
-2.7543020545153000,22,30,120,275,8,155
-2.754360477575300,16,25,130,250,9,120
-2.7545014212818200,92,95,120,275,3,155
-2.754570851106410,92,95,190,300,3,110
-2.754641869106770,50,55,100,200,5,100
-2.7549153704927800,92,95,90,325,3,235
-2.7549265663625400,16,25,160,300,9,140
-2.755105176725920,16,25,190,450,9,260
-2.7552023893727400,56,60,60,250,4,190
-2.755279555044020,44,50,60,150,6,90
-2.755525476743020,56,60,90,325,4,235
-2.755585501381350,92,95,60,250,3,190
-2.7557420704631400,92,95,100,350,3,250
-2.755759305780830,40,45,60,425,5,365
-2.7558967234913300,16,25,160,400,9,240
-2.755998707351850,92,95,110,250,3,140
-2.756040016542960,40,45,50,500,5,450
-2.756047215172710,86,90,80,175,4,95
-2.7561404005453500,84,90,100,125,6,25
-2.7561787595587500,90,95,60,100,5,40
-2.756228494092080,92,100,140,150,8,10
-2.756405795320800,34,40,180,275,6,95
-2.756612569314530,16,25,90,225,9,135
-2.7566303288662400,56,60,130,350,4,220
-2.756631751881940,92,95,150,375,3,225
-2.7566786984626400,22,30,60,450,8,390
-2.756694216610650,56,60,50,250,4,200
-2.756747184962660,16,25,100,425,9,325
-2.756826169964010,34,40,80,200,6,120
-2.756897661766010,56,60,110,275,4,165
-2.7571457088605000,16,25,140,500,9,360
-2.7572393431772600,40,45,120,475,5,355
-2.7572528404544200,80,85,70,125,5,55
-2.7575476741543700,40,45,160,350,5,190
-2.7577629104322400,56,60,110,300,4,190
-2.7578026779718500,16,25,50,475,9,425
-2.757853809881940,56,60,70,200,4,130
-2.7579664054357800,82,85,160,500,3,340
-2.758034401712330,16,25,110,500,9,390
-2.7580867041462900,76,80,60,150,4,90
-2.758098085056860,80,85,120,150,5,30
-2.7582235794137400,56,60,70,325,4,255
-2.758292289973380,92,95,100,375,3,275
-2.758342836620070,40,45,70,225,5,155
-2.7585520521417200,86,90,110,175,4,65
-2.7585685627257700,56,60,150,300,4,150
-2.758731396445490,16,25,160,325,9,165
-2.7587933815923100,32,40,130,175,8,45
-2.758854264124720,22,30,150,300,8,150
-2.7589615689478800,40,45,100,425,5,325
-2.759005564857230,40,45,160,400,5,240
-2.759012829821280,56,60,50,325,4,275
-2.7590388079539900,56,60,80,325,4,245
-2.7590634314580700,92,95,100,325,3,225
-2.7590909016481500,82,85,200,475,3,275
-2.7591199268066700,22,30,110,350,8,240
-2.7594528688222900,50,55,50,175,5,125
-2.759456075018240,66,70,50,200,4,150
-2.759625148094170,48,55,80,125,7,45
-2.7598458827296700,40,45,200,400,5,200
-2.759977759013780,22,30,70,400,8,330
-2.760054873757980,16,25,90,400,9,310
-2.7602352240589200,38,45,50,125,7,75
-2.760562096925700,26,35,50,125,9,75
-2.760566927901860,92,95,120,375,3,255
-2.760791099061880,56,60,150,250,4,100
-2.7610559275288200,82,85,180,500,3,320
-2.761124924482290,40,45,180,425,5,245
-2.7612043357262900,50,55,120,200,5,80
-2.76137790734195,92,95,50,225,3,175
-2.761403799943880,40,45,80,250,5,170
-2.761408736569590,16,25,130,500,9,370
-2.76155342941399,40,45,120,225,5,105
-2.7617711163658400,40,45,60,325,5,265
-2.7620834681110800,58,65,100,125,7,25
-2.7621010984694500,82,85,190,475,3,285
-2.762180140566550,40,45,90,400,5,310
-2.762470598420970,96,100,100,150,4,50
-2.762706664381320,16,25,90,350,9,260
-2.762766633944810,40,45,50,475,5,425
-2.7628352289005700,56,60,70,300,4,230
-2.7629693851111400,40,45,90,450,5,360
-2.763114375870510,40,45,110,475,5,365
-2.763177987990320,92,95,110,275,3,165
-2.7633197908899300,66,70,90,200,4,110
-2.763504515182690,16,25,130,450,9,320
-2.763529668020360,40,45,160,325,5,165
-2.7636025957154600,28,35,190,250,7,60
-2.7636426628319900,16,25,200,300,9,100
-2.7636438341061000,66,70,160,200,4,40
-2.763703509638220,40,45,200,300,5,100
-2.7637290540870000,22,30,190,300,8,110
-2.763758607515760,40,45,180,450,5,270
-2.763849737949510,100,105,50,100,5,50
-2.764110897615830,64,70,80,125,6,45
-2.764159930645280,22,30,100,350,8,250
-2.764374727012030,40,45,120,400,5,280
-2.7644219704154500,40,45,180,400,5,220
-2.7649317410663800,34,40,170,225,6,55
-2.7649358179079200,42,50,80,125,8,45
-2.764939367925090,16,25,130,400,9,270
-2.7651786704636600,56,60,170,250,4,80
-2.7652785131771500,48,55,50,100,7,50
-2.7653845239848600,22,30,80,325,8,245
-2.7654442703218700,22,30,120,375,8,255
-2.765492448430700,92,95,70,325,3,255
-2.76551344569384,16,25,80,275,9,195
-2.7656311314752300,50,55,60,175,5,115
-2.7656509767886600,28,35,90,175,7,85
-2.7658131753724200,22,30,170,250,8,80
-2.7659483289874800,40,45,130,475,5,345
-2.7660680416379500,32,40,140,175,8,35
-2.7660839767225800,90,95,190,200,5,10
-2.766182559292270,92,95,140,300,3,160
-2.766220808474150,34,40,200,275,6,75
-2.7663586178222900,66,70,110,200,4,90
-2.7663660629688400,22,30,70,300,8,230
-2.766505066334500,16,25,70,375,9,305
-2.7665966166787300,40,45,130,225,5,95
-2.7666325379735000,40,45,60,350,5,290
-2.766778444760750,56,60,60,275,4,215
-2.766887077831410,92,95,80,325,3,245
-2.7669355145837900,38,45,140,175,7,35
-2.7669897727648900,86,90,90,175,4,85
-2.767191423848840,86,95,90,100,9,10
-2.7672819943070700,28,35,170,200,7,30
-2.767353592339430,84,90,190,200,6,10
-2.767390966019200,22,30,60,275,8,215
-2.767535715075960,96,100,90,150,4,60
-2.767546005253770,16,25,100,225,9,125
-2.76768443761948,92,95,70,200,3,130
-2.767702623972820,92,95,100,300,3,200
-2.767805566637640,16,25,90,450,9,360
-2.767949170687780,22,30,160,275,8,115
-2.7679850206647300,16,25,70,450,9,380
-2.768114344890930,26,35,130,175,9,45
-2.7681459362923000,66,70,190,275,4,85
-2.7688963733771200,56,60,160,225,4,65
-2.768942653547380,66,70,60,200,4,140
-2.7691563724825600,22,30,110,275,8,165
-2.7693080369625500,40,45,130,425,5,295
-2.7693602845453200,16,25,80,375,9,295
-2.769513307920730,92,95,110,375,3,265
-2.7695146780290800,16,25,140,250,9,110
-2.7695881739443100,40,45,170,450,5,280
-2.76969470790896,40,45,130,400,5,270
-2.770061670851090,16,25,160,475,9,315
-2.7703569630646000,92,95,110,225,3,115
-2.770401540286270,92,95,50,250,3,200
-2.770500070808120,40,45,150,475,5,325
-2.770590372676400,40,45,130,250,5,120
-2.7706865818574300,92,95,150,250,3,100
-2.7707418792341500,16,25,60,400,9,340
-2.770747179815220,40,45,150,350,5,200
-2.7709569280360500,22,30,130,350,8,220
-2.7709755298518100,40,45,150,450,5,300
-2.771223752252120,74,80,70,100,6,30
-2.7715169283940600,40,45,130,375,5,245
-2.77162301652315,26,35,90,150,9,60
-2.7716785431776900,50,55,130,200,5,70
-2.771779441856530,16,25,80,225,9,145
-2.771893374758320,96,100,130,175,4,45
-2.772063293314910,16,25,120,475,9,355
-2.7721073240613700,82,85,170,500,3,330
-2.7721577992038200,34,40,120,300,6,180
-2.7722125489804800,16,25,150,225,9,75
-2.772226641173480,40,45,70,475,5,405
-2.7722298033439700,40,45,200,425,5,225
-2.7722880197417900,22,30,110,300,8,190
-2.77230155591731,40,45,140,450,5,310
-2.7723611555458600,16,25,110,450,9,340
-2.7723703495546400,56,60,160,250,4,90
-2.7727248668961700,40,45,160,300,5,140
-2.7728403037754600,40,45,90,350,5,260
-2.77289322019782,16,25,200,400,9,200
-2.7729441190771600,70,75,120,150,5,30
-2.7730750306181600,50,55,160,200,5,40
-2.7733191904032900,28,35,50,150,7,100
-2.7737772981980300,22,30,140,300,8,160
-2.7740815587062700,50,55,70,175,5,105
-2.7741577813591200,40,45,60,400,5,340
-2.7742194016992800,84,90,70,100,6,30
-2.77427153700977,16,25,150,350,9,200
-2.774323119442680,40,45,140,425,5,285
-2.774447859223710,92,95,50,325,3,275
-2.7746716050170700,16,25,70,475,9,405
-2.774702382546990,48,55,90,125,7,35
-2.775094425917030,82,85,150,500,3,350
-2.775546426424400,16,25,80,500,9,420
-2.77561044578272,82,85,120,450,3,330
-2.775659204888310,40,45,90,300,5,210
-2.775783307776390,22,30,160,225,8,65
-2.775942948665130,40,45,70,375,5,305
-2.7761536871897200,94,100,110,125,6,15
-2.7763585075072400,40,45,150,400,5,250
-2.77641261477371,22,30,110,375,8,265
-2.776493863321730,16,25,180,425,9,245
-2.7767326659412500,22,30,150,375,8,225
-2.776736156990670,16,25,150,400,9,250
-2.7767424224284800,82,85,200,450,3,250
-2.776896204660220,56,60,150,275,4,125
-2.776951922487520,16,25,180,450,9,270
-2.777002312999030,78,85,80,100,7,20
-2.777111772132450,40,45,110,450,5,340
-2.7772980177248700,34,40,180,225,6,45
-2.7776798442191300,22,30,110,325,8,215
-2.7780064159350000,40,45,80,500,5,420
-2.778094943237580,22,30,80,300,8,220
-2.7781326480037300,16,25,50,300,9,250
-2.7782963163798400,92,95,60,275,3,215
-2.7783376930078300,16,25,140,400,9,260
-2.778443883897400,64,70,160,175,6,15
-2.778476373762170,92,95,70,300,3,230
-2.778696675329160,70,75,60,125,5,65
-2.778805172775570,16,25,60,300,9,240
-2.7790964381073600,28,35,100,175,7,75
-2.779107308423860,40,45,190,350,5,160
-2.7791458271425400,96,100,200,225,4,25
-2.7791831029598800,16,25,90,300,9,210
-2.7793056355168100,40,45,200,350,5,150
-2.7794130422639,64,70,130,150,6,20
-2.7795705871729100,16,25,70,250,9,180
-2.779607012100540,16,25,90,275,9,185
-2.779703368501870,22,30,150,250,8,100
-2.7799104089904600,40,45,90,225,5,135
-2.780030367395950,40,45,140,275,5,135
-2.780034181805510,40,45,190,425,5,235
-2.7801556802719800,92,95,110,300,3,190
-2.7802641277084500,40,45,80,475,5,395
-2.78030839913892,40,45,180,375,5,195
-2.7803830351633100,34,40,110,200,6,90
-2.780429636122450,40,45,150,225,5,75
-2.780442081665550,34,40,180,250,6,70
-2.780447661060200,92,95,60,225,3,165
-2.7805647833672900,16,25,130,475,9,345
-2.780567270499580,40,45,120,425,5,305
-2.7805970870392500,16,25,110,475,9,365
-2.7806810162369100,16,25,170,450,9,280
-2.780737036189610,56,60,140,325,4,185
-2.7808033238999700,92,95,130,275,3,145
-2.7808968916931000,26,35,140,175,9,35
-2.7810083712239900,40,45,190,400,5,210
-2.781017515699310,92,95,150,275,3,125
-2.7810827503849400,56,60,80,300,4,220
-2.781459565957270,82,85,180,475,3,295
-2.781462918251220,66,70,50,175,4,125
-2.7814680999031600,66,70,100,200,4,100
-2.7815692563131900,16,25,180,400,9,220
-2.7815847879429300,56,60,130,275,4,145
-2.7821639295650400,42,50,90,125,8,35
-2.7822788086782500,16,25,140,225,9,85
-2.782482247686030,34,40,60,200,6,140
-2.782638836972240,40,45,190,375,5,185
-2.782737988516240,16,25,80,350,9,270
-2.7827719724112500,16,25,120,400,9,280
-2.7834228682373200,82,85,90,500,3,410
-2.7835404582212600,90,95,100,125,5,25
-2.7836260664620400,16,25,70,275,9,205
-2.783695717637640,16,25,100,250,9,150
-2.783702235468780,16,25,120,425,9,305
-2.7839590029345600,72,75,200,500,3,300
-2.7840436766824700,40,45,170,300,5,130
-2.784056072947940,92,95,170,250,3,80
-2.784467194745070,82,85,100,500,3,400
-2.7847863987585900,44,50,80,150,6,70
-2.785022573646810,38,45,110,150,7,40
-2.785056649820980,40,45,140,400,5,260
-2.7851596462688600,86,90,100,175,4,75
-2.78532131415585,50,55,140,200,5,60
-2.785334822858930,78,85,110,125,7,15
-2.7854280046558200,22,30,150,275,8,125
-2.7854952106928500,22,30,130,275,8,145
-2.7856352904913900,92,95,80,300,3,220
-2.785673488249380,36,45,100,125,9,25
-2.786090390452840,40,45,80,375,5,295
-2.786185520734540,16,25,190,400,9,210
-2.7862593256234600,56,60,130,300,4,170
-2.7863053413491400,34,40,90,200,6,110
-2.786574370560460,40,45,80,450,5,370
-2.786886804540390,40,45,100,225,5,125
-2.787233207410530,40,45,70,450,5,380
-2.78734212818256,48,55,160,175,7,15
-2.7873550216692800,22,30,160,250,8,90
-2.7875165049592200,82,85,90,475,3,385
-2.7875665637067900,82,85,170,350,3,180
-2.787712227044140,56,60,110,325,4,215
-2.7879499366435400,16,25,150,475,9,325
-2.7880054561047100,70,75,150,175,5,25
-2.78805545382867,16,25,180,375,9,195
-2.7881681769599500,40,45,140,375,5,235
-2.7883536567036700,40,45,200,375,5,175
-2.7884041357442200,40,45,150,425,5,275
-2.7884093882013200,44,50,70,150,6,80
-2.788426717053210,40,45,160,450,5,290
-2.78851003583342,86,90,200,250,4,50
-2.788707419667070,16,25,150,450,9,300
-2.7887736709162200,44,50,100,150,6,50
-2.788991502665210,92,95,120,325,3,205
-2.789266580443080,16,25,90,375,9,285
-2.7893266312565600,54,60,50,100,6,50
-2.789382999871870,40,45,100,400,5,300
-2.7894350030775300,66,70,130,200,4,70
-2.789504565714100,86,90,50,150,4,100
-2.789791784642900,16,25,120,250,9,130
-2.789842130392680,22,30,120,325,8,205
-2.7899662944088300,96,100,50,125,4,75
-2.7901430435270400,40,45,120,250,5,130
-2.7902176672120500,34,40,50,175,6,125
-2.790401567807680,40,45,90,375,5,285
-2.7904027147477000,16,25,190,350,9,160
-2.790674993807860,26,35,110,150,9,40
-2.79104843676443,92,95,110,325,3,215
-2.7913862380912600,34,40,190,275,6,85
-2.79155620623924,16,25,130,425,9,295
-2.7915812215302000,80,85,50,100,5,50
-2.7916086991690700,16,25,140,425,9,285
-2.791962817806850,34,40,50,200,6,150
-2.7920385059986100,40,45,150,325,5,175
-2.7920410368847100,82,85,120,500,3,380
-2.792273267077610,16,25,130,375,9,245
-2.792404913465960,16,25,140,450,9,310
-2.7924468740165800,16,25,70,425,9,355
-2.792458245136050,56,60,120,325,4,205
-2.7925042435321400,92,95,140,325,3,185
-2.7925556160311500,66,70,120,200,4,80
-2.792560257020710,82,85,190,450,3,260
-2.7926956439610800,40,45,70,350,5,280
-2.792766613178530,40,45,140,475,5,335
-2.792874014651700,96,100,140,175,4,35
-2.7929110676944100,38,45,180,200,7,20
-2.793238471583530,92,95,130,325,3,195
-2.793274093022460,98,105,80,100,7,20
-2.793473285258330,16,25,100,400,9,300
-2.793481416880410,58,65,70,100,7,30
-2.793586286239430,40,45,100,250,5,150
-2.7938977727711800,16,25,50,325,9,275
-2.7939870158616300,16,25,80,450,9,370
-2.7940215314423600,40,45,70,425,5,355
-2.794090206287560,76,80,80,150,4,70
-2.794127483790220,16,25,170,300,9,130
-2.7942261142877600,34,40,130,200,6,70
-2.79423929380652,16,25,200,425,9,225
-2.79428722415627,40,45,90,425,5,335
-2.794314630932210,56,60,170,275,4,105
-2.7943814529842600,16,25,70,350,9,280
-2.794386023001580,16,25,140,275,9,135
-2.7944912144251300,86,90,170,200,4,30
-2.7945535617161900,56,60,130,325,4,195
-2.794570754895870,40,45,50,275,5,225
-2.794864266927800,40,45,110,425,5,315
-2.79498018448112,92,95,130,300,3,170
-2.7949967504004400,82,85,130,500,3,370
-2.7951817474457400,16,25,50,225,9,175
-2.7952790356309600,16,25,80,475,9,395
-2.7954728690526600,40,45,80,275,5,195
-2.7955975698742500,40,45,180,325,5,145
-2.7956076017812700,66,75,140,150,9,10
-2.795666032783230,40,45,60,300,5,240
-2.7959224368943900,16,25,50,250,9,200
-2.7960013209027300,76,80,70,150,4,80
-2.796087744769490,98,105,110,125,7,15
-2.796143355296530,64,70,90,125,6,35
-2.796308056978310,94,100,80,100,6,20
-2.7965318871105500,16,25,60,500,9,440
-2.7966008272773900,50,55,110,175,5,65
-2.7966471537300100,32,40,180,200,8,20
-2.7967147123725300,82,85,160,475,3,315
-2.796742290194840,50,55,80,175,5,95
-2.7968257992596100,82,85,50,375,3,325
-2.7970914250510800,40,45,180,350,5,170
-2.797909290270770,40,45,140,250,5,110
-2.7983124171790000,82,85,170,475,3,305
-2.798642404600180,40,45,80,225,5,145
-2.7986907423488800,22,30,150,200,8,50
-2.7988670077665300,82,85,160,425,3,265
-2.7992262588347300,40,45,60,475,5,415
-2.799301834261050,40,45,70,250,5,180
-2.799332575176960,40,45,80,350,5,270
-2.799535053606450,16,25,160,375,9,215
-2.799728959182340,40,45,90,275,5,185
-2.7997457702699800,82,85,100,450,3,350
-2.799866014645210,40,45,100,275,5,175
-2.799952721024880,92,95,160,250,3,90
-2.799959753598180,42,50,160,175,8,15
-2.800296800401800,16,25,180,300,9,120
-2.8003097856868000,82,85,100,475,3,375
-2.800380073507500,46,50,200,500,4,300
-2.8007819720790400,40,45,190,325,5,135
-2.800797925454670,16,25,140,375,9,235
-2.8009887275060900,40,45,160,375,5,215
-2.8012157701263,40,45,70,275,5,205
-2.801543583295310,42,50,130,150,8,20
-2.8015498686560700,40,45,140,350,5,210
-2.8018668615986900,56,65,140,150,9,10
-2.8019125748095800,16,25,190,325,9,135
-2.8019179113789100,82,85,120,475,3,355
-2.802107613124370,16,25,60,475,9,415
-2.8021260910591900,32,40,110,150,8,40
-2.80251258138568,40,45,180,300,5,120
-2.8026747499151800,46,55,110,125,9,15
-2.8026900250561900,40,45,200,325,5,125
-2.8028635902231200,82,85,170,325,3,155
-2.803330438309850,34,40,60,175,6,115
-2.803570860253800,40,45,110,250,5,140
-2.8037662611763700,82,85,170,425,3,255
-2.8038663602936600,92,95,180,275,3,95
-2.8039747413545600,16,25,190,425,9,235
-2.8039837894745200,46,55,80,100,9,20
-2.8040850049740800,92,95,170,275,3,105
-2.8041750848725400,16,25,100,325,9,225
-2.8042640583638200,66,70,60,175,4,115
-2.8043693145222900,16,25,180,350,9,170
-2.8044430997874100,82,85,130,475,3,345
-2.8046641016554000,22,30,170,225,8,55
-2.804667110623810,16,25,140,475,9,335
-2.8046952572950200,16,25,60,225,9,165
-2.80478098799871,82,85,140,500,3,360
-2.8048740705855100,16,25,150,325,9,175
-2.804935379346080,26,35,180,200,9,20
-2.8050798181074100,82,85,170,375,3,205
-2.80542901139339,90,95,70,100,5,30
-2.8054719398811000,40,45,120,350,5,230
-2.805901344474860,82,85,180,450,3,270
-2.8059087331336600,16,25,110,250,9,140
-2.80645217123784,40,45,60,500,5,440
-2.806571653184510,28,35,60,150,7,90
-2.8065951813425100,22,30,140,325,8,185
-2.806791980683300,92,95,160,225,3,65
-2.806835723260600,82,85,110,500,3,390
-2.8069724027364900,22,30,130,300,8,170
-2.806998130016880,16,25,110,425,9,315
-2.8070138444532000,82,85,170,400,3,230
-2.807070707077440,36,45,70,100,9,30
-2.8070750345188200,82,85,50,425,3,375
-2.8071383087667100,16,25,150,425,9,275
-2.8075168795208400,16,25,90,425,9,335
-2.8076108386513600,16,25,100,275,9,175
-2.8076652990804,66,70,140,200,4,60
-2.8077811315868500,40,45,80,425,5,345
-2.807963436665600,72,75,190,500,3,310
-2.8082112960817,72,75,200,475,3,275
-2.808376946420410,60,65,110,150,5,40
-2.8084647524753800,34,40,140,200,6,60
-2.808471549288200,34,40,100,200,6,100
-2.8086423082259500,82,85,130,450,3,320
-2.8087230508957100,92,95,120,300,3,180
-2.8089436059432200,34,40,160,200,6,40
-2.8090390967030800,100,105,160,175,5,15
-2.809149847087360,56,60,170,225,4,55
-2.8094275897240300,82,85,60,425,3,365
-2.80955191134112,22,30,130,325,8,195
-2.80969088159914,82,85,50,350,3,300
-2.809755987951770,82,85,100,425,3,325
-2.810621094521330,56,60,80,200,4,120
-2.8107483648812400,16,25,200,350,9,150
-2.8108980377649900,16,25,200,325,9,125
-2.811272392716700,66,70,70,175,4,105
-2.811294716191410,16,25,140,350,9,210
-2.811417579812640,22,30,170,275,8,105
-2.8114778177666200,40,45,100,325,5,225
-2.811614806083020,48,55,130,150,7,20
-2.8117982815443000,72,75,190,475,3,285
-2.8118216721160100,82,85,70,500,3,430
-2.8119591628193700,60,65,180,200,5,20
-2.8125087153231100,82,85,180,425,3,245
-2.8125933110377100,28,35,190,225,7,35
-2.8126347212625300,80,85,80,125,5,45
-2.8129283389575200,16,25,180,325,9,145
-2.81303675160065,82,85,160,350,3,190
-2.813039609500410,22,30,80,200,8,120
-2.8132032286962100,40,45,50,300,5,250
-2.8132171856078200,56,60,120,300,4,180
-2.8134887342805700,16,25,60,250,9,190
-2.813587770310460,82,90,140,150,8,10
-2.813663999432910,66,70,110,175,4,65
-2.8136718472613800,82,85,50,400,3,350
-2.8137843033804900,16,25,110,225,9,115
-2.813904929759940,22,30,50,200,8,150
-2.813986827908110,82,85,200,425,3,225
-2.8140273177679200,16,25,70,200,9,130
-2.8140446304050400,82,85,90,250,3,160
-2.814054954920170,86,90,60,150,4,90
-2.8143187481456500,40,45,60,450,5,390
-2.8143400713730600,34,40,120,200,6,80
-2.81452923567096,40,45,100,300,5,200
-2.81468799816436,16,25,120,350,9,230
-2.8147363626088600,16,25,160,450,9,290
-2.8151164320690700,40,45,110,400,5,290
-2.815204415198990,16,25,200,375,9,175
-2.8154042802280100,82,85,130,400,3,270
-2.8156938869857100,40,45,110,350,5,240
-2.8160062965907800,56,60,180,275,4,95
-2.816289903602270,16,25,90,325,9,235
-2.816324035581270,16,25,190,300,9,110
-2.8163340042081100,16,25,120,275,9,155
-2.8164328007688000,40,45,120,375,5,255
-2.8164378983638100,16,25,70,325,9,255
-2.816588528891470,82,85,110,475,3,365
-2.8166404143166000,82,85,90,450,3,360
-2.8168433664497400,16,25,190,375,9,185
-2.817120246777630,82,85,50,500,3,450
-2.8172228990812700,56,60,150,200,4,50
-2.8172526849952300,16,25,80,425,9,345
-2.8173524032496600,92,95,80,200,3,120
-2.8174161195292500,86,90,120,175,4,55
-2.8175334740056700,40,45,140,225,5,85
-2.817707092381780,40,45,80,400,5,320
-2.8179324502694900,50,55,190,250,5,60
-2.818107671856060,54,60,80,125,6,45
-2.818370940439390,28,35,200,250,7,50
-2.8185609461152400,40,45,110,375,5,265
-2.818727817774900,44,50,140,175,6,35
-2.8190269797034200,56,60,60,200,4,140
-2.819069781812420,50,55,90,175,5,85
-2.8190829528985100,16,25,100,300,9,200
-2.8193194073404800,72,75,160,500,3,340
-2.8193311256074200,22,30,60,200,8,140
-2.8195009329022300,72,75,180,500,3,320
-2.81975445144253,16,25,60,450,9,390
-2.819797804390950,82,85,130,425,3,295
-2.8200915226627400,16,25,110,400,9,290
-2.820576250012210,16,25,80,400,9,320
-2.820636467384360,82,85,160,400,3,240
-2.821180692359620,82,85,160,325,3,165
-2.821258514216610,86,90,190,225,4,35
-2.8213569341355600,40,45,70,400,5,330
-2.8214584899493600,46,50,200,475,4,275
-2.821580811728330,26,35,120,150,9,30
-2.8217034052246900,40,45,90,325,5,235
-2.8218242278445200,54,60,90,125,6,35
-2.8219402907100700,92,95,170,225,3,55
-2.8222660568126800,88,95,140,150,7,10
-2.822352619349410,40,45,130,350,5,220
-2.822357090690780,16,25,110,350,9,240
-2.822643440150330,44,50,90,150,6,60
-2.8227619199234600,40,45,100,375,5,275
-2.823198665423660,82,85,60,350,3,290
-2.8231998951020600,62,70,140,150,8,10
-2.823221069120780,40,45,110,275,5,165
-2.8233529848409000,44,50,200,225,6,25
-2.823497122341970,16,25,120,375,9,255
-2.8237149376622200,16,25,70,400,9,330
-2.823716260336680,56,60,200,275,4,75
-2.8237289161057400,40,45,190,300,5,110
-2.823751760405440,40,45,120,275,5,155
-2.823807998957580,82,85,50,450,3,400
-2.8238765531461000,46,50,190,500,4,310
-2.8240013964871900,70,75,70,125,5,55
-2.824086065182570,66,70,190,250,4,60
-2.8241968584991800,82,85,140,450,3,310
-2.8242432712804200,16,25,100,350,9,250
-2.8242988849690200,82,85,120,400,3,280
-2.8250841913632900,82,85,150,450,3,300
-2.825371991108370,28,35,120,175,7,55
-2.8254242846274900,22,30,120,300,8,180
-2.8255141563509100,64,70,60,100,6,40
-2.825567234697320,66,70,80,175,4,95
-2.8256706740578700,82,85,60,325,3,265
-2.8256833984819200,82,85,140,375,3,235
-2.825775889590310,82,85,130,225,3,95
-2.826007893796030,82,85,70,225,3,155
-2.8262511289177500,40,45,100,350,5,250
-2.826317131255680,44,50,130,175,6,45
-2.826326254691500,16,25,110,275,9,165
-2.826359015818230,82,85,70,475,3,405
-2.82656786030623,82,85,140,400,3,260
-2.8266007362936000,72,75,90,500,3,410
-2.826646471277170,82,85,190,425,3,235
-2.826881902570640,82,85,80,250,3,170
-2.826963535877430,82,85,120,425,3,305
-2.826990783821630,16,25,60,275,9,215
-2.827107268649860,82,85,180,400,3,220
-2.827729085308150,82,85,170,450,3,280
-2.8277516944185200,82,85,150,475,3,325
-2.8278353852842000,54,60,160,175,6,15
-2.8279369710555000,82,85,120,225,3,105
-2.8281363010594500,82,85,90,400,3,310
-2.82823289032277,82,85,150,400,3,250
-2.8283192969612500,34,40,70,175,6,105
-2.8283810854574800,82,85,60,375,3,315
-2.8285332461328000,40,45,60,225,5,165
-2.82859687241268,82,85,200,400,3,200
-2.828607283864740,96,100,110,150,4,40
-2.8287044669389600,76,80,100,150,4,50
-2.828842900153760,16,25,100,375,9,275
-2.828845712549390,82,85,70,375,3,305
-2.8290306205550400,82,85,50,475,3,425
-2.8291060911292000,40,45,110,225,5,115
-2.829136269086410,82,85,200,300,3,100
-2.829319404406440,16,25,160,275,9,115
-2.829374738130620,32,40,120,150,8,30
-2.8294585948585600,92,95,200,275,3,75
-2.8297059018021500,72,80,140,150,8,10
-2.8297825776142600,82,85,190,400,3,210
-2.829947128498360,40,45,50,325,5,275
-2.829953859312500,82,85,150,425,3,275
-2.8299736173857500,40,45,150,375,5,225
-2.8300458003208000,72,75,120,450,3,330
-2.8301572056139400,76,80,140,175,4,35
-2.830453504185400,22,30,160,200,8,40
-2.830586892056840,40,45,150,300,5,150
-2.8305954527141500,76,85,170,175,9,5
-2.8306240615462500,70,75,50,100,5,50
-2.8307275372262100,56,60,180,250,4,70
-2.830817459926270,82,85,110,425,3,315
-2.831099890156320,34,40,110,175,6,65
-2.8311378561568900,82,85,130,375,3,245
-2.8314967466911100,46,50,190,475,4,285
-2.8315686757691100,92,95,150,200,3,50
-2.8317278096370300,72,75,50,375,3,325
-2.83193129439429,92,95,190,275,3,85
-2.8320029040615600,82,85,180,375,3,195
-2.8325166792075700,16,25,140,300,9,160
-2.8325554448779800,40,45,70,325,5,255
-2.8326069107048000,82,85,140,475,3,335
-2.832617243984770,22,30,200,275,8,75
-2.832697460656760,82,85,80,475,3,395
-2.8328793349608100,82,85,60,400,3,340
-2.83318899871731,82,85,150,325,3,175
-2.833409175985790,66,70,90,175,4,85
-2.8336959897664100,82,85,80,450,3,370
-2.8339576637490100,56,60,110,200,4,90
-2.8340383991078300,16,25,150,300,9,150
-2.834192532749640,44,50,50,125,6,75
-2.8342100079929300,22,30,180,225,8,45
-2.8342119323767100,40,45,160,275,5,115
-2.834285854924190,40,45,60,250,5,190
-2.834514954316880,40,45,50,225,5,175
-2.8345351322441500,22,30,180,250,8,70
-2.834888391664800,16,25,150,200,9,50
-2.835065651364730,56,60,180,225,4,45
-2.835329528887700,16,25,110,300,9,190
-2.8354369858642000,72,75,170,400,3,230
-2.8359526262790500,40,45,170,250,5,80
-2.835961431425580,46,50,180,500,4,320
-2.83611534245832,30,35,200,500,5,300
-2.8361515350762800,16,25,70,300,9,230
-2.8367138193768300,40,45,160,250,5,90
-2.836769283544930,22,30,50,175,8,125
-2.837190426235220,100,105,130,150,5,20
-2.837294835934020,82,85,110,450,3,340
-2.837302188860610,82,85,130,250,3,120
-2.8374904356151300,82,85,200,375,3,175
-2.8375810519613400,82,85,190,350,3,160
-2.8377797245930700,72,75,100,500,3,400
-2.838054648618,16,25,170,250,9,80
-2.8380720864396400,72,75,50,425,3,375
-2.838080308184310,72,75,170,500,3,330
-2.838133146272750,22,30,110,200,8,90
-2.838262759962960,72,75,120,500,3,380
-2.8383323733364300,82,85,80,500,3,420
-2.8388710524796100,72,75,90,475,3,385
-2.8390809021126400,22,30,180,275,8,95
-2.839092407016070,82,85,160,375,3,215
-2.83928400220723,40,45,70,300,5,230
-2.839331412499770,56,60,120,200,4,80
-2.8393403607696100,82,85,70,450,3,380
-2.839678654278780,16,25,130,350,9,220
-2.8397549208479900,40,45,60,275,5,215
-2.8399522562799700,50,55,100,175,5,75
-2.8402510345755500,40,45,50,250,5,200
-2.8403894816574300,82,85,140,425,3,285
-2.8405151838180700,82,85,140,275,3,135
-2.840557493743480,68,75,80,100,7,20
-2.8409522139322200,16,25,80,300,9,220
-2.840953982036380,60,65,120,150,5,30
-2.8410339612684900,56,60,50,200,4,150
-2.8411085971471100,80,85,60,100,5,40
-2.841212965677870,16,25,150,250,9,100
-2.8414491652572300,40,45,70,200,5,130
-2.841611416668910,82,85,170,300,3,130
-2.841781257147320,40,45,110,300,5,190
-2.841957952425670,56,60,190,275,4,85
-2.8419584540460400,82,85,160,450,3,290
-2.842378205706520,72,75,50,350,3,300
-2.842640777466240,46,50,160,500,4,340
-2.8426551049457000,40,45,80,325,5,245
-2.842721106765680,56,60,90,200,4,110
-2.8429263674838400,22,30,90,200,8,110
-2.8429461921238900,60,65,60,125,5,65
-2.842963428113810,82,85,160,300,3,140
-2.843050886491050,52,60,80,100,8,20
-2.8432335894689100,76,80,90,150,4,60
-2.843486681280910,96,105,170,175,9,5
-2.843506910844430,82,85,140,350,3,210
-2.8436249533495800,72,75,150,500,3,350
-2.843646245337970,82,85,180,350,3,170
-2.8437685749709400,40,45,140,300,5,160
-2.843884229641000,72,75,170,350,3,180
-2.8440411694016900,82,85,60,500,3,440
-2.8440581243361300,72,75,200,450,3,250
-2.844069826536450,54,60,130,150,6,20
-2.8442030552957700,80,85,90,125,5,35
-2.8443037364158600,72,75,160,425,3,265
-2.8444453924798800,76,80,200,225,4,25
-2.8446166707474100,66,70,50,150,4,100
-2.8448319155990500,86,90,70,150,4,80
-2.844910829707660,82,85,90,350,3,260
-2.844912288827000,82,85,200,350,3,150
-2.844937516569880,40,45,150,275,5,125
-2.845340637430730,82,85,100,400,3,300
-2.845586969516280,22,30,120,200,8,80
-2.8455985220285200,92,95,180,250,3,70
-2.845813352041900,28,35,70,150,7,80
-2.8459322856777300,56,60,50,175,4,125
-2.845942632310560,86,90,80,150,4,70
-2.8459449270957800,32,40,150,175,8,25
-2.846290558051490,38,45,120,150,7,30
-2.8463583166968900,76,80,50,125,4,75
-2.8464541186973200,46,50,120,450,4,330
-2.846714455889340,72,75,190,450,3,260
-2.8469414573846500,38,45,60,125,7,65
-2.846943172229190,82,85,100,250,3,150
-2.8469608669500600,82,85,150,350,3,200
-2.846991751656050,16,25,80,325,9,245
-2.8471506299301300,84,90,80,100,6,20
-2.8472241579172700,40,45,150,250,5,100
-2.8479415695927000,82,85,90,275,3,185
-2.8480303368036200,96,100,70,125,4,55
-2.848227751326220,72,75,160,475,3,315
-2.848377509367630,46,50,100,500,4,400
-2.848508792820610,50,55,170,200,5,30
-2.848551740221390,76,80,130,175,4,45
-2.8488103475464100,50,55,50,150,5,100
-2.8488390824713900,34,40,80,175,6,95
-2.848856714675700,92,95,60,200,3,140
-2.8489326561041800,82,85,180,325,3,145
-2.84905924336091,96,100,180,200,4,20
-2.8494317079141500,56,60,100,200,4,100
-2.8495438224391600,82,85,70,425,3,355
-2.8495526110157700,40,45,130,275,5,145
-2.8496691174020900,82,85,200,325,3,125
-2.849888695298390,82,85,140,250,3,110
-2.8500249162690400,92,95,110,200,3,90
-2.850259860462350,16,25,150,375,9,225
-2.850680714751050,82,85,90,425,3,335
-2.850771642940730,32,40,60,125,8,65
-2.8510195320108800,82,85,80,375,3,295
-2.8511803379501700,82,85,70,350,3,280
-2.8512159103672300,64,70,190,200,6,10
-2.8515472794434300,60,65,70,125,5,55
-2.851613364078660,82,85,50,275,3,225
-2.851641734303230,66,70,100,175,4,75
-2.851684858936680,72,75,180,475,3,295
-2.851923817179220,82,85,100,225,3,125
-2.8520204047308800,82,85,190,375,3,185
-2.8520531756601900,46,50,170,500,4,330
-2.8521246022772100,82,85,80,275,3,195
-2.852156152499960,82,85,100,325,3,225
-2.8522738413608200,72,75,160,400,3,240
-2.8524598010045600,46,50,170,350,4,180
-2.8524999569339300,82,85,60,475,3,415
-2.852584423236790,82,85,90,375,3,285
-2.852687895797620,16,25,150,275,9,125
-2.852900917210030,16,25,160,225,9,65
-2.8529405708543300,92,95,50,200,3,150
-2.8532804193994700,30,35,200,475,5,275
-2.853400215413960,72,75,170,450,3,280
-2.8536817052271900,66,75,90,100,9,10
-2.8537140983883900,92,95,60,175,3,115
-2.853835408638130,66,70,170,200,4,30
-2.854000670115790,56,60,160,200,4,40
-2.8540702911567400,46,50,170,400,4,230
-2.854170140155350,82,85,120,250,3,130
-2.8542385715106000,82,85,90,300,3,210
-2.854484441928490,72,75,170,475,3,305
-2.8546463055295700,34,40,170,200,6,30
-2.854703160515410,72,75,100,450,3,350
-2.8551078178117500,40,45,80,300,5,220
-2.8551155970045200,46,50,90,500,4,410
-2.8551847304160400,82,85,110,250,3,140
-2.8553903120719100,22,30,190,275,8,85
-2.855525289585590,96,100,60,125,4,65
-2.8560331177911800,72,75,140,500,3,360
-2.8561954398358600,46,50,150,500,4,350
-2.856425205225620,82,85,70,400,3,330
-2.8565345786304000,92,95,180,225,3,45
-2.85654351297359,70,75,80,125,5,45
-2.856813821562380,50,55,190,225,5,35
-2.8570026180641900,82,85,120,350,3,230
-2.857060699634920,72,75,70,500,3,430
-2.857313012584920,92,95,50,175,3,125
-2.8575443756792300,16,25,110,375,9,265
-2.857680586825340,48,55,60,100,7,40
-2.8582643904702800,72,75,100,425,3,325
-2.858280628671190,92,95,90,200,3,110
-2.858363870823150,82,85,60,300,3,240
-2.8584162090556200,82,85,80,350,3,270
-2.8585933241222500,82,85,70,275,3,205
-2.859046948649190,72,75,130,400,3,270
-2.8590972393220700,82,85,100,275,3,175
-2.8594551625359400,82,85,90,225,3,135
-2.8595173643882400,82,85,190,325,3,135
-2.8595887261488500,72,75,110,500,3,390
-2.8596206517881900,40,45,120,325,5,205
-2.8597262216943900,72,75,50,400,3,350
-2.859760684179640,16,25,130,275,9,145
-2.859843207571000,72,75,200,400,3,200
-2.8600032157300800,72,75,130,475,3,345
-2.8600503355419800,72,75,100,475,3,375
-2.8602735493148800,72,75,120,475,3,355
-2.8603303539082200,50,55,200,250,5,50
-2.8604883373585200,22,30,130,200,8,70
-2.860759511835450,52,60,110,125,8,15
-2.8607721017565600,82,85,110,400,3,290
-2.86096158914538,68,75,110,125,7,15
-2.8609747217866900,42,50,60,100,8,40
-2.8612671300016200,80,85,160,175,5,15
-2.8613623703919400,72,75,50,500,3,450
-2.8614131878973400,46,50,200,450,4,250
-2.8614259511028500,60,65,150,175,5,25
-2.861498979409750,46,50,90,475,4,385
-2.861618105267690,40,45,110,325,5,215
-2.861815884127230,40,45,130,300,5,170
-2.8618212182123700,28,35,100,150,7,50
-2.861948398991020,72,75,70,225,3,155
-2.8622442704353300,72,75,130,500,3,370
-2.862374808450680,32,40,70,125,8,55
-2.8626521240931100,48,55,190,200,7,10
-2.8627376482733800,46,50,170,375,4,205
-2.862928954700370,16,25,170,225,9,55
-2.8629320306114900,46,50,100,450,4,350
-2.8629388495888700,82,85,100,300,3,200
-2.8629802717029800,44,50,110,150,6,40
-2.863228518635220,22,30,100,200,8,100
-2.8633619055078800,82,85,140,225,3,85
-2.8637256195186000,34,40,190,250,6,60
-2.863758410834660,82,85,120,275,3,155
-2.863875926928190,34,40,90,175,6,85
-2.864317962549640,46,50,120,500,4,380
-2.8645359127393300,38,45,150,175,7,25
-2.864587449011740,72,75,50,450,3,400
-2.8646767206396600,26,35,60,125,9,65
-2.8647487972346800,72,75,90,450,3,360
-2.864865251822730,40,45,160,225,5,65
-2.8648810629214400,82,85,80,425,3,345
-2.86501586290002,82,85,180,300,3,120
-2.8650770686078000,16,25,160,250,9,90
-2.8651934221396400,30,35,190,500,5,310
-2.86529139728463,72,75,130,225,3,95
-2.865443091662060,56,60,130,200,4,70
-2.8656134954515,72,75,180,450,3,270
-2.865625816942250,72,75,160,350,3,190
-2.865656965925620,80,85,130,150,5,20
-2.8661194932338100,72,75,90,250,3,160
-2.8662221576797900,100,105,60,100,5,40
-2.866553938507050,46,50,170,475,4,305
-2.8667347646901200,42,50,190,200,8,10
-2.866810833698920,72,75,80,250,3,170
-2.867081451942120,46,50,100,475,4,375
-2.867428686675060,72,75,130,450,3,320
-2.867476214247460,96,100,150,175,4,25
-2.867510765778090,82,85,110,350,3,240
-2.86772921908105,40,45,140,325,5,185
-2.867846436681720,46,50,180,475,4,295
-2.867853099364520,22,30,60,175,8,115
-2.86789406383675,82,85,120,375,3,255
-2.8679167906476500,82,85,60,450,3,390
-2.8681563337816400,86,95,170,175,9,5
-2.868315221041530,72,75,170,425,3,255
-2.868424345360290,72,75,180,400,3,220
-2.8686892744763500,50,55,60,150,5,90
-2.8688057099206200,82,85,80,225,3,145
-2.8689531834695900,72,75,120,400,3,280
-2.8690153053390700,72,75,60,375,3,315
-2.8691539840918400,82,85,80,400,3,320
-2.869199575205210,46,50,140,500,4,360
-2.869360518253260,46,50,130,500,4,370
-2.869424589812350,46,50,50,375,4,325
-2.8695379304632400,40,45,170,275,5,105
-2.869606769016430,90,95,80,100,5,20
-2.869710845401010,40,45,130,325,5,195
-2.870272553029770,38,45,70,125,7,55
-2.870338952247100,92,95,100,200,3,100
-2.8705483248549500,40,45,80,200,5,120
-2.8705673013066900,30,35,190,475,5,285
-2.8708478724483200,92,95,160,200,3,40
-2.871724817081960,16,25,130,300,9,170
-2.8718506815515000,86,90,100,150,4,50
-2.872008651910480,50,55,120,175,5,55
-2.8720180592154600,82,85,150,225,3,75
-2.8724396910729200,46,50,50,400,4,350
-2.872453321893210,26,35,70,125,9,55
-2.8724795674990000,72,75,60,425,3,365
-2.8727702685091200,26,35,150,175,9,25
-2.872796057842270,72,75,170,375,3,205
-2.872936565603260,72,75,150,400,3,250
-2.8730250132770200,82,85,70,250,3,180
-2.8730738891425100,72,75,160,300,3,140
-2.873095260181230,96,100,120,150,4,30
-2.87319429079772,46,50,70,500,4,430
-2.8733886257140100,44,50,180,200,6,20
-2.873432239395930,72,75,180,425,3,245
-2.8736547353470900,66,70,120,175,4,55
-2.8738818441034800,46,50,50,425,4,375
-2.8739096628218600,82,85,190,300,3,110
-2.874148384993780,54,60,60,100,6,40
-2.874492930774640,72,75,170,325,3,155
-2.874504062645220,46,50,120,475,4,355
-2.874676659129150,86,90,50,125,4,75
-2.87483750133798,46,50,190,450,4,260
-2.874873204246890,92,95,130,200,3,70
-2.8750062357626200,40,45,170,225,5,55
-2.8757091602539900,72,75,50,475,3,425
-2.8758395420842900,46,50,160,425,4,265
-2.8759061620015800,82,85,90,325,3,235
-2.876031794919690,92,95,120,200,3,80
-2.8760760951895600,82,85,150,375,3,225
-2.876094770879080,18,25,200,500,7,300
-2.8761413197707100,46,50,70,225,4,155
-2.8761627331387000,82,85,150,300,3,150
-2.876484539148250,46,50,160,350,4,190
-2.8764909750443,40,45,120,300,5,180
-2.876765844060530,46,50,60,350,4,290
-2.877030704889710,46,50,170,425,4,255
-2.8771442312356600,30,35,120,450,5,330
-2.877268611968230,82,85,160,275,3,115
-2.8773172667433300,82,85,100,375,3,275
-2.8774042243960400,46,50,80,250,4,170
-2.8775495314236000,56,60,60,175,4,115
-2.877748580857150,72,75,110,475,3,365
-2.8778632340458600,16,25,160,200,9,40
-2.8778731397221300,16,25,110,325,9,215
-2.878026495463640,72,75,140,450,3,310
-2.878114590001230,48,55,100,125,7,25
-2.8783450923598300,82,85,110,275,3,165
-2.8788404727335900,82,85,110,375,3,265
-2.8788866137139900,16,25,80,200,9,120
-2.87897153742579,76,80,110,150,4,40
-2.8789988655709100,46,50,90,250,4,160
-2.8791018075803500,16,25,170,275,9,105
-2.879409747739440,46,50,120,225,4,105
-2.8794990737896600,16,25,50,175,9,125
-2.8799219147673400,72,75,120,225,3,105
-2.879925539403680,40,45,150,200,5,50
-2.879966945782590,72,75,150,475,3,325
-2.880032599155720,72,75,190,425,3,235
-2.8801814324687700,56,60,140,200,4,60
-2.880248488268070,22,30,70,175,8,105
-2.8803222559550100,46,50,60,425,4,365
-2.8804332315426300,72,75,60,400,3,340
-2.880539127180760,30,35,180,500,5,320
-2.8808579145189900,66,70,190,225,4,35
-2.8808656898765100,72,75,150,450,3,300
-2.881199593578010,66,70,200,250,4,50
-2.8814796955758100,42,50,100,125,8,25
-2.8815527829766800,72,75,60,350,3,290
-2.881651988424550,46,50,160,475,4,315
-2.881851945140840,46,50,110,500,4,390
-2.881927553485120,46,50,50,350,4,300
-2.881967285883750,16,25,180,225,9,45
-2.8822498300672000,46,50,100,425,4,325
-2.882320127080950,72,75,130,250,3,120
-2.8823755073043700,46,50,130,225,4,95
-2.882407877139800,76,80,180,200,4,20
-2.8824699393009900,46,50,50,500,4,450
-2.882485806689440,46,50,60,375,4,315
-2.882487847609070,46,50,170,325,4,155
-2.88278339850277,16,25,60,200,9,140
-2.8828473207729600,46,50,130,400,4,270
-2.8828634960629200,46,50,60,400,4,340
-2.882958527921000,72,75,90,400,3,310
-2.883402507356800,72,75,120,425,3,305
-2.8834659099605800,16,25,110,200,9,90
-2.88373939513812,82,85,50,325,3,275
-2.883846107157280,72,75,180,375,3,195
-2.883904399032770,82,85,80,325,3,245
-2.883936109313970,82,85,60,225,3,165
-2.8840052066070200,34,40,100,175,6,75
-2.8840424952139600,46,50,60,325,4,265
-2.8840978203371700,16,25,140,325,9,185
-2.884170446682890,46,50,130,450,4,320
-2.8841928427656900,72,75,80,450,3,370
-2.884307674737740,30,35,90,500,5,410
-2.884485194150580,46,50,110,475,4,365
-2.884522869327810,82,85,130,350,3,220
-2.8846986020524300,82,85,70,325,3,255
-2.8847988565144200,22,30,140,200,8,60
-2.8848145661815300,82,85,100,350,3,250
-2.8849196655748800,16,25,120,325,9,205
-2.885026941503490,80,85,70,100,5,30
-2.885138376323480,28,35,80,150,7,70
-2.885202495390060,30,35,50,375,5,325
-2.8856062178281000,72,75,60,325,3,265
-2.885891638670620,72,75,130,375,3,245
-2.885939996482920,78,85,140,150,7,10
-2.886087172960080,72,75,170,300,3,130
-2.8862374656397500,72,75,70,375,3,305
-2.8864939269769000,72,75,160,325,3,165
-2.8868346874708800,82,90,90,100,8,10
-2.8869824931016100,30,35,160,500,5,340
-2.8870023345998500,82,85,50,300,3,250
-2.887224946424150,40,45,180,275,5,95
-2.8872736836108000,46,50,200,400,4,200
-2.8872864372323000,72,75,80,500,3,420
-2.8873696937908900,56,60,110,175,4,65
-2.887439029138320,72,75,140,400,3,260
-2.8877150294842800,26,35,50,100,9,50
-2.887719376984470,46,50,120,400,4,280
-2.8877579784367400,72,75,200,300,3,100
-2.887812295981520,72,75,200,425,3,225
-2.888140758208130,16,25,130,325,9,195
-2.8882147389008200,72,75,190,400,3,210
-2.8884043351773100,72,75,70,475,3,405
-2.888419917258290,16,25,50,200,9,150
-2.888507506103780,72,75,90,225,3,135
-2.8885663562826900,56,65,90,100,9,10
-2.888574437264720,92,95,70,175,3,105
-2.8886658596584700,72,75,80,475,3,395
-2.8892770588275900,72,75,130,425,3,295
-2.8893741437580500,82,85,110,300,3,190
-2.8898423532450400,82,85,140,300,3,160
-2.8900906205488100,72,75,110,450,3,340
-2.8901306341117200,46,50,150,475,4,325
-2.8901561577356300,34,40,190,225,6,35
-2.890205116784070,46,50,160,325,4,165
-2.890243341863290,72,75,100,400,3,300
-2.8904440165296400,72,75,80,375,3,295
-2.8909114613049900,46,50,130,375,4,245
-2.8909548702068700,82,85,50,225,3,175
-2.890998234892510,82,85,60,250,3,190
-2.8910088750590000,40,45,200,275,5,75
-2.8910400711856100,72,75,150,325,3,175
-2.8911651879598100,82,85,70,200,3,130
-2.8912707925244900,46,50,180,450,4,270
-2.8914367106176900,46,50,130,475,4,345
-2.891745870119980,30,35,170,500,5,330
-2.891798058403470,60,65,50,100,5,50
-2.8921567056533900,46,50,160,400,4,240
-2.8922103974785300,46,50,50,450,4,400
-2.8923055484603700,40,45,110,200,5,90
-2.8924013614071900,28,35,50,125,7,75
-2.8925173756565400,46,50,180,425,4,245
-2.8925621899901100,72,75,90,350,3,260
-2.8926767261935400,72,75,90,300,3,210
-2.892770856363870,64,70,100,125,6,25
-2.892979576660870,30,35,90,475,5,385
-2.893090061546400,70,75,90,125,5,35
-2.893346831031320,72,75,70,450,3,380
-2.8935953883608500,82,85,110,225,3,115
-2.8936223025406700,72,75,140,475,3,335
-2.8936549013076100,82,85,170,250,3,80
-2.8938642689571900,44,50,120,150,6,30
-2.893967747932900,72,75,150,225,3,75
-2.893988527234650,72,75,150,425,3,275
-2.8941189111515000,72,75,140,425,3,285
-2.8942588175202100,72,75,150,350,3,200
-2.8943265052183600,82,85,150,250,3,100
-2.894380029516630,86,90,130,175,4,45
-2.8944053751212200,46,50,70,450,4,380
-2.8944221021370600,46,50,110,450,4,340
-2.8944423838034600,72,75,80,425,3,345
-2.8945252836424700,70,75,130,150,5,20
-2.894588759217150,82,85,150,275,3,125
-2.8946376612399800,34,40,50,150,6,100
-2.8951073725410600,72,75,190,375,3,185
-2.8951247411424500,46,55,140,150,9,10
-2.8951255763414700,46,50,170,450,4,280
-2.895150426079840,46,50,90,400,4,310
-2.895190429940110,56,60,70,175,4,105
-2.8952122322733200,100,105,100,125,5,25
-2.8952850042304700,72,75,140,250,3,110
-2.895288108588700,46,50,50,475,4,425
-2.895601195601200,82,85,60,275,3,215
-2.8957878678322300,30,35,100,500,5,400
-2.895825639922320,92,95,140,200,3,60
-2.895880423228350,98,105,140,150,7,10
-2.8961253412269900,34,40,200,250,6,50
-2.896390421819750,22,30,170,200,8,30
-2.896468599796830,46,50,140,250,4,110
-2.8966677219635600,72,75,110,425,3,315
-2.896935959597180,28,35,140,175,7,35
-2.8970733820612500,72,75,100,250,3,150
-2.897368188869620,54,60,190,200,6,10
-2.897512447562240,66,70,60,150,4,90
-2.8975730078678100,46,50,160,300,4,140
-2.8975830445625900,46,50,90,350,4,260
-2.8976210111946500,88,95,90,100,7,10
-2.897640964062910,62,65,200,500,3,300
-2.897690390766830,56,60,80,175,4,95
-2.8976969720420800,82,85,70,300,3,230
-2.897831969303060,86,90,90,150,4,60
-2.8978453857052900,46,50,120,425,4,305
-2.8978671674795200,40,45,90,200,5,110
-2.897880401200930,30,35,200,450,5,250
-2.8980527449003100,38,45,50,100,7,50
-2.898147235464300,46,50,90,450,4,360
-2.898353831620500,100,105,190,200,5,10
-2.8984030350182800,86,90,140,175,4,35
-2.898474990693940,28,35,200,225,7,25
-2.898650163173560,72,75,90,425,3,335
-2.8990588525588000,72,75,160,450,3,290
-2.89915664142998,58,65,80,100,7,20
-2.9001184627832900,28,35,90,150,7,60
-2.900337991362160,82,85,130,275,3,145
-2.9004821848221400,22,30,110,175,8,65
-2.9005243173692600,40,45,180,250,5,70
-2.9005514536990900,30,35,170,350,5,180
-2.90065925114303,72,75,80,350,3,270
-2.9007316210967200,72,75,200,375,3,175
-2.900880114208570,28,35,130,175,7,45
-2.900928114010390,72,75,190,350,3,160
-2.9017676129511300,46,50,200,425,4,225
-2.901844273031470,40,45,60,200,5,140
-2.901878526386180,74,80,80,100,6,20
-2.9018815373916000,72,75,70,425,3,355
-2.9026923016195300,72,75,200,350,3,150
-2.902804137363110,46,50,130,425,4,295
-2.902858585516610,72,75,120,350,3,230
-2.9029921808401000,30,35,150,500,5,350
-2.9029935217116800,72,75,180,350,3,170
-2.903055178607630,72,75,60,475,3,415
-2.903211503081150,70,75,160,175,5,15
-2.9033945344964100,46,50,70,475,4,405
-2.903597983178250,72,75,140,375,3,235
-2.9036811296823100,46,50,150,400,4,250
-2.903857485858510,72,75,50,275,3,225
-2.903906346000090,46,50,180,375,4,195
-2.9042117910596800,72,75,100,225,3,125
-2.904397232956200,96,100,80,125,4,45
-2.90442650768773,72,75,60,500,3,440
-2.904698808676160,82,85,160,225,3,65
-2.9047200939018000,30,35,60,425,5,365
-2.9048032207638900,82,85,80,300,3,220
-2.9052884934626000,46,50,100,225,4,125
-2.9057324567620500,94,100,90,100,6,10
-2.9058263926231900,92,95,80,175,3,95
-2.906077512578510,46,50,90,300,4,210
-2.906362748177620,82,85,120,325,3,205
-2.9063992631477600,30,35,170,400,5,230
-2.906425923071040,56,60,90,175,4,85
-2.906466158681470,94,100,140,150,6,10
-2.9064758752216900,30,35,50,400,5,350
-2.9065292869061200,46,50,150,450,4,300
-2.9065540434084800,30,35,170,475,5,305
-2.906588496329950,56,60,190,250,4,60
-2.90668080775774,46,50,70,375,4,305
-2.906723574704670,72,75,80,275,3,195
-2.907128377075190,30,35,50,350,5,300
-2.907388956434930,18,25,200,475,7,275
-2.907800454400500,40,45,50,200,5,150
-2.907870898634300,46,50,90,425,4,335
-2.907909356665160,82,85,50,250,3,200
-2.9079368375690800,30,35,80,250,5,170
-2.908035664641230,30,35,90,250,5,160
-2.908071667376830,22,30,90,175,8,85
-2.908156354405420,72,75,110,250,3,140
-2.9081766295826000,30,35,160,425,5,265
-2.908220978796710,46,50,90,225,4,135
-2.9083697572371600,76,80,60,125,4,65
-2.908603019747380,82,85,110,325,3,215
-2.9086811576324000,40,45,180,225,5,45
-2.9088912893482600,30,35,190,450,5,260
-2.909481469693220,16,25,120,300,9,180
-2.909510215456990,72,75,190,325,3,135
-2.909810734852410,30,35,50,425,5,375
-2.9098194538050700,46,50,150,350,4,200
-2.9098612040466500,46,50,140,450,4,310
-2.9099036993409600,46,50,180,400,4,220
-2.9100148749771500,46,50,150,425,4,275
-2.9101314630090400,30,35,70,225,5,155
-2.9103024636604100,30,35,70,500,5,430
-2.910355124389580,72,75,90,375,3,285
-2.9105830044561000,46,50,180,350,4,170
-2.910608705638500,62,65,200,475,3,275
-2.9106259572107500,16,25,180,275,9,95
-2.910630870196850,70,75,60,100,5,40
-2.9106580893418100,72,75,160,375,3,215
-2.9107176699352800,72,75,110,400,3,290
-2.910819114524550,40,45,160,200,5,40
-2.9109396335090500,34,40,60,150,6,90
-2.9113602064577500,46,50,80,500,4,420
-2.9115026365500200,46,50,190,425,4,235
-2.9116188245768000,30,35,100,450,5,350
-2.911837638782150,46,50,80,475,4,395
-2.9120246191932200,16,25,100,200,9,100
-2.9120791263945900,30,35,60,350,5,290
-2.9124059445479600,72,75,100,275,3,175
-2.9124292394355000,46,50,140,400,4,260
-2.9125273912275900,82,85,130,300,3,170
-2.912608528033040,72,75,140,275,3,135
-2.9126153042455800,100,105,70,100,5,30
-2.912636997563610,72,75,180,325,3,145
-2.9127119850458100,72,75,80,225,3,145
-2.9127994755414100,30,35,110,500,5,390
-2.91299260909052,24,30,200,500,6,300
-2.9129985003210200,72,75,60,300,3,240
-2.913027432678250,30,35,50,500,5,450
-2.913036320369710,30,35,120,225,5,105
-2.9130552495172800,30,35,160,400,5,240
-2.9132278278760300,72,75,180,300,3,120
-2.9132296416956200,30,35,170,325,5,155
-2.913956102643810,72,80,90,100,8,10
-2.9140458157541200,30,35,130,500,5,370
-2.9140825279675000,72,75,70,250,3,180
-2.9142446653688300,92,95,190,250,3,60
-2.91427967461824,22,30,190,250,8,60
-2.914402152173610,18,25,190,475,7,285
-2.9145540550498600,46,50,200,300,4,100
-2.9145764101999200,40,45,190,275,5,85
-2.9146670770052800,50,55,70,150,5,80
-2.9148292902715300,30,35,120,500,5,380
-2.914922451589750,16,25,110,175,9,65
-2.9151681854037100,62,65,190,500,3,310
-2.9151838896453000,46,50,80,375,4,295
-2.9152460775685800,46,50,150,325,4,175
-2.9153952763825200,64,70,70,100,6,30
-2.9154824679884800,72,75,110,375,3,265
-2.9154907344921600,72,75,140,225,3,85
-2.9155923289492300,72,75,120,250,3,130
-2.915708512995560,72,75,90,275,3,185
-2.915744512124690,30,35,60,325,5,265
-2.9157733990498200,50,55,80,150,5,70
-2.915864847610910,46,50,80,450,4,370
-2.9158820236764500,46,50,140,425,4,285
-2.9159290140937400,82,85,140,325,3,185
-2.9160729332960900,30,35,180,475,5,295
-2.9161015531200100,72,75,130,350,3,220
-2.916420698453650,46,50,110,425,4,315
-2.9165267099335000,32,40,50,100,8,50
-2.9167132219835000,46,50,190,400,4,210
-2.91674876969964,62,65,190,475,3,285
-2.9167570322002700,46,50,100,400,4,300
-2.917011575889200,18,25,50,375,7,325
-2.9171028444256900,46,50,130,250,4,120
-2.917175021353650,72,75,140,350,3,210
-2.9173924619199100,82,85,170,275,3,105
-2.9176517227297200,18,25,190,500,7,310
-2.9176782638211600,30,35,170,375,5,205
-2.9177715082185100,46,50,140,375,4,235
-2.91853562162567,46,50,140,475,4,335
-2.918847651790910,46,50,140,275,4,135
-2.9189763655273700,72,75,70,275,3,205
-2.919008026198840,40,45,100,200,5,100
-2.919266048775820,72,75,110,350,3,240
-2.9193959818277800,72,75,60,450,3,390
-2.919641611335260,46,50,70,250,4,180
-2.9196561358980100,82,85,160,250,3,90
-2.92014633602942,44,50,150,175,6,25
-2.920487695627580,46,50,50,275,4,225
-2.920577953680720,46,50,190,350,4,160
-2.920675300624160,16,25,120,200,9,80
-2.9207184806464000,82,85,130,325,3,195
-2.9207684328986700,72,75,70,350,3,280
-2.9208005889664100,16,25,190,275,9,85
-2.920994851734990,16,25,180,250,9,70
-2.921239564943400,62,65,180,500,3,320
-2.9212656063749400,46,50,70,425,4,355
-2.921302261825800,18,25,80,250,7,170
-2.921461473206140,66,70,70,150,4,80
-2.9214857869092800,46,50,140,225,4,85
-2.9214916578672600,72,75,100,325,3,225
-2.92153695740153,30,35,100,475,5,375
-2.9215786707094200,72,75,200,325,3,125
-2.9215861642194900,46,50,90,375,4,285
-2.9217927164089000,62,70,90,100,8,10
-2.9218440660266700,46,50,70,275,4,205
-2.9219034870709000,46,50,150,225,4,75
-2.922034735588180,46,50,60,300,4,240
-2.9221940860006100,16,25,200,275,9,75
-2.922239500506070,46,50,100,250,4,150
-2.9224925221163200,46,50,60,475,4,415
-2.922503221344530,72,75,80,400,3,320
-2.922518512107900,58,65,110,125,7,15
-2.922665547455010,26,35,80,125,9,45
-2.9228884872737000,30,35,130,225,5,95
-2.9229489179965400,46,50,170,300,4,130
-2.922949618106590,72,75,120,375,3,255
-2.923339693534050,72,75,120,275,3,155
-2.92344269448201,72,75,190,300,3,110
-2.9236777558902200,46,50,60,500,4,440
-2.9236806864072200,72,75,50,325,3,275
-2.9239105211833100,30,35,50,450,5,400
-2.9239957781632000,72,75,50,300,3,250
-2.924081912075120,22,30,80,175,8,95
-2.924148776094610,22,30,50,150,8,100
-2.9243497789877300,46,50,90,275,4,185
-2.924390488240530,72,75,100,350,3,250
-2.9245099267591900,46,50,160,375,4,215
-2.92474322330156,44,50,60,125,6,65
-2.924978147055750,92,95,110,175,3,65
-2.925116333743970,82,85,180,275,3,95
-2.925419772348960,46,50,70,350,4,280
-2.92551424148897,40,45,120,200,5,80
-2.9255895786944500,86,90,200,225,4,25
-2.925659279954210,72,75,90,325,3,235
-2.925696946176360,30,35,130,450,5,320
-2.9257313060487100,90,95,110,125,5,15
-2.9260837626632400,46,50,80,275,4,195
-2.9261058008024300,44,50,70,125,6,55
-2.9261498613791000,34,40,120,175,6,55
-2.926196559964360,46,50,80,350,4,270
-2.926712897394930,46,50,180,325,4,145
-2.926900511211820,72,75,100,375,3,275
-2.927125396828790,56,65,170,175,9,5
-2.927142821266400,30,35,160,350,5,190
-2.9272961837966600,30,35,120,475,5,355
-2.9275323326301600,80,85,100,125,5,25
-2.9277004215635000,24,30,200,475,6,275
-2.928216359513910,46,50,200,375,4,175
-2.928223340511390,82,85,120,300,3,180
-2.928476729012290,46,50,190,375,4,185
-2.9285624723777700,72,75,110,275,3,165
-2.9286255455224400,18,25,180,500,7,320
-2.9289877742986400,72,75,70,400,3,330
-2.929119902406670,46,50,140,350,4,210
-2.929294968873050,74,80,110,125,6,15
-2.929305541405350,92,95,90,175,3,85
-2.929534896102380,72,75,100,300,3,200
-2.9295537002750500,38,45,80,125,7,45
-2.9299164425236000,54,60,100,125,6,25
-2.930139984754120,18,25,50,350,7,300
-2.930225601166870,30,35,160,325,5,165
-2.930242381610000,46,50,160,450,4,290
-2.930493086020760,16,25,130,200,9,70
-2.9307122045306700,92,95,50,150,3,100
-2.930753622813240,30,35,60,400,5,340
-2.9307607538316900,46,50,120,250,4,130
-2.9308448899177400,46,50,200,350,4,150
-2.9308486393382400,30,35,50,475,5,425
-2.930919572563100,18,25,120,450,7,330
-2.9312080807035100,46,50,80,225,4,145
-2.931322412308280,18,25,50,425,7,375
-2.931799653624780,30,35,140,500,5,360
-2.9319009228766400,16,25,90,200,9,110
-2.9319687458522100,32,40,80,125,8,45
-2.9320972554536600,72,75,50,250,3,200
-2.9322627845099500,30,35,60,375,5,315
-2.9323642039516000,30,35,110,475,5,365
-2.9328772353204300,96,100,90,125,4,35
-2.932968992716440,40,45,50,175,5,125
-2.9333478412889200,24,30,190,500,6,310
-2.933606383868290,18,25,70,225,7,155
-2.9337244759019300,46,50,180,300,4,120
-2.9339596068830700,46,50,190,325,4,135
-2.934014157495490,86,90,110,150,4,40
-2.934486083104630,42,50,70,100,8,30
-2.9345370959589700,30,35,100,425,5,325
-2.9347471308382100,46,50,110,400,4,290
-2.935057245500740,30,35,150,400,5,250
-2.935149369898110,56,60,50,150,4,100
-2.93518322520069,46,50,80,400,4,320
-2.935629950538520,76,80,120,150,4,30
-2.9359351302318400,62,65,170,475,3,305
-2.936141049648900,30,35,180,425,5,245
-2.9363346280464700,84,90,110,125,6,15
-2.9364321552582600,46,50,110,250,4,140
-2.936619564390920,30,35,130,475,5,345
-2.936880588947210,72,75,150,300,3,150
-2.937046222072090,18,25,90,500,7,410
-2.937124420719760,92,100,170,175,8,5
-2.9372337069747600,46,50,110,350,4,240
-2.9373306495847600,46,50,80,425,4,345
-2.937360194250660,76,80,150,175,4,25
-2.9377027065488400,22,30,190,225,8,35
-2.937861130233280,56,60,100,175,4,75
-2.9378640084790800,30,35,170,425,5,255
-2.9379183684222400,72,75,150,375,3,225
-2.9383605887459600,30,35,160,475,5,315
-2.93853229233396,62,65,90,500,3,410
-2.9385885605182500,30,35,70,375,5,305
-2.938690278392850,46,50,70,400,4,330
-2.938737801041500,72,75,60,250,3,190
-2.9387664780889900,72,75,70,325,3,255
-2.93883054386528,46,50,100,275,4,175
-2.9390024911415300,30,35,190,350,5,160
-2.9391004343513100,30,35,90,225,5,135
-2.939135170708370,30,35,90,450,5,360
-2.939519886937890,30,35,200,300,5,100
-2.9395834476676200,18,25,160,500,7,340
-2.9396386172913200,30,35,200,400,5,200
-2.9397046256421700,62,65,120,450,3,330
-2.9398447971317600,62,65,100,500,3,400
-2.939848899933680,46,50,200,325,4,125
-2.9398506497052600,82,85,170,225,3,55
-2.9403243713381400,66,70,80,150,4,70
-2.940535436642590,56,60,170,200,4,30
-2.9406683399891100,50,55,200,225,5,25
-2.9407263788894900,30,35,100,225,5,125
-2.9407275799551000,28,35,110,150,7,40
-2.940826570695370,82,85,200,275,3,75
-2.940922083728670,62,65,90,475,3,385
-2.941138389575100,30,35,140,275,5,135
-2.9411538346708500,72,75,160,275,3,115
-2.9412115798449100,36,45,80,100,9,20
-2.9415821701916200,72,75,130,275,3,145
-2.941719756199930,46,50,70,200,4,130
-2.9417734575550100,46,50,60,450,4,390
-2.941789030495330,30,35,160,300,5,140
-2.9419543086715500,30,35,170,300,5,130
-2.9419777302009900,30,35,90,350,5,260
-2.942095041264960,30,35,130,400,5,270
-2.942300783793400,72,75,110,225,3,115
-2.942305861933270,50,55,100,150,5,50
-2.9425198610651800,18,25,200,450,7,250
-2.9427368509872300,30,35,120,425,5,305
-2.943074036617490,30,35,80,475,5,395
-2.9431003643914600,46,50,120,350,4,230
-2.9431092167428500,46,50,110,300,4,190
-2.943391962904340,46,50,160,275,4,115
-2.9433964849234700,18,25,50,400,7,350
-2.9435170221354100,32,40,160,175,8,15
-2.94373413039191,46,50,100,350,4,250
-2.943761018940110,72,75,50,225,3,175
-2.9438323349433900,18,25,90,250,7,160
-2.943913087132240,40,45,130,200,5,70
-2.9440614402428200,72,75,170,250,3,80
-2.94407368379696,30,35,50,275,5,225
-2.9444000515940600,72,75,140,300,3,160
-2.9447864498593700,24,30,120,450,6,330
-2.944894960352990,18,25,100,500,7,400
-2.9449069768076700,72,75,130,300,3,170
-2.9450470180954800,68,75,140,150,7,10
-2.9451305650742400,30,35,120,400,5,280
-2.9451329576380500,62,65,50,375,3,325
-2.945164611586310,46,50,190,300,4,110
-2.94533769186021,30,35,110,450,5,340
-2.9453970322399000,18,25,100,450,7,350
-2.9454134315879200,30,35,70,450,5,380
-2.9454414295896800,30,35,80,375,5,295
-2.9454983981505700,92,95,170,200,3,30
-2.945558071254500,82,85,150,200,3,50
-2.945596940929060,80,85,190,200,5,10
-2.945874352808410,46,50,110,225,4,115
-2.945909518785800,46,50,130,350,4,220
-2.9459238160969600,46,50,150,375,4,225
-2.945957080420940,62,65,160,500,3,340
-2.946015668491350,30,35,90,300,5,210
-2.946054264799340,40,45,60,175,5,115
-2.946064786951160,30,35,90,400,5,310
-2.946078921833490,76,80,70,125,4,55
-2.946288992223580,46,50,120,375,4,255
-2.9463307878454100,30,35,150,475,5,325
-2.9463621228917100,72,75,60,225,3,165
-2.9463753778540300,46,50,110,275,4,165
-2.946457691486270,46,50,100,325,4,225
-2.946531985527360,30,35,180,450,5,270
-2.946533186102270,70,75,190,200,5,10
-2.946815709006700,66,75,170,175,9,5
-2.9469379923569300,30,35,130,250,5,120
-2.9470819118250500,30,35,140,250,5,110
-2.9471628447572800,16,25,60,175,9,115
-2.9473527845712300,46,50,100,300,4,200
-2.947429699599880,50,55,90,150,5,60
-2.9474365064206300,60,65,80,125,5,45
-2.9474921964858900,62,65,170,350,3,180
-2.947642551621660,22,30,100,175,8,75
-2.947781613638190,18,25,130,225,7,95
-2.947795367670110,30,35,130,425,5,295
-2.94782275012013,30,35,80,275,5,195
-2.947854691424200,30,35,150,225,5,75
-2.9478825781527400,56,60,120,175,4,55
-2.947910998563830,18,25,170,350,7,180
-2.948003147188500,28,35,180,200,7,20
-2.94822261837788,92,95,100,175,3,75
-2.9482727776675100,72,75,150,250,3,100
-2.9483222124738400,30,35,170,450,5,280
-2.948331183077050,34,40,70,150,6,80
-2.948352438698350,82,85,60,200,3,140
-2.9484984479251000,86,90,60,125,4,65
-2.9485390770433800,30,35,90,375,5,285
-2.9485469048871300,82,85,80,200,3,120
-2.948812622851180,46,50,120,275,4,155
-2.9488542070690500,30,35,70,275,5,205
-2.949125078159760,40,45,140,200,5,60
-2.94923565139996,48,55,70,100,7,30
-2.949272074231010,30,35,140,425,5,285
-2.9493137168879900,18,25,160,350,7,190
-2.949508437667890,62,65,150,500,3,350
-2.94972780126141,46,50,50,300,4,250
-2.9499566975220400,46,50,150,300,4,150
-2.950244841807840,30,35,180,400,5,220
-2.950257430472090,30,35,70,475,5,405
-2.950301804371830,46,50,100,375,4,275
-2.950754203816340,24,30,190,475,6,285
-2.9509205071378000,86,90,70,125,4,55
-2.9511877029645100,18,25,120,225,7,105
-2.951335269296680,30,35,200,425,5,225
-2.9514156110328300,16,25,70,175,9,105
-2.951649808816830,50,55,130,175,5,45
-2.9516676087783900,72,75,70,300,3,230
-2.9518277077727600,30,35,100,250,5,150
-2.951850172561990,30,35,80,225,5,145
-2.952006546438170,30,35,150,425,5,275
-2.952127957171150,56,60,200,250,4,50
-2.952168984388240,30,35,200,350,5,150
-2.952187708666480,30,35,140,400,5,260
-2.9522578454640700,30,35,80,500,5,420
-2.952404183799280,72,75,80,325,3,245
-2.9524148522852900,16,25,140,200,9,60
-2.952757303039860,62,65,200,450,3,250
-2.952813846197420,18,25,50,450,7,400
-2.9530934808627200,30,35,150,325,5,175
-2.9533379052139600,30,35,180,375,5,195
-2.9533644293870600,72,75,150,275,3,125
-2.9533868488321500,66,70,100,150,4,50
-2.953577494719680,46,50,70,325,4,255
-2.9538135911090100,72,75,60,275,3,215
-2.953929287600960,30,35,80,450,5,370
-2.953950727262470,56,60,190,225,4,35
-2.9540879392715400,46,50,80,325,4,245
-2.9541124444050000,30,35,150,450,5,300
-2.9542173709541800,26,35,160,175,9,15
-2.954310495642260,30,35,150,350,5,200
-2.9544420534685600,72,75,110,300,3,190
-2.954473836579240,18,25,60,425,7,365
-2.954546255020540,18,25,60,325,7,265
-2.954585788727680,78,85,90,100,7,10
-2.954632171489210,18,25,60,350,7,290
-2.954780074019860,36,45,110,125,9,15
-2.9547803077508800,46,50,90,325,4,235
-2.9549973651614100,62,65,160,425,3,265
-2.955380369221130,62,65,170,500,3,330
-2.9555988200563100,30,35,140,450,5,310
-2.9557062694291300,18,25,60,375,7,315
-2.955928442753380,30,35,140,225,5,85
-2.9561306384268500,30,35,70,250,5,180
-2.956184111931100,18,25,170,400,7,230
-2.9562531039129800,46,50,70,300,4,230
-2.9563167282309200,30,35,190,425,5,235
-2.95635672711675,46,50,110,375,4,265
-2.956410231736240,24,30,180,500,6,320
-2.9568554249722400,46,50,170,250,4,80
-2.956861514949920,46,50,60,225,4,165
-2.9572033988637100,30,35,60,300,5,240
-2.9572350190241200,72,75,70,200,3,130
-2.9572381407225300,52,60,140,150,8,10
-2.957395571291790,32,40,130,150,8,20
-2.9579417671653000,38,45,90,125,7,35
-2.9583629204582700,30,35,130,375,5,245
-2.9583781585952900,30,35,60,475,5,415
-2.9585240722826500,18,25,50,500,7,450
-2.9585817108405800,46,50,50,225,4,175
-2.9586876324383700,46,50,50,325,4,275
-2.9589005650171300,46,50,60,250,4,190
-2.959152084911790,92,95,60,150,3,90
-2.9591968273180100,62,65,170,400,3,230
-2.9592344262744700,82,85,190,275,3,85
-2.9592401443239100,62,65,180,475,3,295
-2.9592946177504100,24,30,100,500,6,400
-2.9594692600222700,62,65,50,425,3,375
-2.9596548413685900,24,30,50,375,6,325
-2.959794922727180,30,35,70,350,5,280
-2.9600572789030600,18,25,90,475,7,385
-2.960096133081070,38,45,130,150,7,20
-2.96015655435992,40,45,110,175,5,65
-2.960163416715560,32,40,90,125,8,35
-2.9601645671400100,62,65,50,400,3,350
-2.960925614964560,30,35,90,275,5,185
-2.961289773108850,82,85,110,200,3,90
-2.9621226196478900,30,35,80,350,5,270
-2.962315526965900,60,65,160,175,5,15
-2.9623231796398100,62,65,100,450,3,350
-2.9623836159241500,24,30,160,500,6,340
-2.9625279928143900,62,65,100,475,3,375
-2.96296348798281,30,35,70,425,5,355
-2.9633717007978700,30,35,120,250,5,130
-2.9634479963614900,38,45,160,175,7,15
-2.9635208766103900,16,25,170,200,9,30
-2.9635708020601800,18,25,50,475,7,425
-2.9636928328510500,76,80,50,100,4,50
-2.9637199593416800,72,75,140,325,3,185
-2.9637492550871800,62,65,120,500,3,380
-2.963813099698660,72,75,120,325,3,205
-2.963904078932910,96,100,50,100,4,50
-2.96393704779514,30,35,100,400,5,300
-2.9642929723590000,46,50,150,275,4,125
-2.9643105210868800,18,25,170,500,7,330
-2.9646829311271800,62,65,90,400,3,310
-2.9648448984195600,62,70,170,175,8,5
-2.964860584019370,24,30,170,500,6,330
-2.965098268136780,46,50,140,300,4,160
-2.9651360415862900,30,35,60,500,5,440
-2.9652541067748600,40,45,70,175,5,105
-2.9653556349248900,82,85,90,200,3,110
-2.9654651015791600,30,35,160,375,5,215
-2.965485803626430,18,25,170,475,7,305
-2.965801181170850,30,35,190,325,5,135
-2.965820464477500,24,30,90,500,6,410
-2.9661091695254400,66,70,90,150,4,60
-2.9661235497619800,62,65,50,500,3,450
-2.96622742028804,62,65,190,450,3,260
-2.9664456390929700,30,35,160,450,5,290
-2.96656052225065,62,65,140,500,3,360
-2.966601763330630,62,65,90,250,3,160
-2.966725233840180,30,35,140,475,5,335
-2.966767436092260,18,25,160,425,7,265
-2.9672076709773700,66,70,130,175,4,45
-2.967217776431040,30,35,90,425,5,335
-2.9673198086709400,62,65,160,400,3,240
-2.967686988341810,30,35,190,400,5,210
-2.968001310888290,92,95,190,225,3,35
-2.968016401818120,26,35,90,125,9,35
-2.968051623269220,22,30,60,150,8,90
-2.9680822545860900,72,75,80,300,3,220
-2.968538540850950,60,65,130,150,5,20
-2.968592125432980,46,50,50,250,4,200
-2.968991028454790,18,25,70,500,7,430
-2.968992767412660,30,35,180,350,5,170
-2.969054633163610,18,25,150,500,7,350
-2.9692143449543000,24,30,60,425,6,365
-2.9694627769319100,62,65,170,325,3,155
-2.9695654769728600,62,65,50,350,3,300
-2.9696959137593800,30,35,140,375,5,235
-2.969809716077170,72,75,110,325,3,215
-2.970077803042330,62,65,70,225,3,155
-2.970191427737040,72,75,170,275,3,105
-2.970241199470020,30,35,110,425,5,315
-2.9703469527827,46,50,150,250,4,100
-2.970349418032120,24,30,170,350,6,180
-2.9703710450369600,46,50,60,275,4,215
-2.9707562594822300,62,65,130,500,3,370
-2.970856440437150,62,65,130,475,3,345
-2.9709350257982200,62,65,50,475,3,425
-2.971317750436220,24,30,50,425,6,375
-2.97132548550512,62,65,110,500,3,390
-2.9713547966342600,30,35,200,325,5,125
-2.971509811257130,34,40,80,150,6,70
-2.9716553337172100,62,65,130,225,3,95
-2.97168543511208,24,30,50,350,6,300
-2.9716918670760300,72,75,160,250,3,90
-2.9716937681153900,34,40,100,150,6,50
-2.9718183497185700,18,25,100,475,7,375
-2.9718366455759700,50,55,50,125,5,75
-2.9719008274459500,72,75,160,225,3,65
-2.972064854911570,72,75,130,325,3,195
-2.972235894761630,62,65,60,375,3,315
-2.972249813372570,46,50,80,300,4,220
-2.9725213737605000,50,55,140,175,5,35
-2.972729675294400,54,60,70,100,6,30
-2.9728051042104900,18,25,110,500,7,390
-2.9728101874630800,60,65,90,125,5,35
-2.9730760886381500,62,65,160,475,3,315
-2.9731749394938500,34,40,200,225,6,25
-2.9732207682557700,82,85,180,250,3,70
-2.9732854738241500,62,65,150,425,3,275
-2.9733168204084900,18,25,180,475,7,295
-2.973510441506440,18,25,100,425,7,325
-2.9735141113756000,30,35,50,300,5,250
-2.973559714879080,18,25,140,225,7,85
-2.973844342880320,62,65,170,375,3,205
-2.9738666317323500,62,65,50,450,3,400
-2.9739853400798800,22,30,120,175,8,55
-2.974031146091900,18,25,60,300,7,240
-2.974077970222150,66,70,50,125,4,75
-2.974267766909850,62,65,170,425,3,255
-2.9744003930509100,92,95,200,250,3,50
-2.9746197630926500,30,35,200,375,5,175
-2.974668231786840,30,35,100,275,5,175
-2.9747634446298700,18,25,160,325,7,165
-2.974979300116610,86,90,150,175,4,25
-2.974998583024680,46,50,130,275,4,145
-2.975023207635270,30,35,50,225,5,175
-2.975064776200570,62,65,80,250,3,170
-2.9752526721623200,28,35,120,150,7,30
-2.9752607846581300,24,30,200,450,6,250
-2.9754973988853700,62,65,130,450,3,320
-2.975998134072620,62,65,60,425,3,365
-2.9761144792400000,18,25,120,500,7,380
-2.9763924245307500,92,95,120,175,3,55
-2.9764889355437100,62,65,60,350,3,290
-2.976638938252510,30,35,110,225,5,115
-2.9767565677105700,18,25,90,350,7,260
-2.9767631961875100,18,25,170,325,7,155
-2.976954856056100,18,25,150,225,7,75
-2.9773487747216300,18,25,50,275,7,225
-2.9773656324739100,86,90,180,200,4,20
-2.9775217740529100,62,65,160,350,3,190
-2.977595296549710,30,35,60,225,5,165
-2.977647033801970,26,35,130,150,9,20
-2.9776850874911700,62,65,100,425,3,325
-2.977922190935330,62,65,120,475,3,355
-2.9779859174826500,62,65,150,450,3,300
-2.977989239701710,88,95,170,175,7,5
-2.9780287751541000,62,65,130,400,3,270
-2.9782404236747000,46,55,90,100,9,10
-2.9782421056601100,56,60,60,150,4,90
-2.978558301719160,18,25,70,375,7,305
-2.9786633575375100,82,85,50,200,3,150
-2.9787320574866200,24,30,100,475,6,375
-2.9788935999444000,62,65,70,500,3,430
-2.979060335889860,46,50,110,325,4,215
-2.97908889452387,40,45,80,175,5,95
-2.979252414316610,18,25,80,275,7,195
-2.9792579348055000,86,90,120,150,4,30
-2.9795313668961700,82,85,100,200,3,100
-2.9795824856534800,44,50,80,125,6,45
-2.979587469474500,62,65,90,450,3,360
-2.979763038872110,62,65,180,425,3,245
-2.9798149013411400,30,35,180,325,5,145
-2.9802609437524400,66,70,200,225,4,25
-2.9808085939309800,30,35,110,400,5,290
-2.980956514330480,62,65,120,400,3,280
-2.981046122660580,24,30,180,475,6,295
-2.9811621911111600,62,65,120,425,3,305
-2.9812593189648400,18,25,70,475,7,405
-2.9813168603378500,82,85,120,200,3,80
-2.981550964940420,18,25,130,400,7,270
-2.981632767708970,62,65,140,400,3,260
-2.9817457197727000,24,30,120,500,6,380
-2.981866979063350,72,75,180,275,3,95
-2.9818757327286900,46,50,160,250,4,90
-2.981883137482140,18,25,190,450,7,260
-2.982293032075300,82,85,180,225,3,45
-2.9823945168437900,24,30,90,475,6,385
-2.9824648952355500,24,30,50,400,6,350
-2.9826057917789900,30,35,190,375,5,185
-2.9827329684240000,30,35,70,300,5,230
-2.982799593314480,30,35,60,275,5,215
-2.982922593859350,62,65,150,400,3,250
-2.983047736974910,46,50,160,225,4,65
-2.9831075086330900,62,65,180,375,3,195
-2.9831661126853800,30,35,70,400,5,330
-2.9831682061609800,18,25,170,375,7,205
-2.983180542745750,30,35,120,350,5,230
-2.983188899155030,32,40,190,200,8,10
-2.983463521951820,46,50,130,300,4,170
-2.983534773065950,30,35,60,450,5,390
-2.9837180251932300,30,35,90,325,5,235
-2.983915328764110,62,65,110,475,3,365
-2.984081203084300,24,30,80,250,6,170
-2.9843843835304900,18,25,130,450,7,320
-2.9845123882380800,18,25,160,400,7,240
-2.984732254344250,62,65,180,450,3,270
-2.9849555882298800,24,30,130,225,6,95
-2.9851031165464900,62,65,70,475,3,405
-2.98512036794836,30,35,100,375,5,275
-2.9851928598445500,18,25,100,225,7,125
-2.9852209810664200,24,30,100,450,6,350
-2.9855142001409500,46,50,120,325,4,205
-2.9855346118864600,24,30,50,475,6,425
-2.9855661149748200,24,30,170,475,6,305
-2.9856726585903800,44,50,50,100,6,50
-2.9857083748761400,46,50,140,325,4,185
-2.985798924323440,24,30,150,500,6,350
-2.9858796270817100,30,35,80,425,5,345
-2.985902292703890,30,35,110,250,5,140
-2.98598909681336,18,25,90,225,7,135
-2.9860488633739200,24,30,90,250,6,160
-2.9861060371348700,18,25,140,500,7,360
-2.98637139603281,18,25,130,500,7,370
-2.986427214423320,18,25,90,450,7,360
-2.9865617368602500,30,35,100,350,5,250
-2.9865928496922800,62,65,200,400,3,200
-2.9865949270981800,92,95,70,150,3,80
-2.9867110747032900,62,65,120,225,3,105
-2.9868464081232500,18,25,120,475,7,355
-2.987343902934040,24,30,70,225,6,155
-2.987357694252000,30,35,110,350,5,240
-2.987408513224280,16,25,80,175,9,95
-2.9875315967573200,24,30,110,500,6,390
-2.9875419217858400,40,45,170,200,5,30
-2.987601401937610,22,30,200,250,8,50
-2.9876229995897200,62,65,150,475,3,325
-2.987890268416260,24,30,60,375,6,315
-2.9879424063877400,30,35,50,250,5,200
-2.988644980669080,62,65,160,300,3,140
-2.9888020498681700,18,25,60,400,7,340
-2.9888345966784200,24,30,120,225,6,105
-2.9889427673413100,18,25,70,250,7,180
-2.9890552626163000,62,65,90,350,3,260
-2.9891594749414800,62,65,160,325,3,165
-2.9892181278438000,62,65,140,450,3,310
-2.9892702937484300,72,75,120,300,3,180
-2.989314157785290,46,50,170,275,4,105
-2.989331963789670,82,85,140,200,3,60
-2.989398637545470,46,50,170,225,4,55
-2.9894695141034000,24,30,160,425,6,265
-2.989470430811860,18,25,140,250,7,110
-2.9897198747296100,40,45,90,175,5,85
-2.9898323419458900,30,35,180,300,5,120
-2.9898843468980400,24,30,190,450,6,260
-2.9899483523659200,30,35,100,300,5,200
-2.9899606916822400,62,65,60,325,3,265
-2.9899662037159100,18,25,170,425,7,255
-2.990152100916410,22,30,70,150,8,80
-2.9901721535475600,24,30,170,400,6,230
-2.9903029765587000,62,65,50,275,3,225
-2.9904884487157900,30,35,50,325,5,275
-2.9905475417804600,30,35,70,325,5,255
-2.990712656601080,24,30,160,475,6,315
-2.9907959181875900,66,70,140,175,4,35
-2.9908202702015600,82,85,160,200,3,40
-2.990914211894610,30,35,100,325,5,225
-2.991134157200190,82,85,50,175,3,125
-2.99136892795327,96,100,160,175,4,15
-2.9915999287450400,46,50,150,200,4,50
-2.991606247041560,62,65,200,300,3,100
-2.9917265140697200,30,35,120,275,5,155
-2.9922406134554600,82,85,130,200,3,70
-2.9922737394735800,72,80,170,175,8,5
-2.992441599399390,24,30,130,500,6,370
-2.9926025806884000,18,25,70,450,7,380
-2.9926518732165400,30,35,140,350,5,210
-2.992765093637920,62,65,190,425,3,235
-2.992942882595290,34,40,90,150,6,60
-2.993114148693080,62,65,200,425,3,225
-2.9931411969595500,18,25,160,475,7,315
-2.99348843338485,30,35,80,400,5,320
-2.993512172138820,18,25,110,475,7,365
-2.9936253526454000,18,25,130,475,7,345
-2.993784301637480,98,105,90,100,7,10
-2.9937955273293800,24,30,60,350,6,290
-2.993826011525770,62,65,110,450,3,340
-2.9938316261036900,24,30,70,500,6,430
-2.9940469630443000,62,65,190,400,3,210
-2.9941254576025900,62,65,70,450,3,380
-2.994222029715750,18,25,130,250,7,120
-2.994258774119250,30,35,190,300,5,110
-2.9944057189747200,18,25,90,400,7,310
-2.994500105822550,70,75,100,125,5,25
-2.9945527152425700,24,30,50,450,6,400
-2.9946400331517200,72,75,150,200,3,50
-2.9953759981060700,18,25,80,225,7,145
-2.995549142012540,62,65,80,450,3,370
-2.995885365246860,18,25,200,400,7,200
-2.9959651040972800,38,45,60,100,7,40
-2.9960246811543700,18,25,200,300,7,100
-2.996083572560960,24,30,120,475,6,355
-2.9961404414693000,62,65,130,425,3,295
-2.9963790474750300,62,65,70,375,3,305
-2.99641572063062,100,105,80,100,5,20
-2.996531378925020,24,30,160,325,6,165
-2.9967195402644700,56,60,80,150,4,70
-2.9967254198052000,96,100,130,150,4,20
-2.996850753204430,50,55,110,150,5,40
-2.9969464975562500,24,30,60,400,6,340
-2.9970026526298000,62,65,100,225,3,125
-2.9972662620602300,36,40,200,500,4,300
-2.9975775565225200,40,45,190,250,5,60
-2.997743719289250,62,65,190,375,3,185
-2.9978543721124200,24,30,60,325,6,265
-2.9979391657564200,62,65,200,350,3,150
-2.99800159849008,24,30,50,500,6,450
-2.9980141529501800,62,65,170,300,3,130
-2.998100612437720,62,65,130,375,3,245
-2.9983788263354500,72,75,60,200,3,140
-2.998400486414580,62,65,150,325,3,175
-2.998460546809310,30,35,80,325,5,245
-2.998671903188420,62,65,60,400,3,340
-2.998694312006220,16,25,50,150,9,100
-2.998854587352780,18,25,150,350,7,200
-2.9988893117821900,30,35,120,375,5,255
-2.999154350145320,62,65,180,400,3,220
-2.9992845083932400,18,25,70,275,7,205
-2.9992859659968300,34,40,140,175,6,35
-2.9994516025080300,72,75,80,200,3,120
-2.9994921409572900,30,35,160,275,5,115
-2.9996073218831000,46,50,130,325,4,195
-2.9996749030723300,62,65,190,350,3,160
-2.9998523274859600,62,65,110,425,3,315
-3.000393645939810,16,25,90,175,9,85
-3.0004605443420000,72,75,180,250,3,70
-3.0004979057536300,18,25,170,300,7,130
-3.0005391833238400,62,65,170,450,3,280
-3.0009367810099000,62,65,150,350,3,200
-3.001067962992740,62,65,80,500,3,420
-3.0011185055527400,62,65,80,225,3,145
-3.001157132817800,62,65,140,425,3,285
-3.001193438973590,18,25,110,450,7,340
-3.001197983571640,82,85,60,175,3,115
-3.0012028544711100,50,55,180,200,5,20
-3.0013482467764400,24,30,100,425,6,325
-3.001405101435480,18,25,180,425,7,245
-3.0014443434870700,18,25,50,300,7,250
-3.001581043266670,62,65,90,425,3,335
-3.0015965398929400,62,65,80,475,3,395
-3.0016193335694100,18,25,90,275,7,185
-3.001656872433680,72,75,200,275,3,75
-3.0017114338904200,62,65,180,350,3,170
-3.001770825045510,18,25,120,250,7,130
-3.002524589409220,18,25,120,425,7,305
-3.002585053700590,18,25,180,400,7,220
-3.0026440249948300,52,60,90,100,8,10
-3.002666323960660,92,95,80,150,3,70
-3.0026844517850200,30,35,70,200,5,130
-3.0028647990098600,28,35,150,175,7,25
-3.0032276966445500,18,25,160,300,7,140
-3.0033726244233200,24,30,170,325,6,155
-3.0036657697674,18,25,150,400,7,250
-3.0040945496229900,18,25,180,450,7,270
-3.0043463830790600,30,35,60,250,5,190
-3.004388330769860,62,65,130,250,3,120
-3.0046535552287800,72,75,170,225,3,55
-3.0047523181459600,24,30,160,350,6,190
-3.0048346455814600,24,30,170,375,6,205
-3.0051389101036900,62,65,90,375,3,285
-3.005147941115860,24,30,50,275,6,225
-3.0053404228677000,34,40,130,175,6,45
-3.005772180030090,24,30,100,225,6,125
-3.0060903031621100,30,35,170,250,5,80
-3.006186009178380,24,30,140,500,6,360
-3.006362391382810,30,35,110,275,5,165
-3.0063955094848200,24,30,70,450,6,380
-3.0066033801981700,24,30,170,425,6,255
-3.006615067520290,18,25,130,425,7,295
-3.0066217951694700,18,25,190,325,7,135
-3.007446163943260,62,65,70,250,3,180
-3.007539970277730,28,35,60,125,7,65
-3.007629739985410,62,65,100,375,3,275
-3.0076350034555200,18,25,120,400,7,280
-3.0078115936519700,18,25,170,450,7,280
-3.0079022104918200,18,25,150,450,7,300
-3.0079807403567100,18,25,50,225,7,175
-3.008003999408540,62,65,140,475,3,335
-3.0080461207376200,62,65,90,225,3,135
-3.0080666100978500,16,25,190,250,9,60
-3.0082781034059300,46,50,120,300,4,180
-3.0086126521973300,18,25,160,375,7,215
-3.0087017186384600,24,30,180,425,6,245
-3.0087314820661100,18,25,80,450,7,370
-3.0088077150923500,36,40,200,475,4,275
-3.0088591183253400,62,65,80,375,3,295
-3.008911734076050,18,25,90,300,7,210
-3.008982857414590,16,25,190,225,9,35
-3.0089926564526400,62,65,140,375,3,235
-3.0090562341288200,40,45,100,175,5,75
-3.0091230995094300,24,30,130,400,6,270
-3.009245237049130,28,35,70,125,7,55
-3.0093500620089800,18,25,200,425,7,225
-3.009350146204930,76,80,80,125,4,45
-3.009690475351060,30,35,150,300,5,150
-3.0098717976706400,18,25,80,375,7,295
-3.0103270290530600,18,25,80,500,7,420
-3.010536041279990,72,75,50,200,3,150
-3.0109504199791000,30,35,110,300,5,190
-3.0111080607572400,40,45,50,150,5,100
-3.0111512878407000,18,25,70,425,7,355
-3.0112738006437400,30,35,130,350,5,220
-3.011352153073090,32,40,60,100,8,40
-3.0117000637749900,62,65,160,375,3,215
-3.0117993892497000,18,25,100,250,7,150
-3.0118146641615500,62,65,80,350,3,270
-3.0120884557308400,30,35,110,375,5,265
-3.0123138442441400,30,35,150,275,5,125
-3.0125440607273700,34,40,50,125,6,75
-3.012897439657380,62,65,180,300,3,120
-3.013001090387490,18,25,80,350,7,270
-3.0133298389456700,74,80,140,150,6,10
-3.0133725135667000,24,30,130,250,6,120
-3.013749958660600,62,65,140,250,3,110
-3.0138522010524700,18,25,90,375,7,285
-3.013999051700780,62,65,60,300,3,240
-3.014194457456420,24,30,160,400,6,240
-3.0143594850422600,18,25,80,475,7,395
-3.0144895652153900,30,35,140,300,5,160
-3.014743182780230,24,30,90,225,6,135
-3.014778478730170,24,30,70,375,6,305
-3.0148197204944000,72,75,110,200,3,90
-3.0148392167342800,24,30,130,475,6,345
-3.0150119240326100,24,30,60,300,6,240
-3.0151177082466000,62,65,150,225,3,75
-3.015336251133630,24,30,70,475,6,405
-3.015540556064700,18,25,140,450,7,310
-3.0155512805319600,18,25,180,325,7,145
-3.0155976411274600,18,25,150,325,7,175
-3.0157020316994100,62,65,70,275,3,205
-3.0157458168421600,30,35,80,300,5,220
-3.015841288612370,60,65,60,100,5,40
-3.0158868327196300,56,60,70,150,4,80
-3.015956728153450,24,30,150,425,6,275
-3.016058744250370,24,30,200,400,6,200
-3.0161329022443700,62,65,140,275,3,135
-3.016174545076330,24,30,90,450,6,360
-3.016218722245560,24,30,90,350,6,260
-3.0165636447093000,18,25,140,275,7,135
-3.0166012205024,82,90,170,175,8,5
-3.016818853758760,24,30,110,475,6,365
-3.01699535850611,62,65,70,425,3,355
-3.0171315431879500,18,25,130,375,7,245
-3.0171448052654900,24,30,200,300,6,100
-3.0171965170811900,18,25,150,475,7,325
-3.0172421039083400,18,25,140,400,7,260
-3.0172749272005500,44,50,160,175,6,15
-3.017848180161600,62,65,100,250,3,150
-3.0178934008251200,18,25,60,225,7,165
-3.0179185392628300,30,35,150,375,5,225
-3.017929931349460,24,30,70,250,6,180
-3.018027749673370,62,65,110,400,3,290
-3.0180463160108900,36,40,180,500,4,320
-3.0181149787114500,62,65,100,400,3,300
-3.018271390183190,24,30,130,450,6,320
-3.018474596360370,18,25,70,350,7,280
-3.018495934493160,24,30,150,225,6,75
-3.018814491843750,62,65,140,225,3,85
-3.018986704304000,46,50,180,275,4,95
-3.0190381161257900,62,65,190,325,3,135
-3.019412753279910,24,30,120,425,6,305
-3.0194514292557500,18,25,50,325,7,275
-3.0195885280052200,76,80,60,100,4,40
-3.0196426654202800,36,40,190,500,4,310
-3.0197039759366000,24,30,90,400,6,310
-3.019748019358960,62,65,180,325,3,145
-3.0198638512379700,46,50,80,200,4,120
-3.0199125480236600,82,85,70,175,3,105
-3.020452373112290,30,35,160,250,5,90
-3.0205672275353900,24,30,170,450,6,280
-3.0208174349096000,30,35,150,250,5,100
-3.0209244215176300,24,30,130,375,6,245
-3.0210317725395400,18,25,50,250,7,200
-3.0211296485480600,62,65,70,350,3,280
-3.021206765519670,18,25,180,375,7,195
-3.02138009908358,18,25,180,350,7,170
-3.02141801129772,18,25,190,350,7,160
-3.021515717256710,62,65,60,500,3,440
-3.0215430579408500,62,65,200,375,3,175
-3.0215811887657200,62,65,120,375,3,255
-3.0216441238858900,24,30,160,375,6,215
-3.021675168326150,72,75,160,200,3,40
-3.0217877710896700,30,35,150,200,5,50
-3.0220021560949200,24,30,80,350,6,270
-3.022003221329920,24,30,110,450,6,340
-3.0220846127824200,62,65,120,250,3,130
-3.0222930022185700,62,65,60,475,3,415
-3.0223491714672000,62,65,140,350,3,210
-3.022638983149570,24,30,190,425,6,235
-3.022712175586590,18,25,140,425,7,285
-3.0227329259538200,72,75,90,200,3,110
-3.022779876227050,24,30,180,450,6,270
-3.0228827482083300,62,65,200,325,3,125
-3.023007708061470,18,25,190,425,7,235
-3.0230363833278100,62,65,80,425,3,345
-3.023245455929190,18,25,70,200,7,130
-3.0233084153022900,68,75,90,100,7,10
-3.0233583140566200,66,70,110,150,4,40
-3.0234227952491900,34,40,110,150,6,40
-3.023603755517530,24,30,150,400,6,250
-3.0236800714056500,16,25,100,175,9,75
-3.0237233135535200,62,65,90,300,3,210
-3.0237653870027200,62,65,100,325,3,225
-3.02387605091397,18,25,200,350,7,150
-3.023927329396630,18,25,140,375,7,235
-3.023988118561540,18,25,100,275,7,175
-3.024024161145270,86,90,80,125,4,45
-3.024316909586120,18,25,100,400,7,300
-3.0243933648673100,62,65,90,325,3,235
-3.024522576763510,26,35,60,100,9,40
-3.0246040659976300,24,30,140,400,6,260
-3.025178788032980,36,40,190,475,4,285
-3.0252963204443300,66,70,180,200,4,20
-3.0253571409098700,24,30,140,250,6,110
-3.0255981550153700,62,65,60,450,3,390
-3.025677143959440,24,30,140,450,6,310
-3.025683108031350,62,65,160,450,3,290
-3.0258399497198000,72,75,190,275,3,85
-3.025868940392180,62,65,80,275,3,195
-3.025988189357370,24,30,130,425,6,295
-3.0262988987716800,62,65,120,350,3,230
-3.026404996450600,62,65,100,275,3,175
-3.0266512048962900,18,25,100,325,7,225
-3.027159520802350,18,25,60,500,7,440
-3.0271884604298800,24,30,90,275,6,185
-3.027408322217050,18,25,190,300,7,110
-3.0275207644056100,96,100,60,100,4,40
-3.0275373182153800,24,30,160,300,6,140
-3.027545227616420,24,30,170,300,6,130
-3.0276603414288300,30,35,160,225,5,65
-3.0278916466368900,48,55,80,100,7,20
-3.028035473643870,62,65,90,275,3,185
-3.028320264932650,24,30,150,475,6,325
-3.0284336543917200,56,60,200,225,4,25
-3.0285324124068400,62,65,110,350,3,240
-3.028679177314110,70,75,70,100,5,30
-3.02881072966755,18,25,60,475,7,415
-3.0288111959255100,64,70,110,125,6,15
-3.0288519998155200,24,30,90,300,6,210
-3.028891156903810,58,65,140,150,7,10
-3.029146363948350,24,30,80,475,6,395
-3.02946672849378,24,30,200,425,6,225
-3.0294982268041600,18,25,190,400,7,210
-3.0295126675861100,36,45,140,150,9,10
-3.0295943472570700,62,65,50,300,3,250
-3.0296363437663400,82,85,190,250,3,60
-3.029639898732990,24,30,120,400,6,280
-3.029791880586350,72,75,180,225,3,45
-3.029837050800890,62,65,110,250,3,140
-3.0298828415543000,18,25,100,375,7,275
-3.030159594256840,18,25,110,425,7,315
-3.0304826107033600,40,45,200,250,5,50
-3.03055863050262,18,25,70,325,7,255
-3.0308527855914500,24,30,80,275,6,195
-3.031076717374420,62,65,100,350,3,250
-3.0311884721232800,46,50,110,200,4,90
-3.0312541284542400,62,65,150,375,3,225
-3.0317774434208500,24,30,70,425,6,355
-3.031878024956720,44,50,90,125,6,35
-3.031983225285700,46,50,180,250,4,70
-3.0320058946052500,18,25,110,225,7,115
-3.0322159893160200,24,30,110,425,6,315
-3.0323166313487000,40,45,190,225,5,35
-3.0326217633103700,18,25,90,425,7,335
-3.0327790688720700,24,30,80,375,6,295
-3.03278364237347,82,85,50,150,3,100
-3.032786068921530,92,95,100,150,3,50
-3.032911397062010,62,65,80,400,3,320
-3.0329116843568100,24,30,80,500,6,420
-3.033105162930910,24,30,80,225,6,145
-3.033346857964250,24,30,140,425,6,285
-3.0335410309180800,24,30,150,350,6,200
-3.0337365585017700,40,45,60,150,5,90
-3.0340677445329600,18,25,140,475,7,335
-3.0340846018671500,60,65,190,200,5,10
-3.034241491286040,64,70,80,100,6,20
-3.034255611884860,24,30,150,450,6,300
-3.0343598654058700,18,25,150,425,7,275
-3.034364000790500,82,85,80,175,3,95
-3.03445888212787,16,25,60,150,9,90
-3.034472492845810,72,75,100,200,3,100
-3.034540037989030,46,50,60,200,4,140
-3.0346320506015600,24,30,100,400,6,300
-3.034639923068880,24,30,180,400,6,220
-3.0349354441396900,30,35,120,325,5,205
-3.0350399140700700,18,25,180,300,7,120
-3.035192480813610,62,65,150,300,3,150
-3.0358518592550100,18,25,120,350,7,230
-3.0359160432623500,24,30,100,250,6,150
-3.035935057320130,30,35,130,275,5,145
-3.036180769980670,82,85,110,175,3,65
-3.036215673783230,18,25,110,250,7,140
-3.036315374686130,22,30,80,150,8,70
-3.0363732198995500,72,75,50,175,3,125
-3.036377952793420,24,30,200,325,6,125
-3.0365910441835700,30,35,170,225,5,55
-3.037073216456880,24,30,140,275,6,135
-3.0371672839292200,24,30,60,475,6,415
-3.0371705110142500,76,80,130,150,4,20
-3.0371881822903900,28,35,50,100,7,50
-3.037455102871500,24,30,180,375,6,195
-3.0379106579056600,38,45,100,125,7,25
-3.038005281734850,24,30,150,325,6,175
-3.038075264174130,24,30,60,500,6,440
-3.038228566381690,18,25,70,300,7,230
-3.0382599954996100,38,45,190,200,7,10
-3.03826011614993,24,30,140,475,6,335
-3.0386247657876600,36,40,100,500,4,400
-3.0386798949056700,18,25,200,375,7,175
-3.0386807750281100,24,30,80,450,6,370
-3.038737166757150,46,50,200,275,4,75
-3.0390005991529600,26,35,190,200,9,10
-3.0394990670140300,24,30,190,400,6,210
-3.039688112493530,30,35,140,325,5,185
-3.039834283865460,66,70,150,175,4,25
-3.039945463215510,18,25,160,275,7,115
-3.0408148736451800,62,65,100,300,3,200
-3.040998768012550,18,25,60,250,7,190
-3.0411120239985200,24,30,50,300,6,250
-3.0412691783549500,36,40,160,500,4,340
-3.0413190335815300,30,35,170,275,5,105
-3.041333662805090,24,30,190,350,6,160
-3.04154162488134,18,25,80,400,7,320
-3.041559147546340,24,30,140,225,6,85
-3.041559162755820,24,30,120,250,6,130
-3.0415613294194300,18,25,200,325,7,125
-3.0415727452709800,44,50,130,150,6,20
-3.0416025763682900,46,50,90,200,4,110
-3.0417699840793600,18,25,80,325,7,245
-3.041775196496460,22,30,100,150,8,50
-3.042135416006710,62,65,120,275,3,155
-3.0422949270755400,18,25,190,375,7,185
-3.042476876358570,62,65,70,400,3,330
-3.042534472511650,30,35,130,300,5,170
-3.0425924297321700,18,25,60,275,7,215
-3.0426790247083000,46,50,190,275,4,85
-3.04269061710926,18,25,60,450,7,390
-3.0427010853399400,90,95,140,150,5,10
-3.0427610375989200,24,30,190,325,6,135
-3.042792024643680,30,35,180,275,5,95
-3.0430417553996400,62,65,60,225,3,165
-3.0431679937083200,62,65,130,350,3,220
-3.0432389584215400,46,50,180,225,4,45
-3.043284818421150,18,25,100,300,7,200
-3.043449975078400,84,90,140,150,6,10
-3.0435888116368800,36,40,50,375,4,325
-3.043601055225220,62,65,110,225,3,115
-3.043668620979150,62,65,110,375,3,265
-3.0437187403010100,24,30,90,375,6,285
-3.0439571226009000,22,30,50,125,8,75
-3.0440438460441300,24,30,70,275,6,205
-3.044281134408850,18,25,80,425,7,345
-3.0443693290233700,62,65,190,300,3,110
-3.0445013467193400,62,65,50,325,3,275
-3.0445068345099400,46,50,50,200,4,150
-3.04471304288084,30,35,130,325,5,195
-3.044723779501370,76,80,90,125,4,35
-3.0449544667380700,24,30,180,325,6,145
-3.045499702155160,18,25,110,350,7,240
-3.045561657294030,96,100,190,200,4,10
-3.04558379559284,76,80,160,175,4,15
-3.045742428910570,82,85,90,175,3,85
-3.0460607384353800,24,30,70,350,6,280
-3.0460873972510100,30,35,110,325,5,215
-3.0461666318905200,62,65,70,300,3,230
-3.0464365631367700,30,35,80,200,5,120
-3.0464433238524000,18,25,140,350,7,210
-3.046685883127110,62,65,50,225,3,175
-3.047189847613240,40,45,120,175,5,55
-3.0472087540638900,78,85,170,175,7,5
-3.047282112550300,24,30,90,425,6,335
-3.0473254086267400,24,30,180,350,6,170
-3.047524373963420,32,40,100,125,8,25
-3.047710209904700,50,55,150,175,5,25
-3.047736332621470,36,40,90,475,4,385
-3.047763050583080,30,35,50,200,5,150
-3.0479574720682100,72,75,130,200,3,70
-3.048095207650850,24,30,190,375,6,185
-3.0486256179842400,62,65,160,275,3,115
-3.0486586040962400,56,60,100,150,4,50
-3.0487231557586300,24,30,140,350,6,210
-3.0489941853347700,60,65,100,125,5,25
-3.049265345110410,72,75,120,200,3,80
-3.0492993808070900,36,40,90,500,4,410
-3.0494398044766800,90,95,90,100,5,10
-3.0495290200810100,62,65,70,325,3,255
-3.04977361362164,62,65,110,275,3,165
-3.049966908080710,36,40,50,350,4,300
-3.0500370066096200,96,100,100,125,4,25
-3.0500641105370500,24,30,80,425,6,345
-3.0501712019801300,24,30,100,275,6,175
-3.050299088286750,24,30,200,350,6,150
-3.0504983838338900,46,50,160,200,4,40
-3.0508002926892600,18,25,120,275,7,155
-3.050808346227880,18,25,130,350,7,220
-3.050885961515570,18,25,90,325,7,235
-3.051062613369980,24,30,120,275,6,155
-3.0512658095710000,18,25,110,400,7,290
-3.0517899105940600,62,65,70,200,3,130
-3.0520556612869800,24,30,200,375,6,175
-3.0522208473519600,18,25,160,450,7,290
-3.052337303889940,100,105,110,125,5,15
-3.052476271382140,62,65,50,250,3,200
-3.052770173569470,34,40,180,200,6,20
-3.0528102278967000,24,30,110,400,6,290
-3.0529645200602700,18,25,150,300,7,150
-3.053859881266710,62,65,80,325,3,245
-3.0539016269733300,18,25,150,200,7,50
-3.0543069607913000,92,95,90,150,3,60
-3.054487471457550,36,40,120,450,4,330
-3.0545214744212200,18,25,70,400,7,330
-3.054703205069020,24,30,180,300,6,120
-3.0554156543286900,24,30,110,250,6,140
-3.0554865634164300,56,60,130,175,4,45
-3.0556812784219200,24,30,140,375,6,235
-3.0557878756954600,24,30,100,300,6,200
-3.055977981111480,24,30,160,450,6,290
-3.056128957695560,56,60,90,150,4,60
-3.0564010887393700,46,50,100,200,4,100
-3.0565460032239200,62,65,110,300,3,190
-3.0567151772958900,24,30,70,200,6,130
-3.056926491864090,24,30,90,325,6,235
-3.0569635826797800,18,25,110,275,7,165
-3.0571645221802100,48,55,110,125,7,15
-3.0572842778091800,82,85,100,175,3,75
-3.0574016176827400,18,25,140,300,7,160
-3.0574859615230500,36,40,120,500,4,380
-3.0578080001866300,22,30,200,225,8,25
-3.058074180366710,36,40,200,450,4,250
-3.0581133650049600,92,95,130,175,3,45
-3.058242171997840,92,95,50,125,3,75
-3.058341364309290,62,65,60,275,3,215
-3.0583941939482500,18,25,170,250,7,80
-3.058517865346190,62,65,140,300,3,160
-3.05882449505779,46,50,130,200,4,70
-3.0589931413134900,46,55,170,175,9,5
-3.059030417454910,50,55,120,150,5,30
-3.0591421114422400,22,30,90,150,8,60
-3.059238340865000,24,30,120,350,6,230
-3.0592982542258800,36,40,50,400,4,350
-3.0598794762516700,24,30,60,450,6,390
-3.059990494979080,36,40,170,400,4,230
-3.0600080769440400,16,25,120,175,9,55
-3.060010233569250,72,75,60,175,3,115
-3.060038557752340,24,30,50,225,6,175
-3.0601066855638600,50,55,60,125,5,65
-3.0604641409244000,36,40,170,350,4,180
-3.0610096669923300,36,40,180,475,4,295
-3.0610724831456400,42,50,80,100,8,20
-3.061087168816580,36,40,170,500,4,330
-3.061092992798930,92,95,200,225,3,25
-3.0613900711984000,24,30,110,275,6,165
-3.0615182572067000,24,30,50,325,6,275
-3.061524682936040,36,40,150,500,4,350
-3.0615910560069600,36,40,100,475,4,375
-3.0616260196026900,36,40,170,475,4,305
-3.061818802482870,24,30,60,250,6,190
-3.061844169194460,18,25,150,250,7,100
-3.061847898579920,24,30,80,400,6,320
-3.0620917135362100,62,65,80,300,3,220
-3.062308351421960,24,30,120,375,6,255
-3.0623536490046600,24,30,110,225,6,115
-3.0623779809680000,62,65,130,275,3,145
-3.0626492713272300,30,35,200,275,5,75
-3.062893956048100,62,65,60,250,3,190
-3.062918059339770,36,40,100,450,4,350
-3.0632964063296400,36,40,50,425,4,375
-3.0637232952644700,62,65,150,275,3,125
-3.063828661657130,24,30,70,400,6,330
-3.0640456853575100,62,65,170,250,3,80
-3.0640712276025200,36,40,70,225,4,155
-3.0643082243440900,30,35,180,225,5,45
-3.064400285640620,18,25,160,225,7,65
-3.0648867889959900,62,65,120,325,3,205
-3.0652636998660700,18,25,100,350,7,250
-3.0654175932070900,56,60,140,175,4,35
-3.0658260946290700,72,75,140,200,3,60
-3.066234507045950,32,40,70,100,8,30
-3.0667435445050000,24,30,70,325,6,255
-3.066828282812850,16,25,200,250,9,50
-3.0669542103280900,18,25,120,375,7,255
-3.0669953403882100,30,35,50,175,5,125
-3.0670251876261800,66,70,60,125,4,65
-3.067053932261720,36,40,60,425,4,365
-3.067241863491970,50,55,70,125,5,55
-3.0673105986109800,24,30,110,350,6,240
-3.0673716153988100,18,25,80,300,7,220
-3.0675016541861400,36,40,170,375,4,205
-3.067588080415090,24,30,60,225,6,165
-3.067702762866460,62,65,150,250,3,100
-3.0677974806087000,18,25,160,250,7,90
-3.0678879569373300,56,60,50,125,4,75
-3.0679241281085900,18,25,150,375,7,225
-3.068154381455450,24,30,100,325,6,225
-3.068258536980640,92,95,140,175,3,35
-3.0683801615394400,36,40,160,425,4,265
-3.0687325617668100,40,45,70,150,5,80
-3.0688323202390600,30,35,120,300,5,180
-3.0688537930016400,72,75,80,175,3,95
-3.0690164632084000,66,70,120,150,4,30
-3.06902840640429,54,60,80,100,6,20
-3.069425522538840,30,35,160,200,5,40
-3.069575067758550,18,25,150,275,7,125
-3.070284979346690,36,40,170,425,4,255
-3.070566183144520,46,50,120,200,4,80
-3.0705730606409500,42,50,110,125,8,15
-3.0706941065835200,18,25,130,275,7,145
-3.0707235640755000,36,40,50,450,4,400
-3.0708909619182100,24,30,100,350,6,250
-3.0709064336194200,18,25,110,375,7,265
-3.0711621850513700,36,40,120,225,4,105
-3.071179425058130,36,40,130,500,4,370
-3.071896753459610,86,90,50,100,4,50
-3.0723129883492000,22,30,130,175,8,45
-3.0723842667240600,46,50,70,175,4,105
-3.0725038388494400,62,65,110,325,3,215
-3.07271400338353,24,30,150,275,6,125
-3.0728702442508900,30,35,60,200,5,140
-3.0730219973235100,36,40,140,500,4,360
-3.0730998537130700,24,30,70,300,6,230
-3.073427817430120,24,30,100,375,6,275
-3.0734907727063600,36,40,160,475,4,315
-3.074134441837830,24,30,150,300,6,150
-3.0748662074070200,46,50,60,175,4,115
-3.074900648478540,62,65,130,300,3,170
-3.075338700036920,36,40,70,500,4,430
-3.0754126526121800,72,75,190,250,3,60
-3.075432254036650,46,50,50,175,4,125
-3.0761693482491600,24,30,160,275,6,115
-3.0763202023023100,18,25,170,225,7,55
-3.076408289108070,24,30,190,300,6,110
-3.076704532087930,36,40,90,250,4,160
-3.0768185664466200,36,40,80,250,4,170
-3.07707191953483,26,35,100,125,9,25
-3.0771589845473600,82,85,120,175,3,55
-3.077487375235710,34,40,60,125,6,65
-3.0777170742140500,72,75,70,175,3,105
-3.0778606168765700,82,85,170,200,3,30
-3.0779490440213300,36,40,190,450,4,260
-3.0781587847996300,18,25,110,300,7,190
-3.0791457995183700,74,80,90,100,6,10
-3.079168368749740,22,30,140,175,8,35
-3.079216705091100,62,65,160,250,3,90
-3.0792905151274200,24,30,80,325,6,245
-3.079623479689570,36,40,160,325,4,165
-3.0798957876326500,16,25,70,150,9,80
-3.0800618116624400,36,40,60,350,4,290
-3.0801222396832600,36,40,170,325,4,155
-3.080234601724530,60,65,70,100,5,30
-3.0810026100223200,62,65,130,325,3,195
-3.0810773996763100,30,35,90,200,5,110
-3.081434468100160,30,35,180,250,5,70
-3.0815904367078300,36,40,130,450,4,320
-3.081655312666170,30,35,110,200,5,90
-3.081701859664410,44,50,190,200,6,10
-3.081733306876520,36,40,130,225,4,95
-3.0821090753214100,30,35,130,200,5,70
-3.082282913760220,52,60,170,175,8,5
-3.082292199193050,36,40,90,225,4,135
-3.0826166194409300,62,65,170,275,3,105
-3.0826425239380700,36,40,160,350,4,190
-3.082706844991310,36,40,60,325,4,265
-3.0829683069537000,24,30,150,375,6,225
-3.083004498385820,34,40,120,150,6,30
-3.0831099423117600,36,40,110,500,4,390
-3.083261409471460,36,40,90,400,4,310
-3.083786510077260,24,30,150,250,6,100
-3.083881457096030,46,50,140,200,4,60
-3.0839062208347300,36,40,60,375,4,315
-3.0840106495553300,36,40,180,425,4,245
-3.0840871568763600,36,40,60,400,4,340
-3.084212631281230,24,30,50,250,6,200
-3.0843552810881900,38,45,70,100,7,30
-3.0856954113911600,24,30,110,375,6,265
-3.0857062519705100,44,50,60,100,6,40
-3.0857170420305600,36,40,120,475,4,355
-3.086122843125210,24,30,60,275,6,215
-3.0863255690451600,62,65,160,225,3,65
-3.0864474248381100,22,30,180,200,8,20
-3.086665117690220,36,40,50,500,4,450
-3.0867140543301500,62,65,170,225,3,55
-3.08695332913923,82,85,60,150,3,90
-3.0870259931551600,40,45,80,150,5,70
-3.0872307862738800,24,30,140,300,6,160
-3.0873155287179400,36,40,180,450,4,270
-3.0873524410484100,36,40,130,475,4,345
-3.0873882121869600,24,30,130,350,6,220
-3.0877310337777600,72,75,110,175,3,65
-3.087756550833640,36,40,50,475,4,425
-3.0878040085689500,66,70,70,125,4,55
-3.0879081122538000,62,65,80,200,3,120
-3.088001355832990,56,60,110,150,4,40
-3.0888231587014500,36,40,90,450,4,360
-3.0888391398378300,36,40,160,400,4,240
-3.0889369904010800,36,40,90,350,4,260
-3.0893315161485600,28,35,160,175,7,15
-3.089470789882520,24,30,170,250,6,80
-3.089849393916540,28,35,80,125,7,45
-3.090407505131040,36,40,150,475,4,325
-3.0904850058286100,30,35,190,275,5,85
-3.0913345683877000,36,40,100,425,4,325
-3.0914021663797500,24,30,80,300,6,220
-3.0918395540363500,82,85,190,225,3,35
-3.091962497668060,68,75,170,175,7,5
-3.092439530650830,18,25,120,325,7,205
-3.092722227865870,18,25,160,200,7,40
-3.0928908869645800,18,25,110,325,7,215
-3.0931096612173000,62,65,140,325,3,185
-3.0931223181574000,36,40,150,400,4,250
-3.0933701223313600,24,30,160,250,6,90
-3.0936148816758100,24,30,110,300,6,190
-3.0936765214895200,72,75,170,200,3,30
-3.0937971149405900,58,65,90,100,7,10
-3.0939217351569200,36,40,140,450,4,310
-3.093963792479090,36,40,50,275,4,225
-3.094015623303380,36,40,110,475,4,365
-3.094766925446730,46,50,110,175,4,65
-3.0959197172362600,54,60,110,125,6,15
-3.0963979083972600,86,90,90,125,4,35
-3.0974136781638600,18,25,80,200,7,120
-3.0976543351451500,36,40,130,400,4,270
-3.09769468584582,82,85,200,250,3,50
-3.098268260988550,24,30,130,275,6,145
-3.09859480822528,66,70,50,100,4,50
-3.098658090324320,86,90,160,175,4,15
-3.0988472724861900,36,40,80,450,4,370
-3.0990335746649800,84,90,90,100,6,10
-3.099045970974650,36,40,200,400,4,200
-3.099722309528870,36,40,80,225,4,145
-3.099893757176770,36,40,200,425,4,225
-3.099940474180760,30,35,100,200,5,100
-3.100041281976140,36,40,70,475,4,405
-3.1003408979768400,16,25,200,225,9,25
-3.1004505694766700,24,30,110,325,6,215
-3.100560940826250,24,30,130,300,6,170
-3.1010857241913200,34,40,150,175,6,25
-3.101174181452460,36,40,170,300,4,130
-3.101251974976440,36,40,190,375,4,185
-3.101516922899850,18,25,180,225,7,45
-3.101523560767380,96,100,70,100,4,30
-3.1017403070254600,36,40,110,450,4,340
-3.101832926386360,92,95,110,150,3,40
-3.101962426563750,36,40,70,375,4,305
-3.1023050794338100,24,30,120,325,6,205
-3.1025283117188300,36,40,150,450,4,300
-3.102592048874970,36,40,130,250,4,120
-3.1025936859001100,36,40,150,225,4,75
-3.102671648386010,46,50,80,175,4,95
-3.1027661521925900,24,30,160,225,6,65
-3.1027690254145500,72,75,90,175,3,85
-3.1029176077057200,30,35,60,175,5,115
-3.1029538317568000,76,80,190,200,4,10
-3.1031534985904500,36,40,120,400,4,280
-3.1037988336307300,16,25,100,150,9,50
-3.1038880900375200,36,40,180,375,4,195
-3.103942555413470,18,25,50,200,7,150
-3.1039763087558200,36,40,140,400,4,260
-3.1043745261573800,18,25,60,200,7,140
-3.1047389356831,80,85,80,100,5,20
-3.1048589159481500,36,40,140,275,4,135
-3.104878234531990,62,65,150,200,3,50
-3.1049158157834,30,35,120,200,5,80
-3.1049250029603200,18,25,130,300,7,170
-3.105134123295070,36,40,120,425,4,305
-3.105170464799100,92,95,60,125,3,65
-3.105563676255570,36,40,180,400,4,220
-3.10569873346544,18,25,130,325,7,195
-3.105783040942400,36,45,90,100,9,10
-3.106208504951130,62,65,200,275,3,75
-3.1067758641129100,28,35,90,125,7,35
-3.1067878217477800,50,55,50,100,5,50
-3.10681412950815,36,40,200,300,4,100
-3.1068227197220800,18,25,120,300,7,180
-3.107031695688610,34,40,70,125,6,55
-3.107184922827210,36,40,60,300,4,240
-3.1073614275623300,28,35,130,150,7,20
-3.1077471590474200,18,25,140,325,7,185
-3.1079423810903600,24,30,150,200,6,50
-3.108193741656490,36,40,100,225,4,125
-3.1082945943273000,62,65,180,275,3,95
-3.1091195571314100,36,40,170,450,4,280
-3.1100872128130400,56,60,180,200,4,20
-3.1104868331232500,72,75,50,150,3,100
-3.110559764357400,44,50,100,125,6,25
-3.110836439189220,22,30,110,150,8,40
-3.111105816590870,36,40,70,450,4,380
-3.1115015471100200,98,100,200,500,2,300
-3.1117345246012200,62,65,120,300,3,180
-3.1117628804761800,36,40,80,475,4,395
-3.111961377898720,82,85,70,150,3,80
-3.1121129198411700,36,40,100,400,4,300
-3.11213773065434,36,40,150,425,4,275
-3.1122063284421000,36,40,140,250,4,110
-3.1123274044852800,36,40,190,350,4,160
-3.112333567313900,30,35,70,175,5,105
-3.1123440460673300,40,45,100,150,5,50
-3.112601415288950,36,40,80,500,4,420
-3.112712990916950,80,85,110,125,5,15
-3.112758957421200,98,105,170,175,7,5
-3.112770257143400,94,100,170,175,6,5
-3.1129083552104200,36,40,200,350,4,150
-3.1131076119497700,36,40,190,400,4,210
-3.1133616352704300,36,40,140,475,4,335
-3.1137124167049500,36,40,80,375,4,295
-3.11383211646057,36,40,90,425,4,335
-3.1140318145444100,16,25,80,150,9,70
-3.1146996526733100,36,40,130,425,4,295
-3.114882686453750,36,40,70,350,4,280
-3.1152649922482000,46,50,90,175,4,85
-3.1153487562476400,36,40,190,425,4,235
-3.115506855897970,46,50,190,250,4,60
-3.1160881188399100,36,40,80,350,4,270
-3.116117840755460,36,40,90,275,4,185
-3.1161848101864100,26,35,70,100,9,30
-3.116271039954570,36,40,90,375,4,285
-3.1164246746954400,18,25,170,275,7,105
-3.116426760435740,36,40,130,375,4,245
-3.1166699824162500,24,30,170,275,6,105
-3.117562786726800,76,80,100,125,4,25
-3.117595637556470,36,40,160,300,4,140
-3.117907098092000,18,25,110,200,7,90
-3.1185078766203300,36,40,150,350,4,200
-3.1187755842777300,24,30,140,325,6,185
-3.1187937508704200,40,45,200,225,5,25
-3.118892757839960,62,65,60,200,3,140
-3.1190324850925800,36,40,90,300,4,210
-3.119073809424690,36,40,80,425,4,345
-3.1193698410850100,36,40,70,250,4,180
-3.1202514231296100,36,40,70,275,4,205
-3.1203624482629900,36,40,180,350,4,170
-3.120436602272330,36,40,120,250,4,130
-3.1205429827338800,36,40,110,425,4,315
-3.120905103770180,18,25,50,175,7,125
-3.1209229355038200,62,65,180,225,3,45
-3.120988714688750,98,100,200,475,2,275
-3.1211131337181400,36,40,160,450,4,290
-3.1220314807752700,36,40,140,375,4,235
-3.1220599270680100,24,30,170,225,6,55
-3.1221662219713800,36,40,70,425,4,355
-3.1230482133800200,36,40,110,250,4,140
-3.123120490747230,62,65,110,200,3,90
-3.1233348710249100,98,100,190,500,2,310
-3.12353998927117,18,25,200,275,7,75
-3.1238137363656400,24,30,80,200,6,120
-3.123836947890320,36,40,140,425,4,285
-3.124062328959690,92,95,70,125,3,55
-3.1244056386516600,36,40,100,250,4,150
-3.124500989073300,36,40,160,375,4,215
-3.124653307011230,40,45,90,150,5,60
-3.1247579161125200,36,40,80,275,4,195
-3.12488195953173,62,65,50,200,3,150
-3.124974067347270,86,90,130,150,4,20
-3.125210837061520,36,40,100,325,4,225
-3.1254273133259300,40,45,140,175,5,35
-3.1261556715068500,24,30,130,325,6,195
-3.1263264428308200,36,40,150,325,4,175
-3.1264540306899200,36,40,50,325,4,275
-3.126496230529670,36,40,60,500,4,440
-3.1270250150226900,42,50,140,150,8,10
-3.1271421687571000,72,75,100,175,3,75
-3.1273413885285900,46,50,170,200,4,30
-3.12741600438575,36,40,140,225,4,85
-3.127649657038470,36,40,180,325,4,145
-3.127868859393870,98,100,180,500,2,320
-3.128145691538800,46,50,50,150,4,100
-3.1283257095019900,62,65,190,275,3,85
-3.1286725523849200,92,95,180,200,3,20
-3.12875647723619,16,25,140,175,9,35
-3.1288299204719100,36,40,200,325,4,125
-3.1292524336591000,70,75,80,100,5,20
-3.129629317916770,62,65,160,200,3,40
-3.1296854347185600,58,65,170,175,7,5
-3.130950593322290,30,35,140,200,5,60
-3.1311102602598100,64,70,140,150,6,10
-3.1311151802962000,36,40,190,325,4,135
-3.131141868928140,36,40,200,375,4,175
-3.131233269003120,36,40,60,450,4,390
-3.1314237341378000,36,40,60,475,4,415
-3.1322248927720900,16,25,130,175,9,45
-3.1326054488894100,46,50,100,175,4,75
-3.1327225081635000,30,35,110,175,5,65
-3.132777684599550,56,60,120,150,4,30
-3.1329262016009900,36,40,180,300,4,120
-3.1331791945504400,24,30,110,200,6,90
-3.1331927447572400,24,30,180,225,6,45
-3.1336554537262100,36,40,100,300,4,200
-3.133782456440190,40,45,130,175,5,45
-3.1342314351869600,86,90,60,100,4,40
-3.134751142042090,50,55,160,175,5,15
-3.1349967120796800,36,40,50,300,4,250
-3.135135220086360,16,25,50,125,9,75
-3.1356821546621000,62,65,90,200,3,110
-3.135716588282010,62,65,180,250,3,70
-3.136093162452200,52,55,200,500,3,300
-3.137104275242800,72,75,200,250,3,50
-3.1374891952348000,50,55,80,125,5,45
-3.137583330030760,36,40,100,275,4,175
-3.1376343139930100,56,60,60,125,4,65
-3.1378026196482800,36,40,120,275,4,155
-3.1383604541309900,24,30,180,275,6,95
-3.138658595697180,56,60,70,125,4,55
-3.1387121548346500,72,75,190,225,3,35
-3.1390099132862400,36,40,50,250,4,200
-3.1390460959877000,92,95,150,175,3,25
-3.139269449044780,70,75,110,125,5,15
-3.1395290893695700,46,50,190,225,4,35
-3.1399654207943300,18,25,180,275,7,95
-3.1399761869107600,18,25,180,250,7,70
-3.140423955466240,62,65,120,200,3,80
-3.1405923357289100,30,35,80,175,5,95
-3.1408967772040400,36,40,80,400,4,320
-3.1415108228077400,98,100,190,475,2,285
-3.141583718147880,36,40,100,350,4,250
-3.1417281017227600,36,40,110,350,4,240
-3.142056243633920,52,55,190,500,3,310
-3.1421919024116800,82,85,50,125,3,75
-3.142527677003240,36,40,60,275,4,215
-3.142951857718270,36,40,110,400,4,290
-3.1433877663515900,36,40,120,350,4,230
-3.143860348964080,82,85,100,150,3,50
-3.1441245681132300,36,40,100,375,4,275
-3.1442567513555800,30,35,90,175,5,85
-3.14440770054496,24,30,120,300,6,180
-3.1446385422885200,62,65,70,175,3,105
-3.1448391328787300,18,25,100,200,7,100
-3.1449570092030800,40,45,50,125,5,75
-3.1450363332578500,36,40,110,375,4,265
-3.145074360318900,24,30,50,200,6,150
-3.1450768227244900,36,40,70,325,4,255
-3.14524522557434,36,40,120,375,4,255
-3.1452564776881900,36,40,140,350,4,210
-3.1455716527597800,48,55,140,150,7,10
-3.145614326086020,36,40,70,300,4,230
-3.1458062238180300,36,40,70,400,4,330
-3.1461109155282400,98,100,160,500,2,340
-3.1463652847977800,52,55,200,475,3,275
-3.1476643540332800,82,85,80,150,3,70
-3.1477858673069700,62,65,50,175,3,125
-3.1478538272737400,30,35,170,200,5,30
-3.148062413549090,36,40,60,225,4,165
-3.148180366719030,100,105,140,150,5,10
-3.1483475085613900,16,25,90,150,9,60
-3.1485633158939000,98,100,170,350,2,180
-3.148935358841780,18,25,90,200,7,110
-3.1489869447406900,18,25,60,175,7,115
-3.149578115569970,36,40,90,325,4,235
-3.1495874468077600,36,40,150,300,4,150
-3.1499528327200400,12,20,200,500,8,300
-3.150018793659260,36,40,130,350,4,220
-3.150044137395930,24,30,60,200,6,140
-3.150176917475870,36,40,50,225,4,175
-3.150489146904290,34,40,50,100,6,50
-3.150942016324390,28,35,60,100,7,40
-3.151251846981790,66,70,90,125,4,35
-3.1516134652038800,98,100,170,500,2,330
-3.151696417713340,36,40,110,275,4,165
-3.1520516072688700,72,75,60,150,3,90
-3.152131148955040,66,70,80,125,4,45
-3.152158575624600,24,30,200,275,6,75
-3.1522222777149700,88,90,200,500,2,300
-3.1524228086167800,62,65,100,200,3,100
-3.152961716435320,36,40,110,300,4,190
-3.1529844522921200,18,25,130,200,7,70
-3.1532693535215100,62,65,60,175,3,115
-3.1546133412935900,36,40,140,300,4,160
-3.154624235242910,24,30,50,175,6,125
-3.1546310484228800,98,100,120,450,2,330
-3.1548021168773100,98,100,200,450,2,250
-3.154853219329870,22,30,120,150,8,30
-3.1553766538964200,76,80,70,100,4,30
-3.155653253487220,18,25,70,175,7,105
-3.1562913643612600,36,40,110,225,4,115
-3.1565152617666100,62,65,130,200,3,70
-3.156738375152830,98,100,90,500,2,410
-3.1569665547270600,50,55,90,125,5,35
-3.157049318287020,36,40,70,200,4,130
-3.1570891589394400,46,50,60,150,4,90
-3.1571089916460000,72,75,120,175,3,55
-3.157254089719090,36,40,190,300,4,110
-3.157309414894360,18,25,120,200,7,80
-3.1578906287896200,24,30,160,200,6,40
-3.158501615852710,36,40,160,275,4,115
-3.1585648963345100,18,25,190,275,7,85
-3.1586012564724300,28,35,190,200,7,10
-3.1586288151316400,50,55,130,150,5,20
-3.1589558816728100,92,95,120,150,3,30
-3.1593250654677000,24,30,90,200,6,110
-3.1594265160058400,36,45,170,175,9,5
-3.1594707859903000,40,45,110,150,5,40
-3.159558151498620,86,90,100,125,4,25
-3.1607953504928700,56,60,150,175,4,25
-3.1609475723704300,98,100,160,475,2,315
-3.1613754962528900,36,40,150,375,4,225
-3.161832823809690,52,55,190,475,3,285
-3.1618568649135000,98,100,190,450,2,260
-3.1627046459584900,36,40,60,250,4,190
-3.163087614175160,22,30,150,175,8,25
-3.163090550706310,24,30,190,275,6,85
-3.1631993750659500,36,40,80,325,4,245
-3.16420972752474,98,100,150,500,2,350
-3.164680873892850,98,100,180,475,2,295
-3.16477707091137,16,25,180,200,9,20
-3.165322612698600,52,55,160,500,3,340
-3.1655403436703400,52,55,180,500,3,320
-3.165678830334660,98,100,100,500,2,400
-3.1659683671607200,30,35,190,250,5,60
-3.16668065184234,16,25,110,150,9,40
-3.1672606326241900,98,100,50,375,2,325
-3.1675944962276700,52,55,100,500,3,400
-3.16765506531583,98,100,170,475,2,305
-3.168575910057360,88,90,200,475,2,275
-3.1686872599948500,46,50,120,175,4,55
-3.1687423536386200,46,50,200,250,4,50
-3.1688863426988900,82,85,130,175,3,45
-3.169171156016120,36,40,170,250,4,80
-3.169510754643940,24,30,180,250,6,70
-3.169833563046620,24,30,120,200,6,80
-3.1699683568194200,36,40,150,275,4,125
-3.170191832406950,44,50,70,100,6,30
-3.17055754035259,36,40,80,300,4,220
-3.170634096836680,22,30,60,125,8,65
-3.170684050568490,24,30,100,200,6,100
-3.1709864231890000,36,40,130,275,4,145
-3.17101236216829,30,35,50,150,5,100
-3.17107510990692,18,25,110,175,7,65
-3.1712785782217500,24,30,130,200,6,70
-3.1713930948575700,86,90,190,200,4,10
-3.171687656743400,36,40,150,250,4,100
-3.171912905153890,98,100,50,425,2,375
-3.1724758942280900,22,30,70,125,8,55
-3.172631662036800,98,100,90,475,2,385
-3.1726755062992200,18,25,140,200,7,60
-3.173465030632470,98,100,130,500,2,370
-3.1734905641942600,98,100,120,500,2,380
-3.1739088120392900,98,100,170,400,2,230
-3.174438214571750,52,55,90,500,3,410
-3.174976501954420,82,85,140,175,3,35
-3.175762562514420,88,90,190,500,2,310
-3.1761081545598900,52,55,170,350,3,180
-3.1767530720787800,98,100,170,425,2,255
-3.1770140605902900,98,100,50,500,2,450
-3.177658095528650,34,40,160,175,6,15
-3.178445706301320,98,100,160,400,2,240
-3.178704851824470,98,100,130,475,2,345
-3.178953995056920,98,100,160,425,2,265
-3.1793163015766600,62,65,140,200,3,60
-3.1795380999999600,30,35,100,175,5,75
-3.1800024035541800,52,55,120,450,3,330
-3.1800631551888000,52,55,120,500,3,380
-3.18092126994188,88,90,180,500,2,320
-3.1810823869654300,74,80,170,175,6,5
-3.181181174627830,82,85,90,150,3,60
-3.181202747155630,36,40,160,250,4,90
-3.181234643310620,36,40,110,325,4,215
-3.181251965335990,80,85,140,150,5,10
-3.1812594710801400,98,100,100,450,2,350
-3.181583390210740,52,55,150,500,3,350
-3.181740975374030,88,90,190,475,2,285
-3.1826595537021600,62,65,110,175,3,65
-3.1829995366568700,98,100,70,500,2,430
-3.183046475914370,98,100,100,475,2,375
-3.1833389937349700,98,100,50,400,2,350
-3.183593319157410,12,20,200,475,8,275
-3.18452290713225,52,55,100,450,3,350
-3.1846179273499000,98,100,60,425,2,365
-3.1847028319483900,12,20,190,500,8,310
-3.1848012354748900,66,70,160,175,4,15
-3.1848431778172300,82,85,200,225,3,25
-3.184843231037700,98,100,170,375,2,205
-3.1852384217749100,98,100,140,500,2,360
-3.1856579277726100,36,40,160,225,4,65
-3.185668526485590,92,95,80,125,3,45
-3.185724050530020,98,100,170,450,2,280
-3.1859822367298900,86,90,70,100,4,30
-3.186077426624710,52,55,170,500,3,330
-3.1860882445976700,52,55,200,450,3,250
-3.186362185799300,98,100,110,500,2,390
-3.1864166602861,54,60,140,150,6,10
-3.186639244855400,24,30,140,200,6,60
-3.187138247775940,98,100,180,425,2,245
-3.1871421970623200,36,40,140,325,4,185
-3.1877453156123600,40,45,180,200,5,20
-3.188112186147170,36,40,130,300,4,170
-3.1883917792241000,98,100,50,350,2,300
-3.1884132046820500,12,20,50,350,8,300
-3.188415135412920,52,55,170,475,3,305
-3.188483891061620,98,100,50,475,2,425
-3.1888149903428000,34,40,90,125,6,35
-3.190128547802620,18,25,170,200,7,30
-3.1902260610208000,98,100,170,325,2,155
-3.190586523513310,72,75,80,150,3,70
-3.190651767945080,52,55,90,475,3,385
-3.1906791791398200,66,70,130,150,4,20
-3.190681014104460,60,65,80,100,5,20
-3.1909264488107,36,40,150,200,4,50
-3.190966838278340,72,75,70,150,3,80
-3.191042427811790,98,100,150,450,2,300
-3.1911142164319200,12,20,190,475,8,285
-3.191126202956880,98,100,150,400,2,250
-3.1911982782563500,98,100,50,450,2,400
-3.1915922734673200,98,100,100,425,2,325
-3.1915965754098500,98,100,160,350,2,190
-3.191664907322350,52,55,170,400,3,230
-3.1919309614812200,98,100,180,375,2,195
-3.1920152813109500,38,45,80,100,7,20
-3.192109392268900,88,90,160,500,2,340
-3.1921878334376600,24,30,70,175,6,105
-3.192222567296860,34,40,80,125,6,45
-3.1928559027326300,36,40,120,325,4,205
-3.1933645174175500,12,20,50,375,8,325
-3.193605271514830,24,30,60,175,6,115
-3.193670263589480,56,60,50,100,4,50
-3.1944193663225200,88,90,170,500,2,330
-3.1944530554169600,52,55,160,425,3,265
-3.194911950000140,98,100,190,425,2,235
-3.1952297186400100,98,100,120,475,2,355
-3.195395208519510,88,90,120,450,2,330
-3.1958685476317700,88,90,50,425,2,375
-3.1961109117898600,36,40,170,275,4,105
-3.196251709619030,12,20,180,500,8,320
-3.1964942723820800,98,100,140,425,2,285
-3.1967110851112800,52,55,190,450,3,260
-3.196822942105940,24,30,110,175,6,65
-3.1971026700297600,98,100,90,450,2,360
-3.1973795311659400,52,55,50,375,3,325
-3.197607179436630,52,55,180,475,3,295
-3.1978975436636300,98,100,90,250,2,160
-3.1980045668395900,12,20,90,250,8,160
-3.1981288831537400,96,105,120,125,9,5
-3.198166968372090,32,40,110,125,8,15
-3.1983114117981300,18,25,80,175,7,95
-3.198323537844090,96,100,110,125,4,15
-3.198392450249720,16,25,120,150,9,30
-3.198886932189150,98,100,120,225,2,105
-3.1993590018447800,98,100,200,400,2,200
-3.199366845865550,52,55,110,500,3,390
-3.199622628908350,98,100,130,450,2,320
-3.1996834357876300,98,100,110,475,2,365
-3.1997490256624300,98,100,150,425,2,275
-3.199768201509290,30,35,60,150,5,90
-3.1998599874126900,98,100,180,450,2,270
-3.200159099041050,52,55,160,475,3,315
-3.200159171256610,98,100,140,450,2,310
-3.200226809005590,12,20,160,500,8,340
-3.2003596271922500,98,100,60,350,2,290
-3.2005153502950200,46,50,70,150,4,80
-3.200567017784850,98,100,80,250,2,170
-3.2006015970072900,90,95,170,175,5,5
-3.2007942252763100,36,40,130,325,4,195
-3.2008080010921700,62,65,80,175,3,95
-3.200809203395860,98,100,70,475,2,405
-3.200934122365300,12,20,50,400,8,350
-3.2011958078091600,98,100,60,400,2,340
-3.201387092201420,98,100,60,375,2,315
-3.2014148818517900,88,90,170,350,2,180
-3.201427216823030,98,100,190,400,2,210
-3.20143679429588,98,100,60,325,2,265
-3.201639988290100,12,20,130,225,8,95
-3.2016868366275100,52,55,50,425,3,375
-3.2018012465389400,52,55,130,475,3,345
-3.201849858868030,52,55,100,475,3,375
-3.201924034355830,30,35,190,225,5,35
-3.202276468951800,22,30,50,100,8,50
-3.2028493729940500,88,90,200,450,2,250
-3.202968716218950,52,55,170,375,3,205
-3.203175385248790,98,100,70,225,2,155
-3.2032490762170400,36,40,170,225,4,55
-3.203366420940540,52,55,90,250,3,160
-3.2035333306270000,100,105,90,100,5,10
-3.203828234314200,52,55,140,500,3,360
-3.20395981568712,12,20,50,425,8,375
-3.2040064568528700,52,55,130,500,3,370
-3.2040075689388800,52,55,50,350,3,300
-3.2041669926707300,98,100,120,425,2,305
-3.2042076823744000,98,100,200,425,2,225
-3.2043973805160600,12,20,120,450,8,330
-3.205043366105850,12,20,90,500,8,410
-3.2052736189405200,98,100,120,400,2,280
-3.205427261471060,98,100,90,400,2,310
-3.205513381814280,88,90,90,500,2,410
-3.205523911066130,52,55,180,425,3,245
-3.2055553000104100,98,100,140,475,2,335
-3.2055852647871600,12,20,120,225,8,105
-3.2058049508495500,30,35,120,175,5,55
-3.2067931259556800,98,100,160,325,2,165
-3.2071448205943000,98,100,80,475,2,395
-3.2072488626231300,32,40,80,100,8,20
-3.2072949736706500,12,20,80,250,8,170
-3.2072995366101800,62,65,90,175,3,85
-3.207336473439250,98,100,130,400,2,270
-3.207405002664440,98,100,150,475,2,325
-3.207411880166370,46,50,80,150,4,70
-3.2075232571382900,88,90,150,500,2,350
-3.2077896304540000,36,40,180,275,4,95
-3.2085870136819800,36,40,80,200,4,120
-3.2087759386513200,98,100,110,425,2,315
-3.208926213433390,34,40,130,150,6,20
-3.2090505539041900,98,100,150,350,2,200
-3.2094740669728900,66,70,60,100,4,40
-3.2095224575176300,98,100,180,400,2,220
-3.209529687026860,52,55,110,475,3,365
-3.2095443361865400,98,100,70,450,2,380
-3.2096710743243500,98,100,130,250,2,120
-3.209815362664510,98,100,160,300,2,140
-3.209819156278350,88,90,180,475,2,295
-3.2100824709359400,98,100,130,375,2,245
-3.2101156807305100,98,100,130,425,2,295
-3.2105261748528800,52,55,90,450,3,360
-3.210545382909440,88,90,100,500,2,400
-3.2109933117201800,52,55,50,500,3,450
-3.2113616009177400,12,20,70,225,8,155
-3.211645623539780,52,55,70,375,3,305
-3.2118602264921500,52,55,160,350,3,190
-3.211935816131930,52,55,60,425,3,365
-3.2120780884321300,28,35,100,125,7,25
-3.212167395783330,36,40,110,200,4,90
-3.2123986834983500,52,55,170,425,3,255
-3.2125707203330700,62,65,50,150,3,100
-3.212667648442290,88,90,170,475,2,305
-3.2128740777019400,88,90,50,375,2,325
-3.2130164529436800,40,45,150,175,5,25
-3.213020391101080,16,25,50,100,9,50
-3.2131555634951700,98,100,160,375,2,215
-3.2131680209041000,98,100,90,425,2,335
-3.2133733036586000,98,100,140,400,2,260
-3.213433943091050,98,100,70,425,2,355
-3.2135625876099500,52,55,180,450,3,270
-3.213918453551850,52,55,80,250,3,170
-3.2139443728209000,98,100,80,500,2,420
-3.2141168720883100,52,55,100,425,3,325
-3.214122244432520,98,100,200,300,2,100
-3.2143136816282000,98,100,180,350,2,170
-3.214359849038460,88,90,120,500,2,380
-3.2144006087935100,72,75,100,150,3,50
-3.214472804280060,52,55,70,500,3,430
-3.2144979910437300,52,55,60,375,3,315
-3.2146721892627300,52,55,70,225,3,155
-3.2148425389803900,52,55,170,325,3,155
-3.2150727035111900,60,65,110,125,5,15
-3.215133015322880,52,55,130,400,3,270
-3.2152527370853000,98,100,70,375,2,305
-3.2152749057593100,98,100,90,350,2,260
-3.215429179064660,88,90,140,500,2,360
-3.215504743146910,98,100,80,450,2,370
-3.2155920155229400,98,100,140,375,2,235
-3.2164117055963800,56,60,80,125,4,45
-3.2165360411874200,88,90,170,325,2,155
-3.216661674521560,98,100,160,450,2,290
-3.2167829461746000,16,25,60,125,9,65
-3.2167851840773800,26,35,80,100,9,20
-3.216785277867860,98,100,110,450,2,340
-3.2170178645619100,88,90,160,425,2,265
-3.2170474675089000,98,100,130,225,2,95
-3.2171802657656800,62,65,190,250,3,60
-3.2174857761044000,36,40,120,300,4,180
-3.217588856800630,98,100,80,375,2,295
-3.2183011019598300,12,20,100,475,8,375
-3.2183280483509400,72,75,50,125,3,75
-3.218415511220710,62,65,170,200,3,30
-3.218451447773530,98,100,60,475,2,415
-3.2184838084605000,64,70,90,100,6,10
-3.2187563450506,18,25,50,150,7,100
-3.218921549438710,52,55,60,350,3,290
-3.21892265932595,52,55,160,325,3,165
-3.2189570745402000,82,85,110,150,3,40
-3.219299923867940,40,45,60,125,5,65
-3.219322514728790,52,55,120,425,3,305
-3.2193351667941100,52,55,50,400,3,350
-3.219618400122600,88,90,90,475,2,385
-3.2196399666697800,18,25,190,250,7,60
-3.2198861215448900,52,55,110,450,3,340
-3.2203976565925100,50,55,60,100,5,40
-3.2204116616454100,30,35,200,250,5,50
-3.220537983148410,52,55,180,400,3,220
-3.2205515838623100,98,100,200,375,2,175
-3.220689888353320,52,55,60,325,3,265
-3.220740585613710,12,20,70,375,8,305
-3.221006298880870,92,95,50,100,3,50
-3.221014496606670,12,20,100,500,8,400
-3.2210926921894900,98,100,190,375,2,185
-3.2213062731625600,98,100,200,350,2,150
-3.221331556114360,98,100,60,300,2,240
-3.2213499589723300,52,55,130,450,3,320
-3.2213538284183500,98,100,140,275,2,135
-3.2218591820757900,72,75,140,175,3,35
-3.2219310625664400,52,55,140,450,3,310
-3.222101163375300,52,55,120,475,3,355
-3.2221825838626400,52,55,50,450,3,400
-3.222189576628410,98,100,60,500,2,440
-3.2225112809805700,52,55,160,400,3,240
-3.2225210787181400,98,100,180,300,2,120
-3.2228981862265500,88,90,190,450,2,260
-3.2229048672673000,88,90,170,400,2,230
-3.223135885622770,98,100,190,325,2,135
-3.2232256861628000,52,55,190,375,3,185
-3.2233252367057800,52,55,50,475,3,425
-3.223375013595380,12,20,170,350,8,180
-3.2235805876528700,36,40,200,275,4,75
-3.223802899054770,12,20,170,400,8,230
-3.2239662065460100,52,55,200,400,3,200
-3.224006804485770,46,50,100,150,4,50
-3.22407088424196,52,55,140,425,3,285
-3.224092141074940,52,55,80,350,3,270
-3.2242807404415500,88,90,50,500,2,450
-3.224306482165130,98,100,190,350,2,160
-3.224329691976950,52,55,170,300,3,130
-3.224530402172310,38,45,110,125,7,15
-3.224749354011610,98,100,100,400,2,300
-3.224967457518060,52,55,150,400,3,250
-3.2254111389802300,52,55,170,450,3,280
-3.2255727908493200,88,90,130,500,2,370
-3.2255743444180500,98,100,80,425,2,345
-3.2258486212240400,52,55,70,475,3,405
-3.226370381999790,12,20,60,325,8,265
-3.2264529656267300,52,55,150,350,3,200
-3.2265031754229000,96,100,80,100,4,20
-3.226766874894340,12,20,50,500,8,450
-3.2268282750950100,12,20,100,450,8,350
-3.226905765477540,40,45,120,150,5,30
-3.2270213923998600,52,55,130,225,3,95
-3.2272303991029200,12,20,200,450,8,250
-3.2275384703225100,72,75,130,175,3,45
-3.2275432609511800,98,100,70,250,2,180
-3.2275839292684900,52,55,120,225,3,105
-3.227621146412130,12,20,60,425,8,365
-3.227637115189590,26,35,110,125,9,15
-3.227688334984030,88,90,100,450,2,350
-3.2279653313545900,98,100,80,350,2,270
-3.2279752295970700,36,40,180,250,4,70
-3.228036968356680,98,100,70,275,2,205
-3.2281835798698400,52,55,90,350,3,260
-3.228204543807080,12,20,90,475,8,385
-3.2285968532180900,52,55,90,400,3,310
-3.2287380882386700,52,55,150,450,3,300
-3.228862876519640,98,100,180,325,2,145
-3.2289678824213500,98,100,90,375,2,285
-3.2292799285462700,52,55,70,425,3,355
-3.229534661726840,36,40,180,225,4,45
-3.2296873564085800,98,100,100,225,2,125
-3.2297850422523100,36,40,90,200,4,110
-3.229855292074460,52,55,200,425,3,225
-3.2300414521882900,50,55,190,200,5,10
-3.230169380726740,98,100,170,300,2,130
-3.230434330598940,12,20,60,375,8,315
-3.230473715331100,88,90,100,475,2,375
-3.230656443367280,24,30,90,175,6,85
-3.230757871148760,98,100,120,350,2,230
-3.2311728914962000,88,90,110,500,2,390
-3.231179335195700,12,20,150,500,8,350
-3.231230079060360,52,55,130,425,3,295
-3.231626172483690,98,100,80,275,2,195
-3.231781270181910,88,90,60,350,2,290
-3.231891368748170,98,100,90,300,2,210
-3.231930373338080,98,100,140,250,2,110
-3.2320353268784000,12,20,100,225,8,125
-3.2321190615114900,52,55,130,250,3,120
-3.2322058812222600,72,75,90,150,3,60
-3.2323262118262400,88,90,50,475,2,425
-3.2323555296866700,98,100,90,225,2,135
-3.232441423257490,98,100,150,325,2,175
-3.232476532842020,52,55,110,425,3,315
-3.2325541073458500,98,100,50,275,2,225
-3.232594446250820,36,40,50,175,4,125
-3.232632254763900,88,90,160,325,2,165
-3.232666973305990,88,90,180,450,2,270
-3.2328363870478200,88,90,160,400,2,240
-3.2328649559522000,18,25,60,150,7,90
-3.233052150933280,12,20,60,350,8,290
-3.233156783783430,24,30,80,175,6,95
-3.2333271119584200,52,55,160,300,3,140
-3.233439740896040,18,25,90,175,7,85
-3.233447449284700,98,100,140,225,2,85
-3.233476587502810,52,55,140,400,3,260
-3.233482868254890,12,20,160,425,8,265
-3.2335877091998300,84,90,170,175,6,5
-3.233698730885860,52,55,140,375,3,235
-3.2339283844795600,52,55,150,475,3,325
-3.2342298599398100,88,90,170,425,2,255
-3.2348273438254400,52,55,80,500,3,420
-3.234915897104490,52,55,180,325,3,145
-3.2351188722445800,88,90,50,450,2,400
-3.235212372889470,70,75,140,150,5,10
-3.235344816910810,52,55,100,225,3,125
-3.235381570521700,86,90,80,100,4,20
-3.235442543304290,88,90,160,475,2,315
-3.2357343286115500,12,20,170,500,8,330
-3.235919580897400,52,55,200,300,3,100
-3.2359452153667300,52,55,180,375,3,195
-3.236153837222790,52,55,80,475,3,395
-3.236170034034600,78,80,200,500,2,300
-3.2365562041726100,36,40,190,275,4,85
-3.2365713235863800,88,90,130,425,2,295
-3.236770741511050,98,100,80,225,2,145
-3.2367961530262700,52,55,70,450,3,380
-3.236816522951560,28,35,70,100,7,30
-3.236838305329930,54,60,90,100,6,10
-3.236887335084610,82,85,60,125,3,65
-3.236894088958420,24,30,170,200,6,30
-3.2369611230820900,52,55,120,400,3,280
-3.2370197547660800,42,50,90,100,8,10
-3.2370481268434500,88,90,110,475,2,365
-3.237136867774430,52,55,140,250,3,110
-3.2372290096916500,88,90,200,400,2,200
-3.2374867715726800,52,55,90,225,3,135
-3.237536543380420,98,100,140,350,2,210
-3.237786973881650,52,55,60,400,3,340
-3.237976673046060,98,100,80,400,2,320
-3.238096404895810,88,90,130,225,2,95
-3.2382376114962800,98,100,100,275,2,175
-3.2383166290139100,12,20,50,475,8,425
-3.238330031878620,72,75,200,225,3,25
-3.2383881886628700,80,85,90,100,5,10
-3.238628455971390,62,65,100,175,3,75
-3.238683528386430,36,40,60,200,4,140
-3.238931220423040,82,85,180,200,3,20
-3.2393131613297100,48,55,90,100,7,10
-3.239468048303910,12,20,170,325,8,155
-3.2394897688708900,88,90,80,250,2,170
-3.239585385201320,98,100,200,325,2,125
-3.239647399236370,12,20,50,450,8,400
-3.239691463419940,52,55,80,450,3,370
-3.2397285929485600,12,20,120,500,8,380
-3.239862198335630,88,90,50,350,2,300
-3.2398687584021700,88,90,70,500,2,430
-3.239926437338850,52,55,150,425,3,275
-3.2399935353839400,52,55,90,375,3,285
-3.240290256578970,98,100,120,250,2,130
-3.240660591099540,12,20,60,300,8,240
-3.240666303604050,98,100,120,375,2,255
-3.240754504280230,24,30,190,250,6,60
-3.240819854149430,88,90,60,425,2,365
-3.240876503709010,12,20,50,275,8,225
-3.24090766832404,88,90,160,350,2,190
-3.2410492471259100,98,100,60,450,2,390
-3.2411278395637800,98,100,100,250,2,150
-3.2411626102379100,88,90,130,475,2,345
-3.241168677120950,88,90,130,450,2,320
-3.2412115041157400,16,25,150,175,9,25
-3.241279495661020,12,20,150,225,8,75
-3.2413900986178800,98,100,110,350,2,240
-3.241991942426960,98,100,110,375,2,265
-3.2420253022388100,52,55,190,425,3,235
-3.2420365978856700,52,55,130,375,3,245
-3.242114196505890,52,55,100,400,3,300
-3.2421513732375600,82,85,120,150,3,30
-3.2421869545848000,56,60,160,175,4,15
-3.2424953884370900,88,90,170,450,2,280
-3.2425779650426200,40,45,70,125,5,55
-3.242808216166490,88,90,90,250,2,160
-3.2428506013577100,52,55,160,375,3,215
-3.242924009659240,88,90,90,450,2,360
-3.242962048645640,12,20,70,500,8,430
-3.2430435422008800,88,90,140,450,2,310
-3.2430739520761200,88,90,180,425,2,245
-3.243104322906560,52,55,190,350,3,160
-3.243117576406220,12,20,160,350,8,190
-3.2435192492636200,12,20,190,450,8,260
-3.243611366930300,86,95,120,125,9,5
-3.24383130328736,52,55,150,225,3,75
-3.2439861583442400,98,100,70,400,2,330
-3.243999306388580,88,90,100,425,2,325
-3.244161469432020,88,90,50,400,2,350
-3.244229908784790,36,40,50,200,4,150
-3.244263399638890,88,90,120,475,2,355
-3.2444654503256600,98,100,90,275,2,185
-3.2445848336581100,98,100,110,400,2,290
-3.2451241879906500,88,90,140,400,2,260
-3.245314284105910,88,90,170,375,2,205
-3.2453346170069600,66,70,190,200,4,10
-3.245405831682750,98,100,50,300,2,250
-3.24560818631081,12,20,160,400,8,240
-3.2458432906699700,46,50,130,175,4,45
-3.24589859252593,88,90,150,450,2,300
-3.245927345772540,52,55,80,275,3,195
-3.2459686314343800,52,55,60,300,3,240
-3.246036693551210,98,100,100,375,2,275
-3.2461489509747800,50,55,100,125,5,25
-3.246186614699510,52,55,190,400,3,210
-3.24639449541204,52,55,100,250,3,150
-3.246577663570600,98,100,130,350,2,220
-3.2466845564711600,88,90,150,475,2,325
-3.2469100090735900,18,25,100,175,7,75
-3.247042160923510,12,20,180,475,8,295
-3.2470917418937000,12,20,170,475,8,305
-3.247094092714530,52,55,180,350,3,170
-3.247265390401880,52,55,140,350,3,210
-3.247371153121490,88,90,120,425,2,305
-3.247398015124270,62,65,190,225,3,35
-3.2474002669155600,98,100,70,350,2,280
-3.247947686430450,52,55,80,375,3,295
-3.24828191028253,12,20,170,375,8,205
-3.248633502767900,88,90,70,475,2,405
-3.2489614571751700,98,100,100,325,2,225
-3.2491010399132000,12,20,160,325,8,165
-3.249390316514770,12,20,90,225,8,135
-3.249416124687860,52,55,140,475,3,335
-3.2494929580428300,36,40,160,200,4,40
-3.2496538103760400,88,90,130,400,2,270
-3.2498568109528100,92,95,90,125,3,35
-3.2499065077960900,88,90,70,225,2,155
-3.250398633659180,56,60,130,150,4,20
-3.250427316679810,88,90,120,225,2,105
-3.250716192546050,88,90,150,400,2,250
-3.250850894198330,12,20,60,400,8,340
-3.251015188973300,88,90,60,375,2,315
-3.25101757519898,88,90,150,350,2,200
-3.25106104247274,98,100,50,250,2,200
-3.251109516295140,52,55,50,275,3,225
-3.2512256006360900,52,55,150,325,3,175
-3.251769812660760,98,100,70,300,2,230
-3.2520891623069100,52,55,70,350,3,280
-3.2523669861565500,98,100,110,275,2,165
-3.252464868369120,98,100,70,325,2,255
-3.2525418341541300,12,20,130,400,8,270
-3.252803277217890,88,90,200,425,2,225
-3.252844660456470,88,90,150,425,2,275
-3.253015000159060,52,55,90,275,3,185
-3.2530538041103100,52,55,160,450,3,290
-3.2533113410892300,44,50,80,100,6,20
-3.253343595665220,88,90,190,425,2,235
-3.253355016887650,92,95,160,175,3,15
-3.2534061323204200,12,20,150,350,8,200
-3.253432496820190,18,25,190,225,7,35
-3.253649936963250,88,90,110,450,2,340
-3.2536623970392100,88,90,130,375,2,245
-3.2538517443515600,52,55,60,500,3,440
-3.2540260412812900,88,90,60,325,2,265
-3.254049849450320,52,55,90,300,3,210
-3.25408516766685,36,40,100,200,4,100
-3.254092426883270,12,20,90,400,8,310
-3.2541064103179600,56,60,90,125,4,35
-3.2541445182065800,98,100,150,375,2,225
-3.2542219783440500,12,20,80,275,8,195
-3.2542259310596600,52,55,90,425,3,335
-3.254418905199330,98,100,110,250,2,140
-3.2545168330755800,52,55,140,275,3,135
-3.2545207207014800,30,35,70,150,5,80
-3.2547186364691700,88,90,120,400,2,280
-3.2547717732304600,88,90,190,400,2,210
-3.254929303943430,52,55,200,350,3,150
-3.2552139159367500,12,20,130,500,8,370
-3.255269951345690,24,30,50,150,6,100
-3.2554712117346800,52,55,180,300,3,120
-3.2555929588929100,98,100,80,325,2,245
-3.2559267959586,52,55,70,275,3,205
-3.2560072514317300,98,100,150,225,2,75
-3.2560364935804000,36,40,120,200,4,80
-3.256111021969350,88,90,90,400,2,310
-3.2562331825937100,98,100,190,300,2,110
-3.2562879393907400,88,90,60,400,2,340
-3.2564778702214500,52,55,60,475,3,415
-3.256585304384200,88,90,90,350,2,260
-3.2566223212226400,12,20,130,450,8,320
-3.2566436029423700,30,35,100,150,5,50
-3.256862514298960,52,55,200,375,3,175
-3.2569647366337100,46,50,90,150,4,60
-3.2571409017685300,82,85,70,125,3,55
-3.2574199114548000,88,90,80,475,2,395
-3.257813883841360,52,55,100,275,3,175
-3.257834000282830,22,30,90,125,8,35
-3.257839124364990,52,55,200,325,3,125
-3.2578399330661800,22,30,160,175,8,15
-3.2579691476415000,52,55,80,400,3,320
-3.2583769109936500,98,100,90,325,2,235
-3.2583950175828400,52,55,70,400,3,330
-3.2586293098287200,98,100,100,300,2,200
-3.258658661530660,62,65,120,175,3,55
-3.2588109200279600,52,55,60,450,3,390
-3.258825337658720,78,80,200,475,2,275
-3.2589249912833900,12,20,140,500,8,360
-3.2590303549445400,12,20,100,425,8,325
-3.2593873100230600,88,90,140,250,2,110
-3.259447326506670,52,55,120,250,3,130
-3.2594753514257900,88,90,70,450,2,380
-3.25992425130158,98,100,120,275,2,155
-3.2601842395353600,12,20,70,475,8,405
-3.260484249119910,62,65,200,250,3,50
-3.2604848181262000,12,20,140,225,8,85
-3.260611937359570,98,100,150,300,2,150
-3.260625048308890,12,20,120,475,8,355
-3.2607313291344900,12,20,110,500,8,390
-3.2608733822773900,16,25,70,125,9,55
-3.260963190889490,52,55,70,250,3,180
-3.261388311344700,98,100,50,325,2,275
-3.261523323316030,98,100,100,350,2,250
-3.26155088622764,52,55,80,225,3,145
-3.2618065949667900,52,55,190,325,3,135
-3.2619841934625200,88,90,80,450,2,370
-3.261993078863000,52,55,80,425,3,345
-3.262010481335230,12,20,180,425,8,245
-3.2624342231381300,46,50,50,125,4,75
-3.2624990322935800,98,100,160,275,2,115
-3.2626185293296500,92,95,130,150,3,20
-3.262632825432120,46,50,140,175,4,35
-3.2630749902260300,88,90,200,300,2,100
-3.2635763739456700,88,90,170,300,2,130
-3.263667439407860,12,20,200,300,8,100
-3.263687542051890,42,45,200,500,3,300
-3.2638066658624700,88,90,180,400,2,220
-3.264026665751540,12,20,50,225,8,175
-3.2640585870455300,12,20,130,250,8,120
-3.264250564985860,12,20,160,475,8,315
-3.264303055678830,98,100,70,200,2,130
-3.264543120962640,88,90,140,375,2,235
-3.264563542110730,72,75,110,150,3,40
-3.2645937349392100,98,100,160,250,2,90
-3.2648391665355100,88,90,180,375,2,195
-3.264873837037920,88,90,80,500,2,420
-3.265244347296960,52,55,100,325,3,225
-3.2652443782939800,66,70,100,125,4,25
-3.2657575024341400,88,90,70,425,2,355
-3.265856299523240,12,20,70,275,8,205
-3.2658628460708100,22,30,80,125,8,45
-3.266268814873690,78,80,180,500,2,320
-3.2663064818685600,88,90,70,375,2,305
-3.26633336387913,98,100,140,300,2,160
-3.266649321131720,98,100,60,250,2,190
-3.2669956189570300,12,20,90,350,8,260
-3.2670440056475800,22,30,130,150,8,20
-3.26717817230672,98,100,110,225,2,115
-3.26720521434465,88,90,140,425,2,285
-3.267343590268230,88,90,50,275,2,225
-3.267407391744080,24,30,60,150,6,90
-3.267557883604990,88,90,110,425,2,315
-3.267759972076910,12,20,80,225,8,145
-3.2678120568137300,46,50,200,225,4,25
-3.2680976426394100,12,20,170,425,8,255
-3.2681381169262000,78,80,160,500,2,340
-3.2682387396015500,88,90,190,350,2,160
-3.2683120985750100,88,90,180,350,2,170
-3.2683468981213100,36,40,140,200,4,60
-3.268360316119170,98,100,130,275,2,145
-3.2684651390565100,78,80,190,475,2,285
-3.2686223593562700,52,55,110,400,3,290
-3.2687017846231600,78,80,190,500,2,310
-3.268759302883170,98,100,120,325,2,205
-3.2689129218827400,40,45,50,100,5,50
-3.2689354702632900,98,100,150,275,2,125
-3.2692300408695,52,55,140,225,3,85
-3.2692895448315100,30,35,80,150,5,70
-3.2692906418547400,98,100,50,225,2,175
-3.2694560331214900,36,40,60,175,4,115
-3.2694822303986000,24,30,100,175,6,75
-3.269484753538540,88,90,150,325,2,175
-3.26961302015388,12,20,180,400,8,220
-3.269699090340400,88,90,200,350,2,150
-3.2699232876815400,52,55,150,375,3,225
-3.2699385838029600,12,20,110,475,8,365
-3.2699989946270500,12,20,70,250,8,180
-3.2701159851601100,98,100,170,250,2,80
-3.2704784299179700,34,40,60,100,6,40
-3.2705208226295700,98,100,110,300,2,190
-3.2706868749395600,88,90,130,250,2,120
-3.270800540408330,88,90,100,250,2,150
-3.2710508861669100,12,20,110,450,8,340
-3.27105926012538,88,90,100,225,2,125
-3.271124462530370,88,90,160,450,2,290
-3.271178081257190,88,90,190,375,2,185
-3.2711894372185400,88,90,80,375,2,295
-3.2712154016370900,52,55,120,275,3,155
-3.2713780145124600,12,20,90,450,8,360
-3.2715608273532200,50,55,70,100,5,30
-3.2716026805617500,12,20,70,450,8,380
-3.2717340102280700,52,55,110,250,3,140
-3.2717591733563100,12,20,140,275,8,135
-3.271945326066720,12,20,90,300,8,210
-3.2719825579954200,36,40,130,200,4,70
-3.2720886044950100,12,20,90,275,8,185
-3.2724489707526800,12,20,80,500,8,420
-3.2727958166570400,88,90,160,300,2,140
-3.2727995256337000,52,55,120,350,3,230
-3.272865202051320,62,65,70,150,3,80
-3.272874569110670,98,100,60,225,2,165
-3.2730409079644900,52,55,100,300,3,200
-3.2732228989942600,12,20,150,450,8,300
-3.273490768671680,52,55,110,225,3,115
-3.2737878597017900,88,90,100,400,2,300
-3.2742699134550800,88,90,80,350,2,270
-3.2746055950891500,76,85,120,125,9,5
-3.2748767620533300,88,90,60,475,2,415
-3.275118074128080,98,100,60,275,2,215
-3.275349604310700,88,90,90,425,2,335
-3.2754951696115200,52,55,190,300,3,110
-3.2755405703535000,98,100,130,300,2,170
-3.2757265117937400,12,20,140,250,8,110
-3.2757286063208700,52,55,70,325,3,255
-3.2757291098027700,88,90,140,475,2,335
-3.275801044280370,88,90,160,375,2,215
-3.275822708934330,12,20,120,400,8,280
-3.275850411471270,82,85,150,175,3,25
-3.276300805250630,12,20,170,300,8,130
-3.2765462571308700,44,50,110,125,6,15
-3.2765900976794600,12,20,160,300,8,140
-3.2767664170719700,52,55,100,375,3,275
-3.2767959654911000,78,80,120,450,2,330
-3.276956601891190,52,55,150,300,3,150
-3.2771148205964400,52,55,110,350,3,240
-3.2771254371267300,12,20,200,425,8,225
-3.2771273465426000,98,100,130,325,2,195
-3.2776394168285200,62,65,60,150,3,90
-3.2776584157726000,12,20,140,400,8,260
-3.2776862103479100,88,90,120,250,2,130
-3.2778102145394900,12,20,150,400,8,250
-3.2782002457722100,36,40,70,175,4,105
-3.278281500213590,88,90,140,275,2,135
-3.278623071529980,78,80,180,475,2,295
-3.2787666490710100,12,20,130,475,8,345
-3.2788718065052700,12,20,180,375,8,195
-3.2788750014062000,88,90,60,300,2,240
-3.278889915198820,46,50,110,150,4,40
-3.278920294558310,52,55,120,375,3,255
-3.278923354522830,12,20,200,400,8,200
-3.2790006028429300,78,80,170,500,2,330
-3.279079799542160,34,40,190,200,6,10
-3.279292687785220,52,55,50,300,3,250
-3.2793801733391200,88,90,180,300,2,120
-3.2798272216765300,88,90,190,325,2,135
-3.2799304478057400,88,90,150,225,2,75
-3.2799878946956600,98,100,140,325,2,185
-3.2800138532422600,12,20,120,250,8,130
-3.2801019522759800,52,55,130,350,3,220
-3.2801973624242500,52,55,100,350,3,250
-3.28031556901362,52,55,140,300,3,160
-3.280378456627910,12,20,120,425,8,305
-3.280438088430580,24,30,200,250,6,50
-3.2805857854778700,78,80,150,500,2,350
-3.280587628398160,12,20,100,250,8,150
-3.2806698214028000,52,55,50,225,3,175
-3.2808385912565400,88,90,90,375,2,285
-3.281033877405600,12,20,140,450,8,310
-3.2811935812660500,52,55,90,325,3,235
-3.281375082014850,72,75,60,125,3,65
-3.2814616269887200,88,90,80,275,2,195
-3.281550553728900,12,20,180,450,8,270
-3.2816304871636800,30,35,50,125,5,75
-3.28174947441788,52,55,80,325,3,245
-3.2824380677953100,78,80,100,500,2,400
-3.2824688303394300,12,20,80,375,8,295
-3.282687823275800,88,90,200,375,2,175
-3.28298798935485,52,55,60,225,3,165
-3.283183803952630,88,90,180,325,2,145
-3.283265997739310,88,90,100,275,2,175
-3.2834418899615600,12,20,130,375,8,245
-3.2837060273418200,12,20,130,425,8,295
-3.2843474524760200,12,20,80,450,8,370
-3.2844079073704900,36,40,80,175,4,95
-3.284500062231450,56,60,60,100,4,40
-3.2846433585424200,52,55,70,300,3,230
-3.285121032865990,24,30,190,225,6,35
-3.285194323313150,52,55,50,325,3,275
-3.285386972993420,52,55,110,375,3,265
-3.285425076046300,98,100,150,250,2,100
-3.2858837994685800,88,90,70,250,2,180
-3.2863096567657600,88,90,140,350,2,210
-3.286374306352720,88,90,60,500,2,440
-3.2863822158300000,88,90,90,225,2,135
-3.2865293022326800,12,20,50,300,8,250
-3.2867647323452500,88,90,50,325,2,275
-3.286907346737310,78,80,200,450,2,250
-3.2872473978143500,18,25,120,175,7,55
-3.28728297855245,52,55,160,275,3,115
-3.2873332056320500,78,80,90,500,2,410
-3.2874636470631500,88,90,80,425,2,345
-3.2877323401634900,88,90,70,275,2,205
-3.2879419568650800,88,90,200,325,2,125
-3.2879788276266700,88,90,80,225,2,145
-3.288029476697890,12,20,110,250,8,140
-3.288369843332310,42,50,170,175,8,5
-3.289235059274250,12,20,170,450,8,280
-3.2892523383472800,52,55,150,275,3,125
-3.2894649916827000,12,20,200,350,8,150
-3.2895919093221300,88,90,110,400,2,290
-3.2896438570318100,88,90,90,300,2,210
-3.2898185655971800,12,20,80,475,8,395
-3.2901776188887500,12,20,80,350,8,270
-3.290385212369370,88,90,60,225,2,165
-3.2905370044520800,88,90,60,450,2,390
-3.290691766065950,12,20,90,375,8,285
-3.2907085410616600,12,20,70,350,8,280
-3.290872012242460,42,45,190,475,3,285
-3.291057781040800,12,20,150,325,8,175
-3.2914125268134100,60,65,140,150,5,10
-3.2917410158762000,12,20,50,325,8,275
-3.2917556224502800,98,100,80,300,2,220
-3.2918234871953900,24,30,120,175,6,55
-3.291920242512860,88,90,140,225,2,85
-3.292161592346140,98,100,170,275,2,105
-3.292359614209340,88,90,110,350,2,240
-3.2927638258251900,78,80,100,475,2,375
-3.2928106873714000,88,90,70,350,2,280
-3.29358485007599,30,35,140,175,5,35
-3.294057987803570,12,20,140,425,8,285
-3.294230616482050,78,80,50,425,2,375
-3.294266196028870,12,20,100,400,8,300
-3.2944669629901800,66,70,70,100,4,30
-3.294551105943810,12,20,70,425,8,355
-3.294668010456700,88,90,190,300,2,110
-3.2946847472094100,12,20,180,325,8,145
-3.2947650281360000,12,20,50,250,8,200
-3.294795179884340,64,70,170,175,6,5
-3.295159208225930,12,20,150,475,8,325
-3.2952519610334700,78,80,120,500,2,380
-3.2956961758840000,88,90,90,275,2,185
-3.295920002321220,88,90,110,375,2,265
-3.2959637689210400,88,90,120,350,2,230
-3.2960072626113900,92,95,60,100,3,40
-3.2961505230399200,52,55,110,300,3,190
-3.2962155331682100,78,80,170,400,2,230
-3.2962793979339000,52,55,110,275,3,165
-3.2964528255199300,12,20,60,225,8,165
-3.296733928398290,88,90,150,300,2,150
-3.296867153990080,98,100,110,325,2,215
-3.296872830739820,16,25,160,175,9,15
-3.297147761221940,88,90,120,375,2,255
-3.297207612523580,76,80,110,125,4,15
-3.2976138072377800,12,20,110,425,8,315
-3.2976286876983800,78,80,190,450,2,260
-3.2977685894508400,52,55,70,200,3,130
-3.2984619461854300,92,100,120,125,8,5
-3.2984873665227800,12,20,190,350,8,160
-3.2985667309471000,72,75,180,200,3,20
-3.298714223006360,12,20,100,300,8,200
-3.298731050112480,12,20,180,300,8,120
-3.2988793313652700,18,25,70,150,7,80
-3.29924938574767,42,45,190,500,3,310
-3.2992529221811400,38,45,140,150,7,10
-3.299420340095280,88,90,150,375,2,225
-3.299566748418340,78,80,90,475,2,385
-3.2996103296375000,52,55,60,250,3,190
-3.2996969664426500,56,60,190,200,4,10
-3.2997678874621300,12,20,70,200,8,130
-3.299784151273110,98,100,160,225,2,65
-3.2998377901184100,78,80,50,375,2,325
-3.3001961289307200,12,20,190,325,8,135
-3.300262552148760,88,90,100,325,2,225
-3.300614174900510,16,25,130,150,9,20
-3.300708847349900,88,90,70,400,2,330
-3.300787418993880,18,25,200,250,7,50
-3.3009212691435100,98,100,80,200,2,120
-3.3009344416126900,12,20,60,250,8,190
-3.300957965600670,12,20,200,325,8,125
-3.30102959680052,36,40,110,175,4,65
-3.3012101115967000,52,55,50,250,3,200
-3.301323973228350,78,80,100,450,2,350
-3.3014863954988900,88,90,110,225,2,115
-3.3016960893838900,30,35,200,225,5,25
-3.3018424598321200,88,90,80,400,2,320
-3.3019608748185900,98,100,180,275,2,95
-3.3019970292895200,12,20,150,425,8,275
-3.302006174090810,12,20,140,350,8,210
-3.3020275079179700,12,20,200,375,8,175
-3.302062595407150,52,55,150,250,3,100
-3.3020751374176400,76,80,80,100,4,20
-3.3021671279804000,12,20,100,275,8,175
-3.302200702958760,52,55,170,250,3,80
-3.302247473078960,40,45,90,125,5,35
-3.3022937431723900,30,35,90,150,5,60
-3.302558526252960,78,80,110,500,2,390
-3.3026299789621800,88,90,110,275,2,165
-3.302632723629110,78,80,170,350,2,180
-3.3028154288221100,42,45,200,475,3,275
-3.30301469379595,98,100,190,275,2,85
-3.3031007615132200,12,20,100,325,8,225
-3.303218404027890,78,80,100,425,2,325
-3.3032306600157,88,90,110,250,2,140
-3.303556226226950,54,60,170,175,6,5
-3.303606546202540,88,90,160,275,2,115
-3.3036449935351200,12,20,140,375,8,235
-3.303700738388370,52,55,160,225,3,65
-3.3038795710463800,88,90,120,275,2,155
-3.30397420294882,78,80,60,350,2,290
-3.304022813201610,12,20,190,425,8,235
-3.3041784617750900,88,90,140,300,2,160
-3.3041836957321800,88,90,90,325,2,235
-3.3044933042211100,12,20,180,350,8,170
-3.3047353750778400,52,55,130,300,3,170
-3.3047560132356200,52,55,60,275,3,215
-3.3051246521343900,78,80,140,500,2,360
-3.3053198054486700,88,90,130,350,2,220
-3.3055326881162100,88,90,100,350,2,250
-3.305548498920580,82,85,50,100,3,50
-3.305992250775430,34,40,100,125,6,25
-3.306258954605680,88,90,70,325,2,255
-3.306272377550150,12,20,60,475,8,415
-3.3062905396802900,88,90,80,325,2,245
-3.306424138416300,12,20,80,400,8,320
-3.306768090263180,30,35,130,175,5,45
-3.306874613131550,88,90,100,300,2,200
-3.307319754197700,42,45,180,500,3,320
-3.3073436058873600,78,80,130,500,2,370
-3.3073558957422600,36,40,170,200,4,30
-3.3073816128169400,78,80,170,475,2,305
-3.3074667385897200,62,65,80,150,3,70
-3.307534732386530,12,20,80,325,8,245
-3.3075695040101800,88,90,170,250,2,80
-3.3076323503317200,88,90,50,300,2,250
-3.3076850711707900,12,20,120,275,8,155
-3.307692839239980,52,55,120,325,3,205
-3.3076962476601300,40,45,80,125,5,45
-3.307789612406670,78,80,50,400,2,350
-3.3077932264130500,12,20,90,325,8,235
-3.307931195301630,12,20,90,425,8,335
-3.308033598965100,88,90,100,375,2,275
-3.3084016147779100,46,50,180,200,4,20
-3.3084466897648800,78,80,130,450,2,320
-3.308457528788480,12,20,60,500,8,440
-3.3086748462239100,78,80,180,450,2,270
-3.3087788850949300,78,80,110,475,2,365
-3.309038319287950,88,90,150,275,2,125
-3.309087624777440,32,40,140,150,8,10
-3.309163006187510,78,80,160,425,2,265
-3.309306695797840,78,80,170,425,2,255
-3.3094279207629100,12,20,150,300,8,150
-3.3094839529356200,12,20,190,375,8,185
-3.309711410784280,30,35,180,200,5,20
-3.3097187566808300,12,20,190,400,8,210
-3.309772482978450,98,100,60,200,2,140
-3.309994029567290,12,20,160,375,8,215
-3.31039888581382,78,80,50,350,2,300
-3.3108086806636100,12,20,70,300,8,230
-3.310848017363880,12,20,110,400,8,290
-3.3108581580067300,98,100,120,300,2,180
-3.3108971553630100,72,75,150,175,3,25
-3.3111951154125600,88,90,110,325,2,215
-3.311231646154300,78,80,160,475,2,315
-3.311608557420790,78,80,50,500,2,450
-3.3119795403443200,78,80,130,400,2,270
-3.3120272141096900,42,45,160,500,3,340
-3.312052717844670,78,80,70,225,2,155
-3.312468096968120,12,20,70,400,8,330
-3.3127443291038700,26,35,140,150,9,10
-3.312841653886060,12,20,60,275,8,215
-3.313310186379160,52,55,80,300,3,220
-3.3133912498870300,52,55,130,275,3,145
-3.313531886144360,52,55,160,250,3,90
-3.313952248971230,52,55,130,325,3,195
-3.314392651183800,12,20,110,275,8,165
-3.3149065394399900,12,20,140,475,8,335
-3.315047612014440,78,80,150,475,2,325
-3.315364222762170,22,30,60,100,8,40
-3.3156244080148500,12,20,110,225,8,115
-3.3156562558050600,52,55,140,325,3,185
-3.315874685046160,88,90,110,300,2,190
-3.3168323071225300,12,20,100,375,8,275
-3.3168996671794200,78,80,60,425,2,365
-3.3169702165140200,36,40,190,250,4,60
-3.3171320974465200,78,80,160,325,2,165
-3.3173930483470400,36,40,90,175,4,85
-3.3176973592649500,78,80,170,375,2,205
-3.3177129299891200,78,80,70,500,2,430
-3.3177301485732400,88,90,70,200,2,130
-3.317853159845120,88,90,60,250,2,190
-3.318234852551410,88,90,50,250,2,200
-3.3183006138817400,40,45,160,175,5,15
-3.3183558241180100,24,30,80,150,6,70
-3.318652205433010,88,90,60,275,2,215
-3.3192119919106800,12,20,60,450,8,390
-3.319399890461560,12,20,80,425,8,345
-3.3194124146550500,12,20,70,325,8,255
-3.319506675328650,52,55,110,325,3,215
-3.3195936643734800,12,20,120,350,8,230
-3.3203631167779000,78,80,160,350,2,190
-3.3204254874509400,42,45,90,500,3,410
-3.320458255374700,78,80,180,425,2,245
-3.3204697473588200,78,80,120,225,2,105
-3.3205745722107700,88,90,150,250,2,100
-3.320700000930140,40,45,130,150,5,20
-3.3209202446759100,88,90,50,225,2,175
-3.320959548843590,88,90,130,275,2,145
-3.320976288468520,24,30,70,150,6,80
-3.3210843796462200,78,80,130,475,2,345
-3.3211667202254800,78,80,140,450,2,310
-3.321221798080760,78,80,120,475,2,355
-3.3213049848308000,88,90,70,300,2,230
-3.3217914391332700,42,45,120,450,3,330
-3.3221861958949300,12,20,170,250,8,80
-3.3223892091589100,78,80,90,250,2,160
-3.32250110107241,12,20,190,300,8,110
-3.322952136860750,78,80,50,450,2,400
-3.323191189439900,78,80,160,400,2,240
-3.3233899364824500,98,100,170,225,2,55
-3.323393405332240,70,75,90,100,5,10
-3.323425146889270,48,55,170,175,7,5
-3.3236125237339700,72,75,120,150,3,30
-3.3236169859768800,18,25,80,150,7,70
-3.323635565979170,12,20,140,300,8,160
-3.3239596143347600,78,80,150,450,2,300
-3.3240324848205300,52,55,180,275,3,95
-3.324050596230350,78,80,50,475,2,425
-3.3241821562336800,98,100,200,275,2,75
-3.3241851529852000,12,20,100,350,8,250
-3.3242440830024000,92,95,100,125,3,25
-3.324320094472450,52,55,170,275,3,105
-3.324395136662990,52,55,150,200,3,50
-3.3249256180185200,78,80,200,400,2,200
-3.3249787726177100,62,65,50,125,3,75
-3.325123309778100,78,80,60,400,2,340
-3.325245646506040,78,80,140,425,2,285
-3.3252507061109500,78,80,170,325,2,155
-3.325405270342220,12,20,150,200,8,50
-3.3254452113953100,78,80,60,375,2,315
-3.3254750502979400,42,45,170,500,3,330
-3.325701801663240,42,45,100,500,3,400
-3.325779641685010,78,80,60,325,2,265
-3.3265558325538700,98,100,150,200,2,50
-3.326599220573190,12,20,160,225,8,65
-3.327018103600420,78,80,70,375,2,305
-3.327121342978570,78,80,190,425,2,235
-3.3273424144316300,12,20,160,450,8,290
-3.3276776673312200,62,65,200,225,3,25
-3.328213899415580,52,55,80,200,3,120
-3.3284965559783100,78,80,170,450,2,280
-3.328552939534970,96,100,140,150,4,10
-3.328800240022450,42,45,90,475,3,385
-3.328847708686040,42,45,200,450,3,250
-3.328867090816360,88,90,80,300,2,220
-3.32903831897395,22,30,190,200,8,10
-3.32947531452987,12,20,160,275,8,115
-3.329537574622040,12,20,110,375,8,265
-3.3296136929873,46,50,60,125,4,65
-3.3299355879219800,88,90,160,250,2,90
-3.3299547868593200,16,25,90,125,9,35
-3.3299569012627200,78,80,150,400,2,250
-3.329980027381850,98,100,50,200,2,150
-3.33002426176492,92,95,190,200,3,10
-3.3309007391420800,34,40,70,100,6,30
-3.3309792746659100,52,55,120,300,3,180
-3.331486252571270,88,90,130,300,2,170
-3.3317593770220300,88,90,120,325,2,205
-3.331823625516920,98,100,90,200,2,110
-3.3318730859459700,78,80,90,400,2,310
-3.3322960925627100,12,20,130,350,8,220
-3.3324938110663200,78,80,140,400,2,260
-3.332589002388540,18,25,100,150,7,50
-3.332603126975970,78,80,200,300,2,100
-3.3328965051996300,78,80,130,375,2,245
-3.332974250950070,78,80,180,375,2,195
-3.333483976839770,78,80,180,400,2,220
-3.3338214889644700,78,80,80,475,2,395
-3.3339500360990100,78,80,120,400,2,280
-3.3342703315939200,42,45,190,450,3,260
-3.3346310262078700,36,40,50,150,4,100
-3.334817437634720,42,45,130,500,3,370
-3.335094488371280,16,25,80,125,9,45
-3.3351109303150300,78,80,80,250,2,170
-3.3351786524451900,78,80,70,475,2,405
-3.335484127754160,42,45,50,400,3,350
-3.335583182625110,12,20,80,300,8,220
-3.3358777025355800,78,80,50,275,2,225
-3.3360683189433000,98,100,110,200,2,90
-3.3361191196006500,78,80,140,250,2,110
-3.336225321122570,42,45,100,450,3,350
-3.3364247370172500,42,45,100,475,3,375
-3.3368883594830600,62,65,90,150,3,60
-3.337080017290630,78,80,110,450,2,340
-3.3372802532697900,12,20,150,250,8,100
-3.3372928559405800,42,45,180,475,3,295
-3.3372992043089200,98,100,180,250,2,70
-3.337323690393930,78,80,90,350,2,260
-3.337440917297690,78,80,190,400,2,210
-3.3375064273341100,78,80,90,450,2,360
-3.3377479330203900,62,65,100,150,3,50
-3.337786942426970,78,80,130,225,2,95
-3.338233084001400,46,50,150,175,4,25
-3.338274222800090,78,80,70,450,2,380
-3.338400974858660,42,45,50,375,3,325
-3.3391109638188200,78,80,150,350,2,200
-3.339276536538320,12,20,110,350,8,240
-3.339384652427610,36,40,100,175,4,75
-3.3394402125974100,66,75,120,125,9,5
-3.3394784747607000,78,80,140,275,2,135
-3.3396346567825400,42,45,150,500,3,350
-3.3398803459020100,12,20,170,225,8,55
-3.3399239234290400,62,65,130,175,3,45
-3.3399813858328400,78,80,190,350,2,160
-3.340150339886110,12,20,120,375,8,255
-3.3404232537557300,78,80,120,250,2,130
-3.3406754313378600,12,20,110,300,8,190
-3.3407519189549700,86,90,110,125,4,15
-3.340909246052270,78,80,200,425,2,225
-3.3419487586402100,78,80,160,300,2,140
-3.342318881766710,78,80,160,450,2,290
-3.342336574695050,82,85,80,125,3,45
-3.342385693355130,78,80,120,425,2,305
-3.342404104738220,78,80,130,425,2,295
-3.342568983988340,88,90,170,275,2,105
-3.342687660945840,42,45,140,500,3,360
-3.343104446975220,78,80,130,250,2,120
-3.343161446956850,98,100,70,175,2,105
-3.3437858681626400,42,45,170,350,3,180
-3.34380438093339,78,80,110,425,2,315
-3.343887870700050,46,50,120,150,4,30
-3.3440868331357400,88,90,130,325,2,195
-3.344180148724480,78,80,80,500,2,420
-3.3443417685349400,78,80,140,350,2,210
-3.344365634563270,52,55,170,225,3,55
-3.344874079369880,42,45,50,350,3,300
-3.345529330114630,24,30,100,150,6,50
-3.345780073362560,78,80,200,350,2,150
-3.3459853318707300,42,45,170,475,3,305
-3.346098620100060,72,75,50,100,3,50
-3.3461866169186600,56,60,100,125,4,25
-3.346905338332590,52,55,60,200,3,140
-3.34714308639073,78,80,150,425,2,275
-3.347174533737740,78,80,80,450,2,370
-3.347251087085030,42,45,110,500,3,390
-3.347719914531900,42,45,120,500,3,380
-3.3482513079359500,62,65,140,175,3,35
-3.3485969419212500,24,30,200,225,6,25
-3.3489655316961300,42,45,50,425,3,375
-3.3490466881593800,78,80,170,300,2,130
-3.34920260317484,42,45,160,425,3,265
-3.349295687562560,78,80,100,400,2,300
-3.3493049083543500,88,90,140,325,2,185
-3.349595909492660,42,45,60,375,3,315
-3.3497631808833600,78,80,160,375,2,215
-3.3499436480908500,52,55,110,200,3,90
-3.3505036738714800,78,80,200,325,2,125
-3.3505945719633400,72,75,70,125,3,55
-3.350926682957910,42,45,70,225,3,155
-3.350951448799470,78,80,90,225,2,135
-3.351177840886340,78,80,60,500,2,440
-3.3513203664840400,12,20,160,250,8,90
-3.351391910753990,42,45,170,400,3,230
-3.351459030425330,42,45,160,325,3,165
-3.351715035980480,12,20,130,275,8,145
-3.3519205426965900,42,45,120,475,3,355
-3.3521237103256100,28,35,110,125,7,15
-3.352128306344760,42,45,170,375,3,205
-3.3524332604228100,42,45,170,425,3,255
-3.352450836756100,96,100,90,100,4,10
-3.3524882346065600,42,45,70,500,3,430
-3.3527564581110400,78,80,140,375,2,235
-3.3528982967765,42,45,130,475,3,345
-3.3529649638184800,12,20,60,200,8,140
-3.353130531706500,98,100,50,175,2,125
-3.3533336008905000,88,90,120,300,2,180
-3.353560687832370,42,45,130,225,3,95
-3.353560820476770,88,90,160,225,2,65
-3.353792757438440,78,80,90,425,2,335
-3.3538128413069200,98,100,60,175,2,115
-3.3541550241065300,78,80,150,325,2,175
-3.3544583114804400,42,45,80,250,3,170
-3.3548480933359100,78,80,140,475,2,335
-3.3548531613533500,78,80,70,425,2,355
-3.3554142760445400,30,35,110,150,5,40
-3.355755259354590,78,80,100,250,2,150
-3.3557635082696200,42,45,170,325,3,155
-3.3558529070539500,12,20,150,375,8,225
-3.3558601147260000,78,80,60,475,2,415
-3.3561233403704700,12,20,150,275,8,125
-3.3561980799365000,42,45,90,250,3,160
-3.3562346072697100,82,85,90,125,3,35
-3.356381601389340,78,80,190,375,2,185
-3.356408940369020,52,55,180,250,3,70
-3.3571950558405600,36,40,200,250,4,50
-3.3576316862126600,18,25,50,125,7,75
-3.357793515173330,42,45,160,350,3,190
-3.357858558590250,18,25,90,150,7,60
-3.3580043126386600,78,80,200,375,2,175
-3.358061070584120,78,80,180,350,2,170
-3.3581386802099800,78,80,120,350,2,230
-3.3581769653069300,98,100,160,200,2,40
-3.358918947727560,98,100,100,200,2,100
-3.3589581278939000,18,25,200,225,7,25
-3.3590737546881400,98,100,120,200,2,80
-3.359373842332490,42,45,50,450,3,400
-3.359471632375080,78,80,80,375,2,295
-3.359589130612740,78,80,80,350,2,270
-3.359599674174680,42,45,50,500,3,450
-3.3596190236901000,42,45,130,450,3,320
-3.3597989002056600,88,90,150,200,2,50
-3.359823724575030,42,45,60,350,3,290
-3.3599856409176300,36,40,190,225,4,35
-3.360267497108390,88,90,180,275,2,95
-3.3603095311786900,78,80,60,450,2,390
-3.360321932648260,78,80,150,225,2,75
-3.360557026328010,78,80,190,325,2,135
-3.3606249751936500,42,45,120,225,3,105
-3.360757428902170,42,45,180,450,3,270
-3.361111616608090,42,45,160,475,3,315
-3.3611201782226200,42,45,120,400,3,280
-3.361123808244440,46,50,70,125,4,55
-3.3612353491763100,78,80,80,275,2,195
-3.3613620562697200,78,80,90,375,2,285
-3.3614824657756900,42,45,90,450,3,360
-3.3615430142184800,42,45,160,400,3,240
-3.3615885663191400,42,45,100,425,3,325
-3.36161532235969,78,80,180,325,2,145
-3.361770748274080,52,55,200,275,3,75
-3.361875037054140,78,80,110,400,2,290
-3.362044836214920,78,80,140,225,2,85
-3.362400732797810,98,100,130,200,2,70
-3.362427123399510,42,45,90,400,3,310
-3.3625572860798400,88,90,170,225,2,55
-3.363291107214290,12,20,130,300,8,170
-3.363520219492740,42,45,60,425,3,365
-3.3639112571002000,52,55,190,275,3,85
-3.3643214772982200,78,80,90,275,2,185
-3.3644747650644900,78,80,100,325,2,225
-3.364909617622870,78,80,110,250,2,140
-3.365004538094120,44,50,140,150,6,10
-3.3655604074500500,24,30,90,150,6,60
-3.3664086857899900,42,45,130,250,3,120
-3.366755571455550,78,80,100,225,2,125
-3.3668037718510100,42,45,60,325,3,265
-3.366836852499460,62,65,110,150,3,40
-3.367241960815480,78,80,60,300,2,240
-3.367266136682990,78,80,80,225,2,145
-3.3673009962329700,62,70,120,125,8,5
-3.367519768878050,60,65,90,100,5,10
-3.367545074231120,52,55,100,200,3,100
-3.367856733898810,12,20,180,225,8,45
-3.367890439800420,42,45,70,375,3,305
-3.3678980882123600,42,45,200,300,3,100
-3.36814342338917,28,35,80,100,7,20
-3.3682833512960000,12,20,160,200,8,40
-3.368480168287320,92,95,70,100,3,30
-3.368528472300040,82,85,60,100,3,40
-3.368880735946070,88,90,190,275,2,85
-3.3694469097508100,88,90,50,200,2,150
-3.369676698279090,98,100,180,225,2,45
-3.3698966280606900,100,105,170,175,5,5
-3.3699916055813900,24,30,140,175,6,35
-3.3700210471216900,12,20,110,325,8,215
-3.370096093705420,78,80,100,375,2,275
-3.370185967075090,82,90,120,125,8,5
-3.370514122566750,70,75,170,175,5,5
-3.37070635913011,24,30,50,125,6,75
-3.3707416206973900,88,90,80,200,2,120
-3.3711912286816000,78,80,90,300,2,210
-3.371249718112330,42,45,120,425,3,305
-3.3713196409854700,42,45,140,425,3,285
-3.371397094387100,52,55,50,200,3,150
-3.3716113006649800,78,80,70,350,2,280
-3.371705530742110,18,25,140,175,7,35
-3.371912315821570,88,90,200,275,2,75
-3.3719212260731700,42,45,110,475,3,365
-3.372197256896680,42,45,130,400,3,270
-3.372501544794180,78,80,70,250,2,180
-3.372722199971220,36,40,60,150,4,90
-3.373326255973660,42,45,140,450,3,310
-3.3735964413584300,78,80,80,425,2,345
-3.3739362167274200,12,20,50,200,8,150
-3.3739603614436400,42,45,180,425,3,245
-3.37399795245528,42,45,150,450,3,300
-3.3740364272555000,12,20,120,325,8,205
-3.3740871075640000,18,25,130,175,7,45
-3.3741746798259300,32,40,90,100,8,10
-3.3741895673505600,78,80,180,300,2,120
-3.3742461005734900,78,80,160,275,2,115
-3.374430415119830,42,45,50,475,3,425
-3.374713044044990,42,45,70,475,3,405
-3.3747404526736000,42,45,200,400,3,200
-3.375169407609560,78,80,100,275,2,175
-3.37562880637931,80,85,170,175,5,5
-3.3756969876745400,22,30,100,125,8,25
-3.3760736458595300,42,45,180,325,3,145
-3.3760969754287,12,20,120,300,8,180
-3.3761604780674200,16,25,190,200,9,10
-3.376241679734880,42,45,130,425,3,295
-3.376337886876440,78,80,50,250,2,200
-3.3763531565157400,98,100,140,200,2,60
-3.3764434488771100,16,25,60,100,9,40
-3.3765046323180900,42,45,80,375,3,295
-3.3765995203124400,42,45,150,325,3,175
-3.3767944638169000,42,45,90,350,3,260
-3.377109090491210,42,45,150,225,3,75
-3.3774621754134100,78,80,70,275,2,205
-3.3775506099962300,76,80,140,150,4,10
-3.377936854700370,12,20,50,175,8,125
-3.3780828128571000,56,65,120,125,9,5
-3.3782411435334000,78,80,100,300,2,200
-3.378301649659070,42,45,130,375,3,245
-3.3783273633211200,78,80,120,375,2,255
-3.378516909075870,78,80,110,350,2,240
-3.3788860679778300,42,45,90,375,3,285
-3.379041691109680,78,80,110,225,2,115
-3.3792964279532800,78,80,130,350,2,220
-3.379310999196430,24,30,130,175,6,45
-3.3793466280572700,42,45,180,400,3,220
-3.3795266721732800,52,55,180,225,3,45
-3.379830675141660,42,45,110,450,3,340
-3.3799272405443700,88,90,180,250,2,70
-3.3799374106580100,98,100,80,175,2,95
-3.3801037098849100,42,45,60,400,3,340
-3.3802681252112500,42,45,170,300,3,130
-3.3805856558768100,42,45,170,450,3,280
-3.380595682160960,78,80,190,300,2,110
-3.380861820221760,42,45,60,300,3,240
-3.3812793164388700,42,45,200,425,3,225
-3.381294593790540,78,80,150,375,2,225
-3.381371648199400,42,45,180,375,3,195
-3.3815492955702800,36,40,120,175,4,55
-3.3815904439864500,78,80,110,275,2,165
-3.3816062637769500,52,55,90,200,3,110
-3.381619904200010,52,55,160,200,3,40
-3.381670876018410,18,25,110,150,7,40
-3.3820322991075100,42,45,190,350,3,160
-3.382169105299320,42,45,140,275,3,135
-3.3823495094553500,78,80,70,300,2,230
-3.3823796414155300,78,80,120,275,2,155
-3.382474055154800,52,55,120,200,3,80
-3.382538348461310,12,20,80,200,8,120
-3.3826365941932800,78,80,60,225,2,165
-3.3828526815686000,42,45,160,300,3,140
-3.382982344782480,42,45,190,425,3,235
-3.3831003081291200,12,20,130,325,8,195
-3.3831015376459,42,45,150,400,3,250
-3.3831716276558000,42,45,150,350,3,200
-3.3834266360185100,88,90,110,200,2,90
-3.383550595800640,78,80,140,300,2,160
-3.3836188952899400,38,45,90,100,7,10
-3.383718833655550,78,80,80,400,2,320
-3.3840701277776300,78,80,150,300,2,150
-3.384114297401990,42,45,100,400,3,300
-3.3841159055573500,78,80,70,400,2,330
-3.38461990818068,42,45,70,425,3,355
-3.384708756555070,78,80,90,325,2,235
-3.3852261450973200,42,45,140,375,3,235
-3.3852540042730400,42,45,90,300,3,210
-3.3856015177092300,42,45,150,475,3,325
-3.385615378201690,20,25,200,500,5,300
-3.385656612319480,88,90,50,175,2,125
-3.3861763917718100,42,45,80,225,3,145
-3.3863304873739200,42,45,200,350,3,150
-3.386338586052060,30,35,120,150,5,30
-3.3867357093801400,42,45,80,500,3,420
-3.3872020351828800,42,45,90,225,3,135
-3.387465477034680,72,75,80,125,3,45
-3.387725752080680,82,85,130,150,3,20
-3.387884932738370,42,45,110,425,3,315
-3.388016900993310,52,55,70,175,3,105
-3.3880479029805700,42,45,120,250,3,130
-3.388203724199720,22,30,70,100,8,30
-3.3882688476056200,82,85,160,175,3,15
-3.388450200869400,42,45,100,225,3,125
-3.389087510406070,56,60,70,100,4,30
-3.3892508858670700,42,45,80,475,3,395
-3.389316233302470,88,90,60,200,2,140
-3.389484458926150,42,45,150,425,3,275
-3.3897356842965700,42,45,200,375,3,175
-3.389818431638920,42,45,140,250,3,110
-3.389844929762680,42,45,140,400,3,260
-3.3898783083857000,78,80,50,225,2,175
-3.3900443561017200,88,95,120,125,7,5
-3.390198703884160,42,45,190,400,3,210
-3.3908414273881800,78,80,110,375,2,265
-3.391024439935,40,45,190,200,5,10
-3.39126882845076,42,45,90,425,3,335
-3.3913726960612200,12,20,170,275,8,105
-3.391537134424400,62,65,180,200,3,20
-3.3916065394159800,42,45,100,250,3,150
-3.3916498065257600,78,80,70,325,2,255
-3.3917403576927300,42,45,70,450,3,380
-3.391778918452390,30,35,60,125,5,65
-3.3918046818002200,12,20,140,325,8,185
-3.39209808596613,98,100,110,175,2,65
-3.3921900662343600,88,90,90,200,2,110
-3.392366368866620,78,80,50,300,2,250
-3.3924028800546800,18,25,180,200,7,20
-3.392821127655990,42,45,70,275,3,205
-3.3932504427991300,78,80,60,250,2,190
-3.393301496270720,88,90,180,225,2,45
-3.3933474081658800,30,35,70,125,5,55
-3.393516975910550,72,80,120,125,8,5
-3.393553361902710,78,80,100,350,2,250
-3.3940224273500000,42,45,180,350,3,170
-3.3940620476637200,42,45,140,475,3,335
-3.3941274566534100,78,80,50,325,2,275
-3.3946790557241700,42,45,70,350,3,280
-3.3950927618027300,98,100,90,175,2,85
-3.395211158713140,42,45,80,450,3,370
-3.395567848559240,78,80,80,325,2,245
-3.395677884080840,42,45,90,275,3,185
-3.396002620900020,42,45,190,375,3,185
-3.396013792127230,26,35,90,100,9,10
-3.3960924517318500,68,70,200,500,2,300
-3.397122084636170,52,55,50,175,3,125
-3.3971624736938800,42,45,80,275,3,195
-3.3972513511590100,42,45,200,325,3,125
-3.3975992265904600,78,80,70,200,2,130
-3.3985100367810300,40,45,60,100,5,40
-3.3988516415473400,12,20,180,275,8,95
-3.399473360525640,30,35,150,175,5,25
-3.3994954189543200,50,55,110,125,5,15
-3.400119531245620,42,45,90,325,3,235
-3.4005508092564400,42,45,140,350,3,210
-3.4005552332114700,12,20,110,200,8,90
-3.4005740502542600,78,80,150,275,2,125
-3.4011272946737100,78,80,140,325,2,185
-3.4011443884845700,42,45,50,275,3,225
-3.401198554784030,52,55,130,200,3,70
-3.401293305202480,52,55,140,200,3,60
-3.401462476979450,42,45,80,350,3,270
-3.4018290330474900,42,45,60,475,3,415
-3.402177120339530,42,45,100,275,3,175
-3.402217843087120,78,80,60,275,2,215
-3.403368149713580,42,45,190,325,3,135
-3.4034128361092300,12,20,100,200,8,100
-3.403981236924210,42,45,160,375,3,215
-3.4043755138764100,52,55,60,175,3,115
-3.405776718965900,42,45,160,450,3,290
-3.4057996073537400,42,45,100,325,3,225
-3.4058331604158500,36,40,70,150,4,80
-3.406004902722000,88,90,100,200,2,100
-3.406619726941260,42,45,70,250,3,180
-3.4066435246459900,42,45,100,300,3,200
-3.4070195597332400,42,45,60,500,3,440
-3.407101022339680,42,45,180,300,3,120
-3.407875802581490,66,70,80,100,4,20
-3.4081805126765800,42,45,110,400,3,290
-3.4087154178688300,42,45,140,225,3,85
-3.409393513856440,78,80,150,250,2,100
-3.409544609618830,78,80,110,300,2,190
-3.4096818807223100,50,55,80,100,5,20
-3.410052824955560,46,50,50,100,4,50
-3.4104995095435000,42,45,50,300,3,250
-3.4105692119433600,78,80,160,225,2,65
-3.410576988560100,42,45,80,400,3,320
-3.410771651102580,78,80,130,275,2,145
-3.4109120726878800,26,35,170,175,9,5
-3.4109273948457800,72,75,60,100,3,40
-3.411002004184330,88,90,160,200,2,40
-3.4111224309372200,78,80,170,250,2,80
-3.411292700042970,20,25,200,475,5,275
-3.4116857891166600,42,45,100,375,3,275
-3.412099573178630,98,100,50,150,2,100
-3.4125703864564100,12,20,60,175,8,115
-3.412706410012530,42,45,80,425,3,345
-3.4128534871183600,12,20,90,200,8,110
-3.412928750557080,78,80,80,300,2,220
-3.4131451759639300,42,45,60,450,3,390
-3.41317667746113,12,20,180,250,8,70
-3.4137301086343600,98,100,190,250,2,60
-3.414010938184520,40,45,100,125,5,25
-3.4143765746403000,88,90,60,175,2,115
-3.414726624560940,42,45,110,350,3,240
-3.4155074731884700,88,90,120,200,2,80
-3.41577559491452,42,45,110,275,3,165
-3.416531738710670,42,45,120,350,3,230
-3.416623466772710,42,45,190,300,3,110
-3.416627361423180,46,50,80,125,4,45
-3.4178164635525800,42,45,110,250,3,140
-3.4182330916866500,78,80,130,300,2,170
-3.4188590623152500,78,80,160,250,2,90
-3.418956017863330,16,25,100,125,9,25
-3.4191531993339400,42,45,100,350,3,250
-3.4193157922531700,42,45,60,275,3,215
-3.419811995905670,24,30,110,150,6,40
-3.419822084465790,62,65,120,150,3,30
-3.420178261667960,42,45,120,275,3,155
-3.4204884268659100,42,45,140,300,3,160
-3.4206689574205500,24,30,180,200,6,20
-3.4207072342045200,36,40,80,150,4,70
-3.420809454051630,52,55,110,175,3,65
-3.420813749253050,82,85,70,100,3,30
-3.4210347965243600,78,80,110,325,2,215
-3.4213147922602300,36,40,100,150,4,50
-3.421332523934380,42,45,130,350,3,220
-3.4215789643279600,78,80,170,275,2,105
-3.4217829896008400,42,45,60,250,3,190
-3.422034492050410,42,45,70,400,3,330
-3.4223921988126200,12,20,200,275,8,75
-3.4232468227158700,78,80,120,325,2,205
-3.4234913408852400,42,45,50,325,3,275
-3.4239968015099700,20,25,190,500,5,310
-3.4240057603480700,72,75,160,175,3,15
-3.4242578284281400,88,90,130,200,2,70
-3.4245308470920200,68,70,200,475,2,275
-3.4246513546769900,62,65,60,125,3,65
-3.4249353311693500,12,20,120,200,8,80
-3.4251272296823800,20,25,190,475,5,285
-3.425294666696230,78,80,170,225,2,55
-3.4253014893011200,42,45,80,325,3,245
-3.425413941045040,52,55,80,175,3,95
-3.4258874154750100,62,65,150,175,3,25
-3.4269110979350000,18,25,120,150,7,30
-3.427219231433030,76,80,90,100,4,10
-3.4272426756584600,62,65,70,125,3,55
-3.427359123026930,42,45,150,300,3,150
-3.427485006691080,92,95,80,100,3,20
-3.427674320581350,24,30,150,175,6,25
-3.427745137351490,72,75,90,125,3,35
-3.4277882439564300,42,45,120,375,3,255
-3.4291616848862600,72,75,130,150,3,20
-3.4302972653650000,68,70,190,475,2,285
-3.430550630504400,68,70,190,500,2,310
-3.43078800266276,42,45,160,275,3,115
-3.430788816404340,30,35,50,100,5,50
-3.431254426719660,42,45,50,225,3,175
-3.4314570609553600,78,80,130,325,2,195
-3.4318171815308600,20,25,180,500,5,320
-3.4318217925168000,42,45,110,375,3,265
-3.432121302756200,66,70,110,125,4,15
-3.4321880418305400,82,85,190,200,3,10
-3.4322508825376500,38,45,170,175,7,5
-3.4326064331989800,42,45,70,325,3,255
-3.4329361624028700,36,40,200,225,4,25
-3.4338275837723600,86,90,140,150,4,10
-3.4346394402998100,20,25,50,375,5,325
-3.4350081907484900,88,90,140,200,2,60
-3.4353410987249000,60,65,170,175,5,5
-3.4356698853089200,78,85,120,125,7,5
-3.435704564057660,42,45,60,225,3,165
-3.4360717081766000,12,20,130,200,8,70
-3.437289286222560,42,45,70,300,3,230
-3.4374268961668800,12,20,190,275,8,85
-3.437488275454240,42,45,150,375,3,225
-3.4376996816933800,32,40,170,175,8,5
-3.437730358117820,42,45,150,275,3,125
-3.4378505919269200,98,100,170,200,2,30
-3.4379240933948800,20,25,120,450,5,330
-3.4385959819651400,68,70,100,500,2,400
-3.4388746485775900,62,65,50,100,3,50
-3.439254260136630,42,45,110,225,3,115
-3.439349354648770,34,40,80,100,6,20
-3.4394525553765300,52,55,190,250,3,60
-3.4395695154790500,88,90,80,175,2,95
-3.440195304533990,12,20,170,200,8,30
-3.440279738382530,20,25,50,350,5,300
-3.4406021074415300,78,80,120,300,2,180
-3.4406272605560200,42,45,70,200,3,130
-3.4413069062489700,98,105,120,125,7,5
-3.441725345825240,88,90,70,175,2,105
-3.4419570445402200,88,90,110,175,2,65
-3.442162629792090,12,20,110,175,8,65
-3.4421918308639300,42,45,170,250,3,80
-3.442439058963130,12,20,140,200,8,60
-3.4425508391682300,46,50,160,175,4,15
-3.442931325015540,20,25,160,500,5,340
-3.4432474651006600,78,80,180,275,2,95
-3.443318976145000,42,45,50,250,3,200
-3.4433567617274800,98,100,100,175,2,75
-3.4436354973329200,52,55,90,175,3,85
-3.4437723388192400,20,25,120,225,5,105
-3.4441025621008400,94,100,120,125,6,5
-3.444206586640150,68,70,180,500,2,320
-3.4445294247862500,42,45,110,300,3,190
-3.445186102776990,68,70,200,450,2,250
-3.4453152425763100,12,20,70,175,8,105
-3.4453783867117300,98,100,120,175,2,55
-3.4458395414564300,42,45,150,250,3,100
-3.4464070038185000,36,40,130,175,4,45
-3.4469665229651600,42,45,130,300,3,170
-3.4473655751201400,20,25,90,500,5,410
-3.4473759192497900,68,70,90,500,2,410
-3.4483024496782100,68,70,160,500,2,340
-3.449008341611450,20,25,100,500,5,400
-3.4492200677314700,42,45,140,325,3,185
-3.4500557448061500,20,25,90,475,5,385
-3.4508061534211200,68,70,120,450,2,330
-3.4508347030921700,20,25,50,400,5,350
-3.450860024479040,78,80,60,200,2,140
-3.4509870214741700,34,40,110,125,6,15
-3.451291861614850,52,55,50,150,3,100
-3.45131033555002,78,80,190,275,2,85
-3.451405963837130,20,25,170,350,5,180
-3.4514402733842000,42,45,80,300,3,220
-3.452348887515190,20,25,100,450,5,350
-3.4534258249206600,26,30,200,500,4,300
-3.453559313648330,46,50,130,150,4,20
-3.454057522749440,98,100,70,150,2,80
-3.4544134397905700,78,80,80,200,2,120
-3.4550459105278200,78,80,150,200,2,50
-3.4552800577936500,68,70,170,500,2,330
-3.4553535038268900,52,55,170,200,3,30
-3.455808570700660,88,90,50,150,2,100
-3.4562366138676800,16,25,70,100,9,30
-3.456256774147740,36,40,50,125,4,75
-3.456358424793310,42,45,160,225,3,65
-3.4564369650373700,42,45,130,275,3,145
-3.456483659974990,18,25,60,125,7,65
-3.4568597291595500,20,25,50,425,5,375
-3.4570529810339500,68,70,150,500,2,350
-3.4572879448376100,28,35,140,150,7,10
-3.4576938577739400,68,70,90,475,2,385
-3.4579106398177000,20,25,200,450,5,250
-3.4581860697948900,36,40,90,150,4,60
-3.4583120666513400,20,25,170,500,5,330
-3.4588098467978600,82,85,100,125,3,25
-3.4593377481807000,42,45,160,250,3,90
-3.4595235053152600,68,70,120,500,2,380
-3.4598575363410900,26,30,190,500,4,310
-3.4598655114666400,24,30,120,150,6,30
-3.459905601485980,98,100,190,225,2,35
-3.4602071913301800,26,30,200,475,4,275
-3.460508715323350,20,25,80,250,5,170
-3.4608583562797800,20,25,60,350,5,290
-3.460915174442820,78,80,50,200,2,150
-3.4610600300984800,20,25,70,225,5,155
-3.4613048824131000,20,25,70,500,5,430
-3.4615023103523500,20,25,110,500,5,390
-3.4616572144452400,78,80,110,200,2,90
-3.4622110992385800,18,25,150,175,7,25
-3.4624880681783600,42,45,110,325,3,215
-3.4626042665641300,4,10,70,225,6,155
-3.462725849329040,20,25,90,250,5,160
-3.4628348499821100,42,45,150,200,3,50
-3.463138626995110,20,25,170,475,5,305
-3.4642005971345900,20,25,160,350,5,190
-3.464693658431180,46,50,90,125,4,35
-3.4647357848950100,68,70,170,350,2,180
-3.464877361957110,36,40,140,175,4,35
-3.4650433157104600,42,45,120,325,3,205
-3.4650549657082400,98,100,60,150,2,90
-3.4650823443863,88,90,190,250,2,60
-3.4653163233005800,20,25,120,500,5,380
-3.4658837593729200,20,25,150,500,5,350
-3.4660559119034300,20,25,60,325,5,265
-3.46696122989488,30,35,160,175,5,15
-3.4669923162644000,68,70,180,475,2,295
-3.467122672884200,18,25,50,100,7,50
-3.4673105185124500,20,25,50,500,5,450
-3.4674186229574900,20,25,170,400,5,230
-3.467576548924870,68,70,140,500,2,360
-3.4690004175559400,20,25,100,475,5,375
-3.4691124849349400,88,90,90,175,2,85
-3.4691233163896700,68,70,50,350,2,300
-3.4692757034198500,26,30,190,475,4,285
-3.4694010248411400,20,25,60,375,5,315
-3.469408492656950,68,70,100,450,2,350
-3.4694968184748000,30,35,80,125,5,45
-3.4697943961030900,78,80,180,250,2,70
-3.4702678640624000,68,70,170,400,2,230
-3.4709611589989800,78,80,200,275,2,75
-3.4713946230258800,68,70,160,425,2,265
-3.4714762893141800,68,70,50,425,2,375
-3.4715390886911000,78,80,100,200,2,100
-3.4716112552267200,68,70,200,400,2,200
-3.4716271385991100,20,25,170,325,5,155
-3.4718018682387800,68,70,130,500,2,370
-3.47253041729038,20,25,50,450,5,400
-3.472531887732210,68,70,50,375,2,325
-3.472727889478490,98,100,200,250,2,50
-3.4727760183580500,20,25,180,475,5,295
-3.4728514263966900,20,25,50,275,5,225
-3.472940137487870,68,70,110,500,2,390
-3.4733755461149900,56,60,80,100,4,20
-3.473472404593550,68,70,180,450,2,270
-3.4735066210216400,20,25,190,450,5,260
-3.473586002761530,20,25,60,425,5,365
-3.4737261771415300,20,25,170,375,5,205
-3.473732692029850,68,70,170,475,2,305
-3.4739258177679600,68,70,160,475,2,315
-3.475000100187390,42,45,80,200,3,120
-3.4760595867868200,68,70,190,450,2,260
-3.476257529732630,44,50,90,100,6,10
-3.4762699633171000,20,25,160,325,5,165
-3.476717991377820,40,45,70,100,5,30
-3.476798077165910,42,45,170,275,3,105
-3.4768443741153100,68,70,50,400,2,350
-3.4771273142398400,52,55,200,250,3,50
-3.477190381907130,12,20,80,175,8,95
-3.4773506725184500,20,25,130,225,5,95
-3.4777588063739600,20,25,120,475,5,355
-3.477783610122190,68,70,70,500,2,430
-3.4777840696836100,92,95,90,100,3,10
-3.478009818559810,4,10,50,350,6,300
-3.4780306053525700,20,25,160,425,5,265
-3.478076542729430,68,70,170,375,2,205
-3.47817102774515,52,55,100,175,3,75
-3.4783634234641400,20,25,60,400,5,340
-3.4784720848548000,42,45,180,275,3,95
-3.4785336203580200,46,55,120,125,9,5
-3.4785684925759500,18,25,70,125,7,55
-3.478796970441700,20,25,100,425,5,325
-3.478815154108420,12,20,50,150,8,100
-3.4789221908738900,68,70,130,450,2,320
-3.4790120815938500,68,70,100,475,2,375
-3.4797861355799400,42,45,120,300,3,180
-3.479897017615310,20,25,130,400,5,270
-3.4808949122291600,20,25,90,450,5,360
-3.481097032503160,42,45,130,325,3,195
-3.4811630560082400,68,70,50,500,2,450
-3.4813316171793700,20,25,180,425,5,245
-3.4814622095398400,88,90,170,200,2,30
-3.481503050491440,68,70,160,400,2,240
-3.481725150433800,68,70,130,475,2,345
-3.481829621657180,68,70,90,450,2,360
-3.4824012016085100,66,70,140,150,4,10
-3.4825274596365800,78,80,180,225,2,45
-3.482675065191600,24,30,60,125,6,65
-3.4827732227791800,72,75,190,200,3,10
-3.4835170761773600,68,70,100,425,2,325
-3.4837456067872800,68,70,80,250,2,170
-3.483921246157100,78,80,90,200,2,110
-3.484403009133590,42,45,170,225,3,55
-3.484485370123220,68,70,60,325,2,265
-3.4848144592547100,12,20,90,175,8,85
-3.484972679968370,26,30,160,500,4,340
-3.485399455110590,20,25,130,500,5,370
-3.4857810430441800,68,70,170,425,2,255
-3.485844891428690,46,50,190,200,4,10
-3.486037359527430,20,25,160,475,5,315
-3.4860455630142900,98,100,80,150,2,70
-3.4861764912877000,68,70,70,225,2,155
-3.486202097581270,24,30,70,125,6,55
-3.4863133768701400,88,90,100,175,2,75
-3.4864298283840300,68,70,120,400,2,280
-3.4865000565317900,20,25,130,450,5,320
-3.4865229130628900,68,70,60,425,2,365
-3.4865488674982200,68,70,160,350,2,190
-3.486646047293550,78,80,50,175,2,125
-3.4867116939308400,20,25,170,425,5,255
-3.4869461066560000,26,30,180,500,4,320
-3.487171910773440,68,70,90,250,2,160
-3.4871996307298400,68,70,170,325,2,155
-3.487324654852750,26,30,120,450,4,330
-3.487411444500610,20,25,50,475,5,425
-3.4876137277190200,68,70,120,475,2,355
-3.4878358941868000,20,25,70,475,5,405
-3.4879379294892700,78,80,160,200,2,40
-3.48841374337219,46,50,60,100,4,40
-3.488821729788440,86,90,90,100,4,10
-3.4889349323534500,36,40,110,150,4,40
-3.489251726551510,68,70,110,475,2,365
-3.4892757506357300,20,25,110,475,5,365
-3.4897678303821700,68,70,200,425,2,225
-3.489864801861920,50,55,140,150,5,10
-3.4903484167452200,78,80,120,200,2,80
-3.4903910602757800,52,55,60,150,3,90
-3.490447668334120,68,70,130,225,2,95
-3.4905701687380300,68,70,50,450,2,400
-3.4907625456041000,20,25,90,225,5,135
-3.4910032615067800,20,25,90,400,5,310
-3.491437212619060,88,90,200,250,2,50
-3.491857547284340,26,30,50,375,4,325
-3.4918975699906900,20,25,90,350,5,260
-3.49240934613684,52,55,190,225,3,35
-3.492543438758740,20,25,160,300,5,140
-3.493059121495920,68,70,180,425,2,245
-3.493129661784630,14,20,200,500,6,300
-3.4931617074759300,20,25,140,500,5,360
-3.4934626261076200,68,70,110,450,2,340
-3.4936659441197400,68,70,50,475,2,425
-3.493816607338400,26,30,100,500,4,400
-3.4939121378625600,20,25,150,350,5,200
-3.4939580884626400,68,70,150,475,2,325
-3.494336385158100,68,70,150,400,2,250
-3.4943370854646700,68,70,60,375,2,315
-3.494764391411360,68,70,60,350,2,290
-3.494803527154590,68,70,120,425,2,305
-3.495139363655580,20,25,160,400,5,240
-3.4952465190024200,68,70,170,450,2,280
-3.495310916767620,68,70,150,350,2,200
-3.495426146369700,20,25,100,225,5,125
-3.495434348010750,42,45,180,250,3,70
-3.49614220824025,20,25,70,375,5,305
-3.4961997709718200,68,70,130,400,2,270
-3.4962103334983200,56,60,110,125,4,15
-3.4963544851370300,68,75,120,125,7,5
-3.4964519816511700,6,15,50,375,9,325
-3.496632869594790,20,25,80,350,5,270
-3.4966416892758800,42,45,110,200,3,90
-3.4966556905357800,68,70,200,300,2,100
-3.4969272984997600,20,25,80,275,5,195
-3.496958914154810,78,80,130,200,2,70
-3.4970397884608800,20,25,70,450,5,380
-3.4971570709310700,68,70,120,225,2,105
-3.4976829856036800,68,70,90,400,2,310
-3.4977052409994100,68,70,190,425,2,235
-3.4978825964283800,20,25,70,250,5,180
-3.497913926947190,68,70,160,300,2,140
-3.4980866855109100,20,25,130,475,5,345
-3.4981101519014700,20,25,100,250,5,150
-3.498376534777060,26,30,90,500,4,410
-3.498673743519610,18,25,160,175,7,15
-3.498687168718380,88,90,60,150,2,90
-3.4990202819301500,20,25,170,300,5,130
-3.499198493057390,20,25,130,425,5,295
-3.4994428290517100,42,45,60,200,3,140
-3.49961660327703,26,30,50,425,4,375
-3.4999076998142800,68,70,140,425,2,285
-3.5007635755581700,20,25,200,300,5,100
-3.5011194842353200,68,70,160,325,2,165
-3.5012238843449600,20,25,200,400,5,200
-3.5012723567061600,20,25,120,425,5,305
-3.5014807519520700,68,70,130,375,2,245
-3.5015911067469700,20,25,70,275,5,205
-3.501859855618300,20,25,180,400,5,220
-3.5018624998005000,68,70,140,450,2,310
-3.502076388642800,20,25,80,450,5,370
-3.502244927508450,42,45,200,275,3,75
-3.5022693172081800,20,25,80,225,5,145
-3.502276988866440,52,55,120,175,3,55
-3.502609665180010,68,70,150,450,2,300
-3.502660500755240,78,80,140,200,2,60
-3.5030210404597300,68,70,130,425,2,295
-3.503198758236430,20,25,150,225,5,75
-3.5033821483195,20,25,140,450,5,310
-3.503849696418300,20,25,150,400,5,250
-3.504080442558960,20,25,60,300,5,240
-3.504178818507300,68,70,180,400,2,220
-3.5042247793839400,42,45,180,225,3,45
-3.5043891993355500,20,25,130,250,5,120
-3.5044295295012900,30,35,130,150,5,20
-3.5044636034509200,20,25,180,450,5,270
-3.504668729902170,68,70,130,250,2,120
-3.5046869666538100,78,80,60,175,2,115
-3.5048027328269100,20,25,90,300,5,210
-3.5048922666511200,26,30,170,350,4,180
-3.5049408376216100,68,70,90,350,2,260
-3.5054116766344900,58,60,200,500,2,300
-3.5054778270804600,26,30,170,500,4,330
-3.5056857024591900,26,30,70,225,4,155
-3.5063807800394900,68,70,70,450,2,380
-3.5064140910558200,68,70,70,375,2,305
-3.506605888629380,20,25,190,350,5,160
-3.5071362009528900,20,25,120,250,5,130
-3.5074237880152500,68,70,80,450,2,370
-3.5074297796863400,68,70,70,475,2,405
-3.507811493489440,68,70,180,375,2,195
-3.5078302558650200,12,20,190,225,8,35
-3.507878850323460,20,25,110,450,5,340
-3.508064717609950,68,70,120,250,2,130
-3.5081605065973700,58,60,200,475,2,275
-3.5083206842589700,68,70,50,275,2,225
-3.5083833259837100,68,70,80,475,2,395
-3.5085085623305300,68,70,110,425,2,315
-3.5088934942018400,30,35,90,125,5,35
-3.50894760033914,26,30,90,475,4,385
-3.5089723705582500,68,70,140,400,2,260
-3.509032635580080,20,25,80,375,5,295
-3.5092083639043800,92,95,110,125,3,15
-3.50928302339633,12,20,100,175,8,75
-3.5096502512529800,68,70,100,400,2,300
-3.5098081262193200,68,70,150,425,2,275
-3.509820722136580,20,25,120,400,5,280
-3.509866826288410,26,30,200,450,4,250
-3.5099719912562600,4,10,50,275,6,225
-3.510222256620740,68,70,190,400,2,210
-3.5102432278074100,42,45,190,275,3,85
-3.510478157768950,26,30,90,250,4,160
-3.510629350989280,68,70,80,500,2,420
-3.510651414721690,20,25,100,400,5,300
-3.5106600540054700,14,20,190,500,6,310
-3.5106960458191600,68,70,60,400,2,340
-3.5108905081146900,20,25,70,425,5,355
-3.5114211242659200,4,10,50,375,6,325
-3.5117262929185500,88,90,190,225,2,35
-3.5119955608849200,20,25,140,275,5,135
-3.512205918174620,20,25,170,450,5,280
-3.5123736466352300,14,20,200,475,6,275
-3.5124107698189300,68,70,150,325,2,175
-3.5126410541313900,88,90,70,150,2,80
-3.512921762005790,12,20,60,150,8,90
-3.5131522259030100,20,25,130,375,5,245
-3.513210332046420,20,25,140,225,5,85
-3.5134560604125500,20,25,200,425,5,225
-3.513480699682790,68,70,190,375,2,185
-3.5138514091048800,26,30,50,350,4,300
-3.513943176468570,20,25,150,450,5,300
-3.5140078602992600,68,70,180,325,2,145
-3.5143466724530700,26,30,50,500,4,450
-3.5143787632601700,68,70,90,425,2,335
-3.5145282445423900,68,70,160,375,2,215
-3.5145706288982400,20,25,180,350,5,170
-3.5148680107859800,42,45,90,200,3,110
-3.514944482514180,26,30,50,450,4,400
-3.514960599252190,36,40,180,200,4,20
-3.5150362158645800,68,70,170,300,2,130
-3.515045062110520,68,70,70,350,2,280
-3.5152589971044500,26,30,160,350,4,190
-3.515328661187780,42,45,50,200,3,150
-3.5153569289556400,68,70,140,275,2,135
-3.515451937535110,68,70,90,375,2,285
-3.5157413774599100,26,30,100,450,4,350
-3.5158118120803700,68,70,140,475,2,335
-3.5161185121483100,72,75,100,125,3,25
-3.516147192305280,26,30,110,500,4,390
-3.5165088044409700,20,25,80,475,5,395
-3.516593309972200,88,90,120,175,2,55
-3.5167235645921500,68,70,190,350,2,160
-3.5167293033637100,26,30,170,400,4,230
-3.517340402520520,20,25,180,375,5,195
-3.517414743802000,98,100,50,125,2,75
-3.5178591217411800,20,25,190,425,5,235
-3.518102791847930,68,70,60,300,2,240
-3.5183856465473400,26,30,120,500,4,380
-3.518520092026530,6,15,70,225,9,155
-3.518693837546890,78,80,70,175,2,105
-3.5187083894044300,26,30,50,400,4,350
-3.519040767423260,20,25,140,400,5,260
-3.519349347211110,68,70,160,450,2,290
-3.5196978404751300,26,30,180,475,4,295
-3.5197491131851900,68,70,140,250,2,110
-3.5199924068594200,68,70,100,225,2,125
-3.5202190175383200,26,30,170,475,4,305
-3.5205706093881900,20,25,150,475,5,325
-3.5208819336457500,20,25,140,250,5,110
-3.521153360604040,68,70,200,375,2,175
-3.5211847807033300,68,70,80,350,2,270
-3.5213887271700300,14,20,190,475,6,285
-3.521580437039550,52,55,70,150,3,80
-3.521743262041130,42,45,100,200,3,100
-3.5220877176063200,26,30,60,350,4,290
-3.5221273744073300,26,30,60,325,4,265
-3.52214484464465,20,25,180,325,5,145
-3.522155632604700,28,35,90,100,7,10
-3.522290977564150,68,70,80,225,2,145
-3.5223670554659000,20,25,90,375,5,285
-3.5224485505531100,20,25,190,325,5,135
-3.522502840518750,78,80,110,175,2,65
-3.522519545589630,26,30,80,250,4,170
-3.522660513956570,36,40,60,125,4,65
-3.522738610012480,36,40,120,150,4,30
-3.5227977193339700,68,70,180,350,2,170
-3.522853119952320,20,25,80,500,5,420
-3.5230908185615400,20,25,60,500,5,440
-3.523144629697040,26,30,130,500,4,370
-3.5231949839932800,22,30,110,125,8,15
-3.523311292423880,26,30,100,475,4,375
-3.523378763668270,76,80,170,175,4,5
-3.523560425755230,68,70,140,375,2,235
-3.5238291955531800,68,70,90,225,2,135
-3.523913184419170,20,25,150,425,5,275
-3.5240753530861000,26,30,160,425,4,265
-3.5243895888082900,20,25,140,350,5,210
-3.5244565654744900,26,30,150,500,4,350
-3.5245052743613300,68,70,80,275,2,195
-3.524606757680780,68,70,100,375,2,275
-3.5246382392669500,68,70,70,275,2,205
-3.524847589230780,20,25,140,425,5,285
-3.52499788068116,68,70,190,325,2,135
-3.5251884182088000,68,70,100,275,2,175
-3.5251897871717500,14,20,90,250,6,160
-3.525377397716810,68,70,80,375,2,295
-3.5254640472973200,96,100,170,175,4,5
-3.525558466639830,12,20,190,250,8,60
-3.525577716273460,26,30,130,225,4,95
-3.5256645999875000,42,45,160,200,3,40
-3.5256807682051600,14,20,180,500,6,320
-3.5257249275441700,20,25,190,375,5,185
-3.5259273177398400,26,30,50,475,4,425
-3.5259309427905600,20,25,110,425,5,315
-3.5261268043637900,20,25,190,400,5,210
-3.5261849107551400,26,30,60,375,4,315
-3.5263382121449800,26,30,100,225,4,125
-3.526357111989380,20,25,60,475,5,415
-3.5263856723869700,20,25,50,225,5,175
-3.5267513141243400,20,25,90,425,5,335
-3.5272545896785700,20,25,150,325,5,175
-3.52751972137619,12,20,120,175,8,55
-3.5276634455252600,14,20,60,325,6,265
-3.5280391071921000,78,80,90,175,2,85
-3.5280625302566000,68,70,80,425,2,345
-3.5283203609162600,20,25,60,450,5,390
-3.528333294794030,58,60,190,500,2,310
-3.52840599280013,68,70,90,300,2,210
-3.528536450267470,26,30,190,450,4,260
-3.5285959220902200,68,70,110,400,2,290
-3.528667543406080,6,15,50,350,9,300
-3.5286741971611800,62,65,80,125,3,45
-3.528692796495600,20,25,50,300,5,250
-3.5287741362835300,26,30,200,400,4,200
-3.528835800578300,68,70,120,350,2,230
-3.52891572027233,68,70,200,325,2,125
-3.528958076465640,26,30,130,450,4,320
-3.528969240812490,24,30,50,100,6,50
-3.529026384266800,68,70,70,425,2,355
-3.529474230260200,68,70,100,250,2,150
-3.5295719019838100,68,70,60,500,2,440
-3.529778730366620,14,20,50,375,6,325
-3.5301078964046400,78,80,80,175,2,95
-3.5301555230020100,20,25,200,350,5,150
-3.530262302036910,68,70,60,475,2,415
-3.5303449293128400,26,30,70,500,4,430
-3.5306240474681400,68,70,200,350,2,150
-3.5308399355758900,20,25,90,275,5,185
-3.5311164513414700,20,25,160,375,5,215
-3.531147671189130,14,20,50,350,6,300
-3.5315107321747600,26,30,120,225,4,105
-3.531563854038830,20,25,160,450,5,290
-3.531653723862870,20,25,70,350,5,280
-3.5319287001714500,20,25,100,275,5,175
-3.5320293713739700,52,60,120,125,8,5
-3.5328000755755500,68,70,180,300,2,120
-3.532856670947250,68,70,110,250,2,140
-3.533268109817290,68,70,120,375,2,255
-3.533418164587630,68,70,60,225,2,165
-3.533435267848320,26,30,160,475,4,315
-3.5334750374139500,20,25,140,475,5,335
-3.533487214830370,4,10,150,225,6,75
-3.5334985801163200,20,25,140,375,5,235
-3.533581387247200,26,30,130,475,4,345
-3.5336232016400600,26,30,60,425,4,365
-3.533915636066100,68,70,90,275,2,185
-3.533926873914640,20,25,190,300,5,110
-3.533935891666190,62,65,160,175,3,15
-3.533952785123000,26,30,100,425,4,325
-3.533983888813480,98,100,100,150,2,50
-3.5344340301798700,98,100,90,150,2,60
-3.5347610511965400,20,25,110,250,5,140
-3.5347925474199500,68,70,150,225,2,75
-3.5348351108749300,6,15,200,500,9,300
-3.5349641211419100,26,30,160,325,4,165
-3.534996668955650,14,20,70,225,6,155
-3.5351667238859100,68,70,110,350,2,240
-3.535252508774560,20,25,110,225,5,115
-3.5353651815380700,68,70,70,250,2,180
-3.535743518012660,20,25,200,325,5,125
-3.5360530959657500,42,45,120,200,3,80
-3.536369249707810,20,25,60,225,5,165
-3.5364017234014400,68,70,150,375,2,225
-3.5365438958052200,20,25,180,300,5,120
-3.53656057093138,22,30,80,100,8,20
-3.5366205694790200,14,20,80,250,6,170
-3.536959645650390,68,70,140,225,2,85
-3.5370040982126800,68,70,70,325,2,255
-3.5372727317997800,26,30,170,425,4,255
-3.5374676228673500,26,30,170,375,4,205
-3.537543273448920,20,25,140,300,5,160
-3.5380122092825700,68,70,100,300,2,200
-3.5381422669032100,20,25,100,325,5,225
-3.5381675387325600,14,20,50,400,6,350
-3.5382309729930700,14,20,90,500,6,410
-3.5385230428918300,20,25,50,250,5,200
-3.5385386864515200,20,25,100,375,5,275
-3.5386028261651300,62,65,90,125,3,35
-3.5386334214170800,36,40,150,175,4,25
-3.5386586477536800,20,25,110,375,5,265
-3.538721337480810,68,70,90,325,2,235
-3.5388896710767000,26,30,140,500,4,360
-3.5390949581463200,20,25,80,425,5,345
-3.539648615548780,24,30,160,175,6,15
-3.53985095159969,26,30,170,325,4,155
-3.540020035031070,14,20,120,450,6,330
-3.5400712897197300,68,70,100,350,2,250
-3.540297563049570,42,45,130,200,3,70
-3.5404164375354100,26,30,70,275,4,205
-3.540420178531240,68,70,100,325,2,225
-3.540556099345020,20,25,50,325,5,275
-3.5406444439785000,20,25,100,300,5,200
-3.540718375432860,20,25,150,300,5,150
-3.5407604209699100,26,30,90,450,4,360
-3.5409910373586500,68,70,140,350,2,210
-3.5414102171062900,14,20,60,425,6,365
-3.5414979197601500,88,90,80,150,2,70
-3.5415658257768300,20,25,70,200,5,130
-3.541865492524850,6,15,50,275,9,225
-3.5419939202985400,58,60,190,475,2,285
-3.542290209967190,42,45,50,175,3,125
-3.542356166441750,68,70,50,225,2,175
-3.542684536611680,14,20,160,500,6,340
-3.5429937813367400,20,25,70,300,5,230
-3.5429954041805200,14,20,170,350,6,180
-3.5431814540083000,18,25,130,150,7,20
-3.543288350453690,6,15,50,400,9,350
-3.5432981406258300,26,30,50,275,4,225
-3.543324737551240,26,30,80,375,4,295
-3.543466634789430,52,55,80,150,3,70
-3.543521892539240,20,25,90,325,5,235
-3.5436730485726800,68,70,110,375,2,265
-3.5438406649907700,42,45,60,175,3,115
-3.54385166868478,20,25,200,375,5,175
-3.5440840746948100,14,20,100,500,6,400
-3.544399078377000,98,100,200,225,2,25
-3.5445814396113300,58,60,120,450,2,330
-3.5448618885151100,20,25,70,325,5,255
-3.5450609757280700,20,25,110,350,5,240
-3.5450626477961500,26,30,150,225,4,75
-3.545224082693440,20,25,120,350,5,230
-3.545385030900770,26,30,60,400,4,340
-3.5454000744927500,26,30,180,425,4,245
-3.5454641175963900,20,25,70,400,5,330
-3.5464867081672100,68,70,120,275,2,155
-3.546576699432510,6,15,90,250,9,160
-3.5467342694337900,26,30,120,475,4,355
-3.546898003677590,68,70,60,450,2,390
-3.5472566566072400,42,45,140,200,3,60
-3.5472584824157300,26,30,90,225,4,135
-3.5473015421625600,26,30,170,450,4,280
-3.5473185563882200,68,70,190,300,2,110
-3.5475513667638800,26,30,130,375,4,245
-3.54813659048079,14,20,50,425,6,375
-3.548290432170740,30,35,190,200,5,10
-3.5487015296319200,20,25,110,400,5,290
-3.5487639969648600,14,20,60,375,6,315
-3.5488908735806300,78,80,190,250,2,60
-3.5489829360879,26,30,70,450,4,380
-3.5492410630924800,26,30,70,375,4,305
-3.549511394891280,26,30,180,450,4,270
-3.5495892832982500,20,25,120,275,5,155
-3.5497574766483300,68,70,110,275,2,165
-3.5498553953734900,34,40,140,150,6,10
-3.549882059818720,68,70,140,300,2,160
-3.549886576811850,68,70,130,350,2,220
-3.550257558269070,68,70,70,400,2,330
-3.5504146833394500,26,30,140,450,4,310
-3.550511175748650,58,60,160,500,2,340
-3.550579227625070,98,100,130,175,2,45
-3.5506168518774600,20,25,60,250,5,190
-3.5506456554313500,68,70,160,275,2,115
-3.5506667751843900,46,50,100,125,4,25
-3.55068451489627,26,30,90,350,4,260
-3.550819827530130,26,30,160,400,4,240
-3.5512106519861100,14,20,90,475,6,385
-3.551309429980880,58,60,90,500,2,410
-3.5513206969269700,26,30,60,300,4,240
-3.5513451262259100,24,30,80,125,6,45
-3.551491036530210,26,30,110,475,4,365
-3.5516811292507300,14,20,60,350,6,290
-3.5519185292252800,26,30,70,475,4,405
-3.55198347638973,20,25,100,350,5,250
-3.5520508427587400,68,70,80,400,2,320
-3.5521820021415000,58,60,180,500,2,320
-3.552200550018310,36,40,70,125,4,55
-3.5522277389140100,26,30,90,400,4,310
-3.5522305075077900,98,100,140,175,2,35
-3.552246679047480,6,15,50,425,9,375
-3.5522902331027300,26,30,150,400,4,250
-3.5525756458809600,68,70,150,300,2,150
-3.5526495118788700,20,25,80,400,5,320
-3.552774086428900,6,15,150,225,9,75
-3.5528034744404600,20,25,80,325,5,245
-3.5529149636866100,20,25,130,350,5,220
-3.5529520923705400,14,20,100,475,6,375
-3.553276849687690,18,25,80,125,7,45
-3.5532917464172300,26,30,80,450,4,370
-3.553415289084310,62,65,130,150,3,20
-3.553422019469200,68,70,50,300,2,250
-3.553540036775670,20,25,160,275,5,115
-3.553870258548200,78,80,170,200,2,30
-3.554101860693060,18,25,190,200,7,10
-3.5541353859814200,26,30,130,250,4,120
-3.554270405377690,4,10,60,325,6,265
-3.5546423674071400,26,30,110,450,4,340
-3.554676599534290,20,25,110,275,5,165
-3.5548518145230000,68,70,110,225,2,115
-3.5548959752341700,6,15,200,475,9,275
-3.555416087469240,20,25,150,375,5,225
-3.5554808206758300,42,45,70,175,3,105
-3.5556033758628000,14,20,200,450,6,250
-3.5556053354912100,68,70,80,325,2,245
-3.5556307818466300,58,60,90,475,2,385
-3.5557447848439600,26,30,130,400,4,270
-3.5560104183422000,26,30,160,300,4,140
-3.556082975118770,26,30,170,300,4,130
-3.556130547080980,52,55,200,225,3,25
-3.556182665852940,68,70,70,200,2,130
-3.5573493274353500,58,60,200,450,2,250
-3.5580425540874200,26,30,120,425,4,305
-3.5582511611910900,26,30,70,250,4,180
-3.5583847614040400,26,30,70,425,4,355
-3.5585229006662300,58,60,100,500,2,400
-3.558625500697460,58,60,170,350,2,180
-3.5586550793963900,14,20,120,225,6,105
-3.5587056260455000,26,30,130,425,4,295
-3.558921498707960,26,30,110,425,4,315
-3.5590788958178400,58,60,100,475,2,375
-3.559085880124990,26,30,150,475,4,325
-3.559148112946250,68,70,50,250,2,200
-3.559446565945860,14,20,170,500,6,330
-3.559675024790780,44,50,170,175,6,5
-3.5597303214260200,14,20,50,450,6,400
-3.560138401301780,26,30,140,250,4,110
-3.5602079099091400,26,30,200,425,4,225
-3.5602792915102300,26,30,120,400,4,280
-3.560326765989210,14,20,50,275,6,225
-3.5603576940966900,14,20,150,225,6,75
-3.560365646482330,26,30,160,375,4,215
-3.5604971102460600,26,30,80,350,4,270
-3.5604998656350100,16,25,110,125,9,15
-3.560515184801050,6,15,80,250,9,170
-3.561066574023380,68,70,170,250,2,80
-3.5612313107802600,26,30,80,275,4,195
-3.561257430997780,14,20,130,225,6,95
-3.5613595681733400,26,30,190,425,4,235
-3.5614003287527300,20,25,60,275,5,215
-3.5615663553996100,58,60,150,500,2,350
-3.561669571640980,74,80,120,125,6,5
-3.5616872607270900,30,35,60,100,5,40
-3.5617063054966200,24,30,90,125,6,35
-3.56184219447407,20,25,120,375,5,255
-3.5618772388834,12,20,70,150,8,80
-3.562168632588490,6,15,60,325,9,265
-3.5622091676053200,26,30,180,375,4,195
-3.5622251900997500,26,30,140,225,4,85
-3.562453804477720,4,10,50,225,6,175
-3.5625090135097600,4,10,50,400,6,350
-3.5627311318931700,68,70,80,300,2,220
-3.5629440120335400,6,15,130,225,9,95
-3.5629803848836200,26,30,150,450,4,300
-3.56323412566099,78,80,50,150,2,100
-3.5632908388829200,26,30,140,400,4,260
-3.5634190017660100,26,30,90,300,4,210
-3.563512635219790,26,30,80,500,4,420
-3.563676413869500,26,30,200,300,4,100
-3.5637939263437700,26,30,90,275,4,185
-3.563827338065120,68,70,70,300,2,230
-3.5638377040720900,26,30,80,475,4,395
-3.563844079851640,20,25,150,200,5,50
-3.5647318929295900,26,30,80,425,4,345
-3.565257982598080,52,55,100,150,3,50
-3.5654376516120500,72,75,70,100,3,30
-3.565451413785030,14,20,50,500,6,450
-3.5656297324657900,68,70,50,325,2,275
-3.5657652687173600,26,30,60,475,4,415
-3.5657693513931200,14,20,70,375,6,305
-3.5658711958792800,14,20,160,425,6,265
-3.5660875024495000,40,45,80,100,5,20
-3.5662190211817800,58,60,170,400,2,230
-3.566267379745230,14,20,150,500,6,350
-3.5664368738187700,14,20,100,450,6,350
-3.566984623510790,20,25,170,250,5,80
-3.5672918637455900,14,20,170,400,6,230
-3.5672940280899500,20,25,150,275,5,125
-3.5673013745759800,14,20,120,500,6,380
-3.5673689273115100,14,20,90,225,6,135
-3.5674185220027100,28,35,170,175,7,5
-3.567568553458410,18,25,90,125,7,35
-3.567628804129790,6,15,60,350,9,290
-3.567652759259300,68,70,150,250,2,100
-3.56772869577635,58,60,170,500,2,330
-3.567876656973750,68,70,110,300,2,190
-3.568174879387480,42,45,110,175,3,65
-3.5683466678687300,26,30,120,250,4,130
-3.56896129002776,68,70,150,275,2,125
-3.5693539208098900,68,70,130,275,2,145
-3.569858860687760,58,60,120,500,2,380
-3.5700828256152200,26,30,150,350,4,200
-3.5700895299396200,26,30,140,425,4,285
-3.5702709439082300,26,30,190,400,4,210
-3.570474986997870,78,80,100,175,2,75
-3.570487484385630,58,60,190,450,2,260
-3.5704947770579500,58,60,130,500,2,370
-3.5710491115354800,88,90,130,175,2,45
-3.571216252245140,20,25,80,300,5,220
-3.5712715377019400,26,30,100,400,4,300
-3.5713253455760700,52,55,50,125,3,75
-3.571620463062410,58,60,160,425,2,265
-3.5716949129170700,6,15,190,500,9,310
-3.5720330128155500,26,30,190,350,4,160
-3.572143519798180,14,20,70,500,6,430
-3.5722947707442800,26,30,90,375,4,285
-3.572297436660910,14,20,160,475,6,315
-3.572332348841570,68,70,60,250,2,190
-3.5724646716563200,14,20,180,475,6,295
-3.572559344046280,26,30,100,250,4,150
-3.572581350706510,26,30,150,325,4,175
-3.5725926204599700,4,10,90,250,6,160
-3.572739400442790,12,20,200,250,8,50
-3.5730126539557100,20,25,160,250,5,90
-3.5730206286405000,26,30,200,350,4,150
-3.5731646261673900,14,20,60,300,6,240
-3.5734310858696900,68,70,60,275,2,215
-3.573542585034860,26,30,180,325,4,145
-3.5736323474994300,58,60,80,250,2,170
-3.5736643627892700,26,30,80,225,4,145
-3.573811763925390,88,90,50,125,2,75
-3.573842731082060,14,20,160,325,6,165
-3.573873572967410,14,20,170,325,6,155
-3.5738852153291000,6,15,60,375,9,315
-3.574033397691200,20,25,110,300,5,190
-3.5744031543053000,26,30,140,375,4,235
-3.5746187436491200,14,20,170,475,6,305
-3.5747781705856200,40,45,110,125,5,15
-3.575077750040450,42,45,190,250,3,60
-3.5751704233876300,58,60,100,450,2,350
-3.5752144473367,58,60,120,225,2,105
-3.575346037325460,26,30,180,400,4,220
-3.5753682001444200,68,70,110,325,2,215
-3.5757267992705300,26,30,140,275,4,135
-3.5758354826276600,58,60,100,425,2,325
-3.5759061129539500,58,60,50,425,2,375
-3.5760923800095600,6,15,120,225,9,105
-3.576316719917570,58,60,50,375,2,325
-3.576416561566360,58,60,170,375,2,205
-3.5765327199569600,58,60,160,350,2,190
-3.576670360923120,88,90,100,150,2,50
-3.57686082765484,58,60,170,325,2,155
-3.5768801370402400,26,30,200,375,4,175
-3.5769192204015200,26,30,190,375,4,185
-3.5770112265382900,14,20,190,450,6,260
-3.5770827055436500,6,15,50,500,9,450
-3.5772247737234300,26,30,70,325,4,255
-3.577380019667910,26,30,140,350,4,210
-3.577410586334790,20,25,130,275,5,145
-3.577423948948280,26,30,50,300,4,250
-3.5774321542131700,58,60,180,475,2,295
-3.5777584982866400,14,20,90,400,6,310
-3.577807257405050,14,20,60,400,6,340
-3.578036587962750,14,20,120,475,6,355
-3.5781171093710100,92,95,140,150,3,10
-3.578307893619420,58,60,140,500,2,360
-3.578482331198200,26,30,50,250,4,200
-3.57850728564384,26,30,70,350,4,280
-3.578711763328670,26,30,150,425,4,275
-3.5787567619204800,58,60,50,350,2,300
-3.578781248561840,26,30,160,450,4,290
-3.5789369712764,52,55,90,150,3,60
-3.5793223281848700,14,20,140,500,6,360
-3.5793403525102800,58,60,110,500,2,390
-3.57955562376062,58,60,60,425,2,365
-3.5797706240893300,20,25,160,225,5,65
-3.5798026452618800,58,60,180,425,2,245
-3.5799968890295100,98,100,110,150,2,40
-3.5800322021681000,26,30,180,350,4,170
-3.5801959842213300,58,60,170,475,2,305
-3.5802650926083300,68,70,120,325,2,205
-3.580300694614270,26,30,110,250,4,140
-3.580457542137380,26,30,100,300,4,200
-3.5804707295966500,14,20,50,475,6,425
-3.5806374197558800,26,30,60,500,4,440
-3.580995256923040,26,30,200,325,4,125
-3.5810744453746300,26,30,140,475,4,335
-3.581122234853980,14,20,170,425,6,255
-3.5812389952188700,26,30,110,225,4,115
-3.581376091466090,26,30,190,325,4,135
-3.5815485245661600,26,30,100,350,4,250
-3.5819867677865500,24,30,130,150,6,20
-3.582380888205980,58,60,130,400,2,270
-3.5824194697935300,14,20,160,350,6,190
-3.5824579436026700,20,25,120,325,5,205
-3.582694119412360,52,55,130,175,3,45
-3.5830303673594200,68,70,130,300,2,170
-3.5831643911869800,58,60,70,225,2,155
-3.583207306571850,20,25,150,250,5,100
-3.5832848287499700,52,55,140,175,3,35
-3.583597252405030,14,20,130,500,6,370
-3.5838700530544000,12,20,200,225,8,25
-3.5841528310653800,26,30,60,250,4,190
-3.5842336535045000,68,70,140,325,2,185
-3.5843313563772300,14,20,170,375,6,205
-3.584360948915310,6,15,190,475,9,285
-3.584416794073850,68,70,130,325,2,195
-3.5845086789924700,14,20,160,300,6,140
-3.5845743715353900,4,10,80,250,6,170
-3.5846357928921900,14,20,100,425,6,325
-3.5849410069214900,58,60,150,400,2,250
-3.5849890274348700,46,50,70,100,4,30
-3.5850675139463800,14,20,140,225,6,85
-3.5856374249561800,18,25,60,100,7,40
-3.5856745413589100,14,20,160,400,6,240
-3.5859061195882300,42,45,80,175,3,95
-3.5859868194329300,58,60,120,475,2,355
-3.586114879365000,58,60,50,500,2,450
-3.5863069225581900,82,85,80,100,3,20
-3.5863796874290800,14,20,90,300,6,210
-3.58666568462765,58,65,120,125,7,5
-3.586766106917810,14,20,100,225,6,125
-3.5867759835232100,58,60,160,475,2,315
-3.58693228650041,58,60,50,400,2,350
-3.587579091660720,14,20,130,450,6,320
-3.5875850499913200,58,60,70,500,2,430
-3.587594239782010,58,60,50,450,2,400
-3.587873899156910,78,80,190,225,2,35
-3.5879481624567900,58,60,90,450,2,360
-3.588017782438590,4,10,120,225,6,105
-3.5880884006446500,50,55,90,100,5,10
-3.5884296563653800,58,60,170,425,2,255
-3.589128090867910,6,15,50,225,9,175
-3.5892936758724700,6,15,90,225,9,135
-3.5895450860773900,58,60,140,400,2,260
-3.589770447713750,58,60,130,425,2,295
-3.589969737629380,26,30,90,425,4,335
-3.59005752273416,62,65,60,100,3,40
-3.59050076203603,14,20,80,275,6,195
-3.590569471496380,68,70,170,275,2,105
-3.5907504511894000,22,30,140,150,8,10
-3.590857370010310,26,30,100,325,4,225
-3.5909559038825700,14,20,140,250,6,110
-3.59104292764997,68,70,160,250,2,90
-3.591137994675870,14,20,200,300,6,100
-3.591199401825360,58,60,90,250,2,160
-3.591254595979290,20,25,110,200,5,90
-3.5913108468634500,26,30,180,300,4,120
-3.591494061481550,26,30,90,325,4,235
-3.591538639543440,14,20,90,450,6,360
-3.5916198714482100,20,25,110,325,5,215
-3.5919198289459900,26,30,120,350,4,230
-3.5920250951849000,14,20,110,500,6,390
-3.592080986944560,26,30,60,225,4,165
-3.5920993473037400,26,30,100,375,4,275
-3.5922578000383200,88,90,140,175,2,35
-3.592527562958530,26,30,80,400,4,320
-3.592731641277540,14,20,110,475,6,365
-3.5933569484097000,6,15,180,500,9,320
-3.5934350969581700,58,60,130,450,2,320
-3.5936403793839800,6,15,50,450,9,400
-3.593758396998820,68,70,150,200,2,50
-3.5937597262166400,26,30,120,275,4,155
-3.5937599649858500,6,15,60,300,9,240
-3.5938156327776200,84,90,120,125,6,5
-3.5938263928596000,58,60,110,475,2,365
-3.5938488106623500,58,60,160,400,2,240
-3.594262754764940,26,30,50,225,4,175
-3.594288580941450,14,20,80,350,6,270
-3.5944138345029600,14,20,70,475,6,405
-3.594495687608790,58,60,130,475,2,345
-3.5945321878385300,26,30,60,450,4,390
-3.594655180036370,58,60,60,375,2,315
-3.594728754282400,56,60,140,150,4,10
-3.5947355016277300,58,60,50,475,2,425
-3.5947457563357800,14,20,80,225,6,145
-3.5948233936095200,14,20,150,400,6,250
-3.594880385387930,26,30,100,275,4,175
-3.5949144253169600,78,80,60,150,2,90
-3.5949537113477100,26,30,160,275,4,115
-3.594961523648660,66,70,90,100,4,10
-3.5952038692276300,58,60,120,425,2,305
-3.595282491208160,14,20,180,450,6,270
-3.595500286570580,58,60,150,350,2,200
-3.5955627294541900,58,60,150,450,2,300
-3.5956949144945500,68,70,160,225,2,65
-3.5960475779842900,26,30,130,350,4,220
-3.596113987185570,26,30,110,275,4,165
-3.596420036799830,12,20,50,125,8,75
-3.596850579502970,14,20,130,475,6,345
-3.596894716819480,4,10,130,225,6,95
-3.596907448912430,58,60,120,400,2,280
-3.597243802243780,20,25,140,325,5,185
-3.597676998580640,14,20,70,350,6,280
-3.5978443600218500,26,30,50,325,4,275
-3.597880196349010,14,20,70,325,6,255
-3.5980389857435900,14,20,90,350,6,260
-3.5984453105559700,58,60,200,400,2,200
-3.598454778585860,26,30,70,400,4,330
-3.5985204015414300,14,20,70,275,6,205
-3.5987346371092900,14,20,130,400,6,270
-3.598800118540390,58,60,180,375,2,195
-3.598909742580500,58,60,60,350,2,290
-3.5991611445487000,14,20,200,400,6,200
-3.599430243979730,58,60,90,400,2,310
-3.599860747880310,58,60,110,450,2,340
-3.600088648387810,14,20,70,250,6,180
-3.6000968901775200,98,100,60,125,2,65
-3.600164473951370,26,30,110,350,4,240
-3.6002193658994800,58,60,170,450,2,280
-3.6003117175824900,58,60,60,325,2,265
-3.6003321630037500,68,70,170,225,2,55
-3.6003703905911800,58,60,180,450,2,270
-3.6005466604611500,36,40,50,100,4,50
-3.600627322558560,14,20,180,425,6,245
-3.6006525206979800,42,45,90,175,3,85
-3.6006907297465700,58,60,160,325,2,165
-3.6007090814583900,98,100,70,125,2,55
-3.600747406986960,12,20,100,150,8,50
-3.6007659205995000,58,60,140,425,2,285
-3.6010431204402500,14,20,150,450,6,300
-3.601649427792400,6,15,50,475,9,425
-3.601697150460680,14,20,120,425,6,305
-3.6019644277676900,12,20,80,150,8,70
-3.6019768983288400,14,20,150,350,6,200
-3.602251397996030,68,70,180,275,2,95
-3.6023763883092100,58,60,130,225,2,95
-3.602397909949280,4,10,50,425,6,375
-3.6024570016954800,14,20,140,400,6,260
-3.6027890202702400,58,60,140,450,2,310
-3.6028804002682300,88,90,200,225,2,25
-3.602957257561400,88,90,90,150,2,60
-3.603013779778050,58,60,150,475,2,325
-3.603132175549480,20,25,60,200,5,140
-3.603456258788490,68,70,120,300,2,180
-3.603520364540520,26,30,110,400,4,290
-3.603632109171860,16,25,80,100,9,20
-3.6036425983299200,58,60,70,375,2,305
-3.604472300615020,26,30,60,275,4,215
-3.604570437755100,58,60,200,300,2,100
-3.6046913422117200,78,80,200,250,2,50
-3.6048477021425600,6,15,60,425,9,365
-3.6050773084584000,26,30,120,375,4,255
-3.6050883349372700,6,15,120,450,9,330
-3.605174071213440,6,15,90,500,9,410
-3.605178577471070,26,30,70,200,4,130
-3.6052557695764300,14,20,80,375,6,295
-3.6053227086895700,14,20,110,425,6,315
-3.6056851901953000,58,60,130,250,2,120
-3.6058553335298400,58,60,60,400,2,340
-3.605901014792260,30,35,100,125,5,25
-3.605910570519630,26,30,80,325,4,245
-3.6060123471250200,58,60,130,375,2,245
-3.6060185124728400,58,60,90,225,2,135
-3.606155910559910,42,45,100,175,3,75
-3.606179520520530,42,45,170,200,3,30
-3.606379864757130,14,20,150,475,6,325
-3.606547697491840,26,30,150,250,4,100
-3.606596228249230,14,20,50,300,6,250
-3.6066493891789000,20,25,170,225,5,55
-3.6069956840084700,14,20,170,450,6,280
-3.6070900793375500,26,30,190,300,4,110
-3.607231391146810,6,15,80,225,9,145
-3.6073920462578200,62,65,190,200,3,10
-3.607520215268020,58,60,70,475,2,405
-3.6075596668851100,26,30,70,300,4,230
-3.6076392684310700,20,25,180,275,5,95
-3.607752623744530,14,20,70,450,6,380
-3.6086714271574,58,60,100,225,2,125
-3.6087909350655400,58,60,150,425,2,275
-3.608945017589680,14,20,150,325,6,175
-3.609006609282560,14,20,50,225,6,175
-3.6092480493742300,20,25,130,300,5,170
-3.6096488833202400,14,20,80,475,6,395
-3.6100570636500800,20,25,130,325,5,195
-3.6104735093672400,58,60,70,450,2,380
-3.6106064700396100,58,60,190,425,2,235
-3.610650752771400,6,15,50,250,9,200
-3.610661176817440,14,20,200,425,6,225
-3.6107959411562600,58,60,160,450,2,290
-3.6108419490221400,14,20,120,400,6,280
-3.611068403453380,14,20,90,275,6,185
-3.6112897706471100,58,60,80,375,2,295
-3.611418787438590,58,60,190,400,2,210
-3.6117148925752900,14,20,130,250,6,120
-3.6118165841045900,14,20,170,300,6,130
-3.6118173199897900,14,20,180,400,6,220
-3.611901932938920,14,20,80,450,6,370
-3.6119309512054300,20,25,170,275,5,105
-3.6122341680273700,58,60,90,350,2,260
-3.612235435650240,68,70,80,200,2,120
-3.61232727450268,6,15,160,500,9,340
-3.6123979023006900,20,25,180,225,5,45
-3.612452784113650,14,20,180,375,6,195
-3.612727863933940,58,60,200,425,2,225
-3.612868816246780,58,60,140,275,2,135
-3.612985576681500,58,60,170,300,2,130
-3.612994223184490,58,60,180,400,2,220
-3.613156211742640,58,60,80,475,2,395
-3.6135644163058900,58,60,190,350,2,160
-3.6135667295532900,14,20,80,500,6,420
-3.6138295128164500,14,20,130,425,6,295
-3.613882801967160,14,20,140,275,6,135
-3.6141569017184200,68,70,50,200,2,150
-3.6143619488734000,78,80,120,175,2,55
-3.6144934117812700,36,45,120,125,9,5
-3.61465189857696,14,20,50,325,6,275
-3.6147528081280800,26,30,150,300,4,150
-3.6147656790429100,14,20,140,450,6,310
-3.6148821253572000,98,100,180,200,2,20
-3.6150083266465800,6,15,70,250,9,180
-3.6150952433379400,58,60,80,500,2,420
-3.6151744412050400,90,95,120,125,5,5
-3.615235769497780,14,20,90,375,6,285
-3.615310439858230,58,60,90,300,2,210
-3.6153165374877600,58,60,110,425,2,315
-3.615485018248450,14,20,100,275,6,175
-3.615540387923490,58,60,50,275,2,225
-3.6155682662575200,52,55,110,150,3,40
-3.615625118649090,58,60,200,350,2,150
-3.6158886353244,6,15,200,450,9,250
-3.6159570397283100,14,20,60,475,6,415
-3.615967370260860,68,70,200,275,2,75
-3.6163712096012600,14,20,130,375,6,245
-3.616438513927510,26,30,110,375,4,265
-3.616875422680330,58,60,190,375,2,185
-3.617161875415700,58,60,70,425,2,355
-3.617259338285220,20,25,200,275,5,75
-3.6173170494262600,14,20,60,225,6,165
-3.6176162133089700,6,15,140,225,9,85
-3.6177047734855600,6,15,100,450,9,350
-3.6177463954925800,58,60,160,300,2,140
-3.6177814060029200,24,30,60,100,6,40
-3.6179009622137800,20,25,120,300,5,180
-3.6180570504210300,6,15,60,400,9,340
-3.6180659195265900,58,60,100,400,2,300
-3.6183166733451700,14,20,110,450,6,340
-3.618319510964220,14,20,70,425,6,355
-3.618480880264160,6,15,170,350,9,180
-3.618535768492870,52,55,180,200,3,20
-3.618794764194360,98,100,150,175,2,25
-3.6194482199468600,58,60,160,375,2,215
-3.619682180988500,58,60,80,450,2,370
-3.619831474609830,26,30,140,300,4,160
-3.6199472420167100,68,70,60,200,2,140
-3.62012408870632,20,25,80,200,5,120
-3.620164028694490,6,15,100,500,9,400
-3.6204487274399600,58,60,140,375,2,235
-3.620783518981560,58,60,150,325,2,175
-3.621049515254510,58,60,140,475,2,335
-3.6211438138563800,36,40,80,125,4,45
-3.621173834686350,58,60,140,225,2,85
-3.6215425224150600,14,20,100,400,6,300
-3.6215568649675300,14,20,150,425,6,275
-3.621780383379480,4,10,60,350,6,290
-3.6219354792968600,26,30,80,300,4,220
-3.622168284275370,14,20,50,250,6,200
-3.622237315063150,6,15,170,400,9,230
-3.622294252973920,68,70,90,200,2,110
-3.6226175066109600,6,15,100,225,9,125
-3.6226362298022100,14,20,70,200,6,130
-3.6226947079057400,78,80,70,150,2,80
-3.623066260680090,30,35,70,100,5,30
-3.623234849605080,14,20,120,250,6,130
-3.623479077607420,58,60,90,375,2,285
-3.6236106815891800,14,20,190,375,6,185
-3.6236367375934500,6,15,50,300,9,250
-3.6236852838817500,4,10,60,375,6,315
-3.6238171588108700,14,20,190,325,6,135
-3.6238257467213300,68,70,180,225,2,45
-3.6240105198170600,6,15,90,475,9,385
-3.6242097182986600,26,30,170,250,4,80
-3.624285163215940,58,60,180,325,2,145
-3.624770810713370,14,20,190,400,6,210
-3.6248299213424700,20,25,100,200,5,100
-3.624887810626470,58,60,140,250,2,110
-3.625217628359350,14,20,100,250,6,150
-3.6252298793454200,14,20,140,375,6,235
-3.625321113877320,12,20,180,200,8,20
-3.6253827836445500,58,60,80,275,2,195
-3.62542901196513,34,40,90,100,6,10
-3.6258062346589000,26,30,150,375,4,225
-3.6262600628830100,14,20,190,425,6,235
-3.6263190063896900,86,90,170,175,4,5
-3.626650610925130,58,60,80,350,2,270
-3.626669518884540,58,60,80,225,2,145
-3.626800305533800,14,20,100,300,6,200
-3.626806309754170,58,60,100,250,2,150
-3.6271199676739900,58,60,90,425,2,335
-3.627444633468650,58,60,110,400,2,290
-3.627589814081410,58,60,180,350,2,170
-3.627689781513060,14,20,110,250,6,140
-3.628149911503220,26,30,160,250,4,90
-3.6282012579525800,20,25,50,175,5,125
-3.6283790954644200,26,30,110,300,4,190
-3.629056128205550,42,45,50,150,3,100
-3.629059115815020,6,15,160,350,9,190
-3.6291119815877500,14,20,200,350,6,150
-3.6293133114475900,14,20,120,350,6,230
-3.629578091768130,20,25,160,200,5,40
-3.62962198901229,20,25,50,200,5,150
-3.629856945715520,4,10,60,300,6,240
-3.6298777374043700,58,60,140,350,2,210
-3.6303666789552100,58,60,150,225,2,75
-3.63056524862722,12,20,140,175,8,35
-3.6305923505934300,58,60,200,375,2,175
-3.630638403529030,14,20,180,350,6,170
-3.630662914007150,42,45,190,225,3,35
-3.6307095789859200,14,20,180,325,6,145
-3.630770751464480,6,15,90,300,9,210
-3.6307831036856300,68,70,160,200,2,40
-3.630822201363560,68,70,190,275,2,85
-3.6311287192235200,58,60,90,275,2,185
-3.631561073138700,26,30,150,275,4,125
-3.6317262225646900,58,60,60,500,2,440
-3.6318022650069300,14,20,70,400,6,330
-3.6318496642522000,14,20,60,450,6,390
-3.6321098707893700,58,60,60,300,2,240
-3.6323481908897200,14,20,60,500,6,440
-3.632572983810420,58,60,80,400,2,320
-3.6327441898073200,14,20,200,325,6,125
-3.6331799893258600,58,60,180,300,2,120
-3.6331955688416300,6,15,170,325,9,155
-3.6332061954074900,6,15,130,250,9,120
-3.6332233451271200,58,60,70,275,2,205
-3.633274159205760,6,15,160,325,9,165
-3.633559462223420,58,60,100,300,2,200
-3.6338418931487900,14,20,90,425,6,335
-3.633914037453310,12,20,90,150,8,60
-3.634184401705250,14,20,100,325,6,225
-3.6343008063347400,42,45,120,175,3,55
-3.6343610220983600,42,45,200,250,3,50
-3.634652079406740,14,20,190,350,6,160
-3.634693804917420,58,60,80,425,2,345
-3.634967064443020,20,25,120,200,5,80
-3.634995004743430,14,20,80,400,6,320
-3.6350444388821500,6,15,70,500,9,430
-3.6350633976601400,32,35,200,500,3,300
-3.6352509009605400,26,30,130,300,4,170
-3.6352689957690600,58,60,120,250,2,130
-3.6354862885923400,26,30,160,225,4,65
-3.6358463781368100,14,20,160,375,6,215
-3.6359398731913200,14,20,140,425,6,285
-3.6364178703975800,24,30,190,200,6,10
-3.6364978321121700,58,60,60,475,2,415
-3.6365328361295400,58,60,120,375,2,255
-3.6369096077523900,68,70,130,200,2,70
-3.6373389388149800,14,20,140,475,6,335
-3.637427514355310,58,60,190,325,2,135
-3.637798295690200,6,15,70,375,9,305
-3.6381734045649500,82,85,110,125,3,15
-3.638234343315110,6,15,80,275,9,195
-3.6382634301885100,58,60,110,225,2,115
-3.6385433729018400,6,15,70,275,9,205
-3.6386281521533900,58,60,100,350,2,250
-3.6388683329188500,58,60,160,275,2,115
-3.638926713755290,6,15,140,250,9,110
-3.639350783960770,58,60,200,325,2,125
-3.6395343537721600,6,15,60,225,9,165
-3.6395380799217500,88,90,110,150,2,40
-3.6397860145618200,68,70,100,200,2,100
-3.639882871170770,88,90,180,200,2,20
-3.640227238824000,58,60,100,325,2,225
-3.640231181026270,6,15,160,425,9,265
-3.6402625364545300,14,20,60,250,6,190
-3.6402685416006600,6,15,90,350,9,260
-3.6404030427558900,68,70,180,250,2,70
-3.6404663472419300,6,15,90,400,9,310
-3.6405243205830800,20,25,190,275,5,85
-3.64144580777129,58,60,70,250,2,180
-3.641509443367720,40,45,140,150,5,10
-3.6415164141472000,6,15,70,200,9,130
-3.641532519769070,14,20,70,300,6,230
-3.6415478471454100,50,55,170,175,5,5
-3.6416115255128,58,60,120,350,2,230
-3.641641443706250,68,70,110,200,2,90
-3.641765000813590,14,20,60,275,6,215
-3.642000789522170,88,90,60,125,2,65
-3.64210294242882,6,15,50,325,9,275
-3.6428129944217200,18,25,100,125,7,25
-3.6428338101342300,98,100,120,150,2,30
-3.642912173161100,58,60,100,275,2,175
-3.643086107854880,26,30,130,275,4,145
-3.643267832601450,14,20,100,375,6,275
-3.6434391249882100,14,20,160,450,6,290
-3.643559922334180,26,30,140,325,4,185
-3.643704280335320,68,70,50,175,2,125
-3.643819451312240,36,40,160,175,4,15
-3.644006746324860,14,20,200,375,6,175
-3.644093774288950,42,45,60,150,3,90
-3.644244184989400,58,60,70,350,2,280
-3.6443580625587300,52,55,150,175,3,25
-3.644585383939740,26,30,170,225,4,55
-3.644989843574470,88,90,70,125,2,55
-3.6453756861417000,58,60,60,450,2,390
-3.6456267952825800,14,20,110,225,6,115
-3.6465896455768000,20,25,180,250,5,70
-3.6468397832391500,6,15,170,500,9,330
-3.64709135889366,6,15,90,450,9,360
-3.6471048888555800,78,80,50,125,2,75
-3.6472416634906600,26,30,110,325,4,215
-3.6477280092976500,14,20,170,225,6,55
-3.6479520407329600,20,25,60,175,5,115
-3.6482185965087400,14,20,180,300,6,120
-3.6491352737699600,14,20,110,350,6,240
-3.649733278514960,20,25,130,200,5,70
-3.6498455283854800,58,60,110,350,2,240
-3.649954675218480,58,60,150,375,2,225
-3.6502660453169600,14,20,90,325,6,235
-3.650373168257210,14,20,120,275,6,155
-3.6504624098882700,58,60,110,250,2,140
-3.650486147899190,14,20,110,275,6,165
-3.6506776358628600,58,60,90,325,2,235
-3.650912390441690,4,10,200,500,6,300
-3.651039928334870,26,30,120,325,4,205
-3.651237439208100,58,60,100,375,2,275
-3.651550394905590,12,20,130,175,8,45
-3.6515740910486000,14,20,80,425,6,345
-3.6516653587604500,58,60,50,300,2,250
-3.6521391995921400,24,30,100,125,6,25
-3.652179965522160,58,60,50,325,2,275
-3.6525411357676100,14,20,110,400,6,290
-3.6526043197087400,78,80,80,150,2,70
-3.65262101795111,14,20,190,300,6,110
-3.652772885006420,4,10,50,250,6,200
-3.6528967034062500,20,25,70,175,5,105
-3.6529594899066900,6,15,180,475,9,295
-3.653359072233580,14,20,160,275,6,115
-3.6538904591091700,6,15,200,300,9,100
-3.6543615433491400,6,15,100,475,9,375
-3.6543799371891900,68,70,120,200,2,80
-3.654580039156000,26,30,150,200,4,50
-3.6551342608048400,14,20,80,325,6,245
-3.6555465972800400,78,80,100,150,2,50
-3.655547754474840,26,30,180,225,4,45
-3.655612441823730,26,30,170,275,4,105
-3.655700802160880,98,100,90,125,2,35
-3.6558467276975700,14,20,140,350,6,210
-3.655967087574760,62,65,70,100,3,30
-3.656003684632370,6,15,170,475,9,305
-3.6563176236643700,14,20,150,300,6,150
-3.656440852066380,58,60,120,275,2,155
-3.656470644930430,58,60,70,400,2,330
-3.6565185617941500,62,65,100,125,3,25
-3.656613800004680,6,15,190,450,9,260
-3.6566688310849900,58,60,130,350,2,220
-3.6567050157247300,36,40,130,150,4,20
-3.6567571150578100,6,15,60,250,9,190
-3.656911994837730,26,30,130,325,4,195
-3.657126092345790,88,90,150,175,2,25
-3.657227572591690,56,60,90,100,4,10
-3.6572954535083600,6,15,70,475,9,405
-3.6578484516251600,6,15,120,500,9,380
-3.657870597787210,58,60,110,275,2,165
-3.657983928190370,14,20,160,225,6,65
-3.6582910898134500,58,60,140,300,2,160
-3.65855947528501,26,30,80,200,4,120
-3.6585665709536000,6,15,170,375,9,205
-3.658650509429600,14,20,100,350,6,250
-3.658748120922050,20,25,90,200,5,110
-3.6589869068360000,6,15,130,400,9,270
-3.6591028122920600,58,60,150,300,2,150
-3.6592447680495500,6,15,120,250,9,130
-3.659624755498680,58,60,50,225,2,175
-3.6597119262998300,14,20,170,250,6,80
-3.6597705265424600,58,60,80,325,2,245
-3.6598376827725200,68,70,60,175,2,115
-3.6599480044909500,4,10,140,225,6,85
-3.6607151127510100,14,20,80,300,6,220
-3.661117138689800,26,30,180,275,4,95
-3.661375316083610,52,55,60,125,3,65
-3.6620990185847300,58,60,190,300,2,110
-3.6624763867882100,68,70,140,200,2,60
-3.662509170670980,14,20,120,375,6,255
-3.662804909938670,6,15,160,300,9,140
-3.6632124481082200,14,20,150,375,6,225
-3.66404087522816,36,40,90,125,4,35
-3.6642333817596000,14,20,130,350,6,220
-3.6642481954184400,58,60,70,325,2,255
-3.66425669677676,58,60,110,300,2,190
-3.66481662151259,6,15,60,275,9,215
-3.6652775371155800,26,30,120,300,4,180
-3.6657624255451100,32,35,200,475,3,275
-3.6658709587038900,58,60,70,200,2,130
-3.665898316051800,26,30,110,200,4,90
-3.666338503611950,6,15,150,500,9,350
-3.666731371680330,32,35,190,475,3,285
-3.6667400871533800,58,60,110,375,2,265
-3.6669361114625100,58,60,50,250,2,200
-3.666973269425680,58,60,70,300,2,230
-3.667022005509420,66,70,170,175,4,5
-3.6672548021068900,14,20,150,200,6,50
-3.667363416420310,6,15,100,250,9,150
-3.667486656311700,6,15,140,275,9,135
-3.6675293740801200,6,15,160,400,9,240
-3.6679196380119600,58,60,60,275,2,215
-3.668861906469620,6,15,100,425,9,325
-3.668897888524670,4,10,70,250,6,180
-3.669155076239570,58,60,60,225,2,165
-3.6691852122728700,4,10,90,225,6,135
-3.6692533952852200,14,20,150,250,6,100
-3.669284357148990,32,35,190,500,3,310
-3.669719733277500,12,20,120,150,8,30
-3.670540270089150,58,60,60,250,2,190
-3.670599389749460,6,15,90,275,9,185
-3.6713821954005600,58,60,150,275,2,125
-3.6714701097863300,72,75,80,100,3,20
-3.67201517123292,68,70,70,175,2,105
-3.672841661340740,58,60,170,250,2,80
-3.6730248741068500,4,10,50,500,6,450
-3.6732986634891200,6,15,110,500,9,390
-3.673580255119150,20,25,140,200,5,60
-3.6736303371457600,26,30,50,200,4,150
-3.673704624749040,58,60,150,250,2,100
-3.673763492699830,6,15,170,425,9,255
-3.6737980345936800,6,15,70,350,9,280
-3.674290701213770,32,35,180,500,3,320
-3.6746158503767800,6,15,130,500,9,370
-3.6746454554185000,4,10,50,300,6,250
-3.674648188158500,6,15,170,300,9,130
-3.674911073424070,4,10,150,200,6,50
-3.6750456494557400,78,80,130,175,2,45
-3.675166856770740,14,20,160,250,6,90
-3.6755371692598700,58,60,120,325,2,205
-3.6758414924975200,58,60,130,275,2,145
-3.676032585303750,18,25,70,100,7,30
-3.676068252862320,24,30,70,100,6,30
-3.6766004186271400,26,30,60,200,4,140
-3.676743784434610,98,100,80,125,2,45
-3.676792195513060,6,15,150,200,9,50
-3.6768433650765000,4,10,70,200,6,130
-3.676869454272280,32,35,120,450,3,330
-3.676975626445640,14,20,150,275,6,125
-3.677386147194300,6,15,80,350,9,270
-3.677389954908220,6,15,160,225,9,65
-3.677780086565220,6,15,150,350,9,200
-3.677938443393120,58,60,130,300,2,170
-3.678277420067730,6,15,110,225,9,115
-3.6783282295350600,6,15,120,475,9,355
-3.6783759196601700,14,20,110,375,6,265
-3.678386200776080,6,15,80,375,9,295
-3.6784168074799900,22,30,90,100,8,10
-3.6786816102903400,52,55,120,150,3,30
-3.678740339773200,14,20,140,300,6,160
-3.6794130677011900,6,15,70,450,9,380
-3.680092957856480,68,70,80,175,2,95
-3.6802264451575000,88,90,120,150,2,30
-3.680800927733810,12,20,110,150,8,40
-3.6809313938264800,78,80,140,175,2,35
-3.680982401698160,6,15,70,325,9,255
-3.6810742379131100,20,25,110,175,5,65
-3.68166613058595,42,45,70,150,3,80
-3.6817851924359400,14,20,110,300,6,190
-3.681922694730960,58,60,110,325,2,215
-3.6822627193895700,58,60,160,225,2,65
-3.682476399735900,72,75,110,125,3,15
-3.6824854364635600,26,30,160,200,4,40
-3.6825026410331000,58,60,80,300,2,220
-3.6826900235983100,26,30,200,275,4,75
-3.68301664499511,4,10,60,225,6,165
-3.6832315481929900,58,60,160,250,2,90
-3.6833716263078300,78,80,200,225,2,25
-3.6836477910210800,20,25,80,175,5,95
-3.683933211421650,100,105,120,125,5,5
-3.684772709466930,52,55,70,125,3,55
-3.6853861953824900,6,15,150,400,9,250
-3.6859937162077300,6,15,170,225,9,55
-3.686272249607280,6,15,140,500,9,360
-3.6871553464426500,26,30,50,175,4,125
-3.6876721495236200,58,60,140,325,2,185
-3.687853031986860,14,20,60,200,6,140
-3.687923081684300,36,40,60,100,4,40
-3.6881529584069100,26,30,180,250,4,70
-3.6882020503863600,14,20,130,275,6,145
-3.6886414531981700,48,55,120,125,7,5
-3.6886618929103700,6,15,130,450,9,320
-3.6887802643766100,42,45,80,150,3,70
-3.689124002791520,36,40,190,200,4,10
-3.689265073039590,6,15,120,400,9,280
-3.6900559578991400,16,25,140,150,9,10
-3.690291066869960,32,35,50,375,3,325
-3.69122247350641,6,15,130,475,9,345
-3.6917818444940700,32,35,50,425,3,375
-3.691823756213250,32,35,90,500,3,410
-3.691961295391080,14,20,120,325,6,205
-3.691972794095180,6,15,110,450,9,340
-3.692053561228050,6,15,150,450,9,300
-3.69224683430173,32,35,160,500,3,340
-3.6924039425184700,32,35,50,350,3,300
-3.692801140068630,26,30,120,200,4,80
-3.692822634681860,46,50,110,125,4,15
-3.6934723983775800,4,10,200,475,6,275
-3.6934741069285700,6,15,110,475,9,365
-3.693661493657140,58,60,150,200,2,50
-3.6938022034431900,6,15,80,450,9,370
-3.69380356428574,58,60,170,275,2,105
-3.693806311134660,78,80,90,150,2,60
-3.6938177462319100,6,15,70,300,9,230
-3.6938609868443800,6,15,90,375,9,285
-3.6940866352586500,68,70,110,175,2,65
-3.694922818289520,6,15,100,300,9,200
-3.6951877834198500,20,25,170,200,5,30
-3.695498509044260,26,30,100,200,4,100
-3.695642006763600,78,80,180,200,2,20
-3.6957238454719200,26,30,190,275,4,85
-3.6959550574923900,6,15,70,425,9,355
-3.696191689690890,26,30,90,200,4,110
-3.6964767434983200,14,20,130,300,6,170
-3.696701851289840,6,15,60,500,9,440
-3.697252614503300,32,35,100,500,3,400
-3.6975032101415700,58,60,180,275,2,95
-3.697990847955240,6,15,110,250,9,140
-3.698342694226100,68,70,170,200,2,30
-3.6984914701469900,14,20,110,325,6,215
-3.698975980520610,6,15,180,325,9,145
-3.6993608243078500,32,35,120,225,3,105
-3.699507459545600,4,10,160,200,6,40
-3.6997037968704600,58,60,130,325,2,195
-3.700121876476430,6,15,80,500,9,420
-3.7006633290606700,34,40,170,175,6,5
-3.7008793378084200,4,10,80,225,6,145
-3.700996601538990,6,15,120,425,9,305
-3.7011120835683600,32,35,200,450,3,250
-3.7012315673152800,64,70,120,125,6,5
-3.7013907575774300,32,35,160,425,3,265
-3.701896797795260,42,50,120,125,8,5
-3.7024009077902300,32,35,90,475,3,385
-3.7024137304596400,6,15,190,325,9,135
-3.702579331598170,68,70,50,150,2,100
-3.7033749851774000,6,15,100,275,9,175
-3.7041426985201300,32,35,170,400,3,230
-3.7042808846121800,32,35,60,350,3,290
-3.704638127232760,32,35,170,500,3,330
-3.70517974764996,14,20,130,325,6,195
-3.705240457686700,14,20,140,325,6,185
-3.7054273423472600,6,15,200,325,9,125
-3.705540293491430,26,30,140,200,4,60
-3.7057860305519800,6,15,180,425,9,245
-3.706284315615260,6,15,200,400,9,200
-3.706359500817440,6,15,150,325,9,175
-3.7064835783392800,6,15,170,250,9,80
-3.7069762110695500,32,35,50,400,3,350
-3.707288549595870,32,35,100,450,3,350
-3.707585055438750,32,35,150,500,3,350
-3.7076488679437800,98,100,50,100,2,50
-3.707678626595350,32,35,190,450,3,260
-3.7081528610324800,14,20,50,175,6,125
-3.708229767978610,42,45,140,175,3,35
-3.7083138710936300,42,45,90,150,3,60
-3.7083498373308300,32,35,170,350,3,180
-3.7084727857235900,20,25,50,150,5,100
-3.7087907844150800,14,20,180,225,6,45
-3.7090691937351200,6,15,60,200,9,140
-3.7092062548128000,6,15,140,400,9,260
-3.7094043814198800,6,15,160,475,9,315
-3.709797947781520,32,35,70,225,3,155
-3.710210956033000,26,30,130,200,4,70
-3.7102452243861300,68,70,190,250,2,60
-3.710315691772430,88,90,50,100,2,50
-3.7104339444846800,32,35,80,250,3,170
-3.711016048405640,6,15,190,425,9,235
-3.711161384200560,46,50,80,100,4,20
-3.7112103833966900,20,25,190,250,5,60
-3.711264947002350,42,45,100,150,3,50
-3.711611519735420,6,15,130,425,9,295
-3.711702468473360,6,15,130,375,9,245
-3.712215744612030,68,70,90,175,2,85
-3.712722872286580,32,35,100,475,3,375
-3.7128322698336900,4,10,170,200,6,30
-3.713078225424020,4,10,70,275,6,205
-3.7133668093832100,32,35,170,475,3,305
-3.713810228295280,6,15,160,200,9,40
-3.7138345878217100,58,60,80,200,2,120
-3.7139583082840000,14,20,170,275,6,105
-3.714350490627890,6,15,90,325,9,235
-3.7145427716240600,58,60,120,300,2,180
-3.7151410622269100,52,55,50,100,3,50
-3.7155203804829500,32,35,60,425,3,365
-3.716291038278650,14,20,160,200,6,40
-3.716293627218020,6,15,180,300,9,120
-3.716453222520880,6,15,180,375,9,195
-3.716567644953690,6,15,60,475,9,415
-3.7167255180792800,58,60,170,225,2,55
-3.716761336389720,6,15,140,450,9,310
-3.7169489063670600,6,15,170,450,9,280
-3.7170568129726200,14,20,80,200,6,120
-3.717416735565060,6,15,180,450,9,270
-3.7174381992537900,58,60,200,275,2,75
-3.717818530119360,20,25,90,175,5,85
-3.718163699286570,40,45,90,100,5,10
-3.7182286214947700,26,30,60,175,4,115
-3.71830910844983,32,35,50,500,3,450
-3.718457699226930,32,35,90,250,3,160
-3.7185550380341300,6,15,140,375,9,235
-3.718824390255890,32,35,180,475,3,295
-3.718925209264930,6,15,100,400,9,300
-3.7189427950733100,78,80,60,125,2,65
-3.718978377346320,4,10,50,475,6,425
-3.719230136672800,6,15,110,275,9,165
-3.71929857687051,14,20,50,200,6,150
-3.7195566982553900,32,35,120,500,3,380
-3.719931841968270,56,60,170,175,4,5
-3.720295379367790,32,35,60,325,3,265
-3.7209116398565200,6,15,120,275,9,155
-3.7211691662726300,6,15,100,325,9,225
-3.7213077449955800,82,85,140,150,3,10
-3.7213243718313300,6,15,180,400,9,220
-3.72141113063016,12,20,150,175,8,25
-3.7215038426658000,32,35,130,225,3,95
-3.721824036671560,32,35,70,500,3,430
-3.7218481852870200,4,10,80,275,6,195
-3.7221844046814400,32,35,130,500,3,370
-3.722196013303580,92,95,170,175,3,5
-3.7222494025185800,22,30,170,175,8,5
-3.7225855635694600,6,15,190,350,9,160
-3.722587917800350,14,20,120,300,6,180
-3.722701974520780,32,35,170,375,3,205
-3.7228547644602100,32,35,50,450,3,400
-3.7228776241423300,6,15,200,425,9,225
-3.7229436953002500,68,70,100,175,2,75
-3.7236785191650800,6,15,80,300,9,220
-3.7237466233233000,78,80,110,150,2,40
-3.723747798289820,6,15,80,475,9,395
-3.723950219440350,32,35,140,500,3,360
-3.724808163435510,4,10,100,225,6,125
-3.725257366927550,6,15,80,400,9,320
-3.7253566205770800,32,35,110,500,3,390
-3.7258695556519500,32,35,110,450,3,340
-3.7258964133506700,32,35,120,475,3,355
-3.7259194296589400,6,15,70,400,9,330
-3.7261957542237500,58,60,60,200,2,140
-3.7264135781863300,32,35,160,475,3,315
-3.7269440962076600,20,25,60,150,5,90
-3.726963103492000,4,10,50,450,6,400
-3.7272611598288600,42,45,200,225,3,25
-3.7280844526091100,32,35,160,400,3,240
-3.728119128654010,6,15,170,200,9,30
-3.728713486867990,6,15,140,350,9,210
-3.728753687259730,58,60,190,275,2,85
-3.728846335404970,4,10,50,200,6,150
-3.729005743063850,6,15,160,275,9,115
-3.729160462837560,6,15,50,200,9,150
-3.729204609534270,32,35,100,425,3,325
-3.729339369611020,4,10,90,300,6,210
-3.729530417266840,42,45,130,175,3,45
-3.7296514209463000,6,15,180,225,9,45
-3.729852838303450,32,35,50,475,3,425
-3.730103304018560,6,15,150,475,9,325
-3.730607308696200,32,35,130,475,3,345
-3.730799700276450,32,35,160,350,3,190
-3.7314847449032000,14,20,180,275,6,95
-3.731976869123100,26,30,80,175,4,95
-3.732343177292590,32,35,60,375,3,315
-3.732586778048960,6,15,180,350,9,170
-3.732813209336330,6,15,50,175,9,125
-3.733015660571570,32,35,70,375,3,305
-3.733693743295230,20,25,100,175,5,75
-3.7336951995314700,4,10,160,225,6,65
-3.7337142575036800,32,35,90,400,3,310
-3.73391842108001,6,15,80,425,9,345
-3.7346335619137000,32,35,80,450,3,370
-3.734711499519570,14,20,90,200,6,110
-3.734742097013280,58,60,90,200,2,110
-3.7352546338670100,6,15,150,425,9,275
-3.7354704021593200,42,45,50,125,3,75
-3.7355153003097800,14,20,110,200,6,90
-3.7358491581950500,4,10,170,225,6,55
-3.7360062718439500,52,55,80,125,3,45
-3.7363934363644800,58,60,50,200,2,150
-3.7364334686645500,32,35,170,425,3,255
-3.736488448315160,54,60,120,125,6,5
-3.7365352935799400,14,20,100,200,6,100
-3.7370456411745900,6,15,160,375,9,215
-3.7374071426445000,32,35,170,325,3,155
-3.737861506696150,6,15,90,425,9,335
-3.7382002891049600,6,15,140,425,9,285
-3.738356377469420,6,15,150,300,9,150
-3.7384958074921300,32,35,180,425,3,245
-3.7384959642239200,58,60,180,225,2,45
-3.738619629279890,32,35,160,325,3,165
-3.7386599327532300,32,35,110,475,3,365
-3.739175525510450,32,35,60,400,3,340
-3.739554056737990,6,15,110,425,9,315
-3.7400859635699300,32,35,130,450,3,320
-3.7408122195864500,82,85,90,100,3,10
-3.740858977118780,26,30,70,175,4,105
-3.7409609626140600,88,90,80,125,2,45
-3.740967615598550,68,70,120,175,2,55
-3.74104112668829,36,40,100,125,4,25
-3.74109548838437,32,35,130,400,3,270
-3.7411825799645700,58,60,180,250,2,70
-3.7414530788022200,14,20,180,250,6,70
-3.7421402736760300,32,35,90,450,3,360
-3.7425815532215500,6,15,190,300,9,110
-3.74295159585231,32,35,90,225,3,135
-3.7432965871973600,32,35,70,475,3,405
-3.7434776481077800,26,30,110,175,4,65
-3.743942385316030,6,15,100,375,9,275
-3.7440747367049500,6,15,190,400,9,210
-3.744595657922370,4,10,60,425,6,365
-3.744887955349020,14,20,200,275,6,75
-3.745117458007450,32,35,180,375,3,195
-3.7451307033125400,6,15,110,300,9,190
-3.7454818941322500,32,35,150,400,3,250
-3.7456975995448600,32,35,150,425,3,275
-3.74576515712305,32,35,130,425,3,295
-3.7457830163436400,32,35,200,400,3,200
-3.7458678533527100,68,70,190,225,2,35
-3.7462381718356400,32,35,170,450,3,280
-3.746437718641330,32,35,180,450,3,270
-3.7466001953974100,4,10,60,250,6,190
-3.747037308807820,4,10,190,500,6,310
-3.747196811206460,32,35,200,300,3,100
-3.747204674486590,14,20,70,175,6,105
-3.7472894487145100,32,35,120,425,3,305
-3.747412045547910,32,35,140,450,3,310
-3.7474310964423500,98,100,160,175,2,15
-3.7474345519872100,6,15,60,450,9,390
-3.7475493255083900,32,35,120,400,3,280
-3.7479109195735200,32,35,100,225,3,125
-3.747979473084430,32,35,70,250,3,180
-3.748267960467430,32,35,90,350,3,260
-3.7483818168860400,32,35,190,425,3,235
-3.748436602857660,14,20,60,175,6,115
-3.748627793143620,68,70,60,150,2,90
-3.749029413176160,4,10,190,475,6,285
-3.7490440110343100,32,35,90,425,3,335
-3.749103552749900,32,35,190,350,3,160
-3.749145129773180,4,10,60,400,6,340
-3.7493319296338300,58,60,110,200,2,90
-3.749431110767170,26,30,170,200,4,30
-3.7495524523300400,12,20,50,100,8,50
-3.7497663207782500,6,15,110,350,9,240
-3.7499753417747300,14,20,190,275,6,85
-3.750078075477650,78,80,150,175,2,25
-3.7503430542483100,32,35,180,400,3,220
-3.750346488393410,30,35,110,125,5,15
-3.750408236962870,32,35,70,450,3,380
-3.750769911973570,32,35,130,375,3,245
-3.7508667260373300,4,10,50,325,6,275
-3.7511139292978100,6,15,140,475,9,335
-3.751499190427210,32,35,140,250,3,110
-3.7519678578138300,58,60,140,200,2,60
-3.752445531577020,98,100,130,150,2,20
-3.7525053493436100,32,35,140,400,3,260
-3.752685680549300,14,20,130,200,6,70
-3.7527434991204200,32,35,80,500,3,420
-3.753034314151470,20,25,190,225,5,35
-3.7539942712276700,32,35,70,275,3,205
-3.7542372834843900,6,15,200,350,9,150
-3.7548073389411700,32,35,80,275,3,195
-3.7550145844623100,12,20,60,125,8,65
-3.7550897687917500,80,85,120,125,5,5
-3.75513151522291,32,35,140,425,3,285
-3.7551510965382700,32,35,200,425,3,225
-3.7553497449660100,32,35,60,300,3,240
-3.755550062930850,32,35,150,350,3,200
-3.755721196434640,32,35,50,275,3,225
-3.7561179987464000,32,35,70,350,3,280
-3.75628434383613,14,20,140,200,6,60
-3.756286119724700,4,10,60,275,6,215
-3.7563029581988000,52,55,130,150,3,20
-3.756411631391320,32,35,100,400,3,300
-3.756608857606700,6,15,140,300,9,160
-3.7566200794341600,58,60,160,200,2,40
-3.7567292548228200,6,15,160,250,9,90
-3.757668730650330,16,25,170,175,9,5
-3.757673300980110,32,35,160,300,3,140
-3.757680012043100,4,10,160,325,6,165
-3.7577601650269400,30,35,80,100,5,20
-3.757925900185560,32,35,100,250,3,150
-3.758311754905280,58,60,120,200,2,80
-3.75842867505531,68,70,200,250,2,50
-3.758491711339120,6,15,80,325,9,245
-3.7586812475321700,32,35,80,375,3,295
-3.7587175362132300,58,60,130,200,2,70
-3.758949847622960,14,20,120,200,6,80
-3.7590303478604000,32,35,90,300,3,210
-3.7592847155334800,6,15,120,350,9,230
-3.7597689279982800,32,35,70,425,3,355
-3.7599684841160900,32,35,150,450,3,300
-3.759991824832610,58,60,100,200,2,100
-3.760788022462150,6,15,160,450,9,290
-3.7609197718342900,32,35,80,475,3,395
-3.7612153816616800,32,35,150,225,3,75
-3.761425946639790,42,45,180,200,3,20
-3.761567214870710,6,15,150,250,9,100
-3.7616176524421600,32,35,90,375,3,285
-3.761621421332270,32,35,170,300,3,130
-3.761670957623360,52,55,160,175,3,15
-3.761976330885400,32,35,150,475,3,325
-3.7620309591788900,32,35,200,350,3,150
-3.762308928630600,42,45,110,150,3,40
-3.763539864087200,6,15,150,275,9,125
-3.7635504914091900,32,35,130,250,3,120
-3.7636662901481400,58,60,50,175,2,125
-3.7638873185206700,6,15,60,175,9,115
-3.7640113992055600,4,10,50,175,6,125
-3.7649387559903400,6,15,100,350,9,250
-3.765478959607880,32,35,50,300,3,250
-3.7654855246871800,26,30,90,175,4,85
-3.7655308923630600,26,30,190,250,4,60
-3.765873168635280,32,35,140,475,3,335
-3.7659836652027600,32,35,150,325,3,175
-3.7661858285610800,32,35,100,325,3,225
-3.766266227634860,32,35,200,325,3,125
-3.7665801108420800,6,15,110,325,9,215
-3.767040706066150,32,35,140,275,3,135
-3.7670615234354400,32,35,180,350,3,170
-3.7671840569438400,32,35,80,225,3,145
-3.7673947704811800,16,25,90,100,9,10
-3.7679747572571000,32,35,110,425,3,315
-3.768007818180700,32,35,60,500,3,440
-3.768520690763960,78,80,120,150,2,30
-3.768575022686980,14,20,110,175,6,65
-3.7690161537068600,12,20,70,125,8,55
-3.770377928763730,32,35,50,225,3,175
-3.7704303050831200,6,15,110,400,9,290
-3.770637281427870,32,35,190,325,3,135
-3.7711137963720800,32,35,190,400,3,210
-3.7711384552380500,32,35,100,375,3,275
-3.7712393310318000,32,35,90,275,3,185
-3.771688905151910,32,35,190,375,3,185
-3.7717319899101000,4,10,140,250,6,110
-3.7717508468604000,32,35,120,250,3,130
-3.7720269168838300,32,35,80,350,3,270
-3.772066036610320,6,15,130,350,9,220
-3.77229673429511,58,60,60,175,2,115
-3.7728529030417200,6,15,200,375,9,175
-3.772976972070730,6,15,190,375,9,185
-3.773525135349860,32,35,160,450,3,290
-3.773902850631070,32,35,60,225,3,165
-3.7748107807693400,32,35,180,325,3,145
-3.775637449388590,32,35,200,375,3,175
-3.7757594936270900,32,35,100,300,3,200
-3.7759305860579300,32,35,80,425,3,345
-3.7764770482174700,32,35,110,400,3,290
-3.776486443695870,4,10,170,325,6,155
-3.776528889970710,32,35,140,350,3,210
-3.776659142418500,4,10,70,375,6,305
-3.776765754718880,6,15,120,375,9,255
-3.7773945888091900,32,35,160,375,3,215
-3.7777888127319900,32,35,70,400,3,330
-3.7781261150775600,32,35,100,275,3,175
-3.7782170858777800,52,55,90,125,3,35
-3.7783931721279900,72,75,140,150,3,10
-3.7784822641900400,4,10,120,450,6,330
-3.7785860669243000,32,35,180,300,3,120
-3.779132341116850,32,35,60,475,3,415
-3.779358546161890,4,10,130,250,6,120
-3.7794300231759200,32,35,140,375,3,235
-3.780005212744420,20,25,120,175,5,55
-3.7809291586208300,32,35,120,350,3,230
-3.7810942979405500,4,10,180,500,6,320
-3.781895560665200,12,20,160,175,8,15
-3.7820281357089900,32,35,140,225,3,85
-3.782604999007650,32,35,70,325,3,255
-3.783892426832320,14,20,80,175,6,95
-3.784441151421150,32,35,110,225,3,115
-3.7847737153514400,32,35,90,325,3,235
-3.7849286250823500,70,75,120,125,5,5
-3.7856218536179500,32,35,80,400,3,320
-3.7859359542592300,6,15,130,275,9,145
-3.786203087984050,88,90,160,175,2,15
-3.786869188100460,32,35,120,275,3,155
-3.7869981305854100,20,25,200,250,5,50
-3.7871019285625000,32,35,110,350,3,240
-3.787524696330420,32,35,110,250,3,140
-3.787766145200130,32,35,60,450,3,390
-3.787944651881800,18,25,110,125,7,15
-3.7882013016814700,6,15,80,200,9,120
-3.7886048506268800,32,35,100,350,3,250
-3.7886086563506900,78,80,70,125,2,55
-3.788891797308620,32,35,70,300,3,230
-3.789001294389260,62,65,110,125,3,15
-3.789372122023880,58,60,110,175,2,65
-3.7898691250011600,32,35,50,325,3,275
-3.789896203560520,32,35,120,375,3,255
-3.791562002829290,4,10,170,350,6,180
-3.7917976898148000,26,30,50,150,4,100
-3.791801257396440,4,10,100,450,6,350
-3.7924943681505600,98,100,60,100,2,40
-3.792662714973050,98,100,100,125,2,25
-3.7936681026652400,6,15,110,375,9,265
-3.793867857945530,32,35,60,250,3,190
-3.7944909170831000,78,80,50,100,2,50
-3.7950260929993200,4,10,90,350,6,260
-3.795298374082160,46,50,140,150,4,10
-3.795604666716260,6,15,130,200,9,70
-3.7958019752578700,20,25,70,150,5,80
-3.7960738621080200,36,40,70,100,4,30
-3.7963599262296700,26,30,100,175,4,75
-3.7968935184400800,4,10,170,400,6,230
-3.7970181348990500,58,60,70,175,2,105
-3.797485942223210,14,20,170,200,6,30
-3.797513545566150,4,10,120,250,6,130
-3.7984997955439700,32,35,50,250,3,200
-3.79893155462217,32,35,140,300,3,160
-3.7996744815432000,26,30,190,225,4,35
-3.800123315039190,58,60,80,175,2,95
-3.800229964948500,88,90,90,125,2,35
-3.8002467866639600,32,35,190,300,3,110
-3.8003562042807600,32,35,160,275,3,115
-3.8005099035852600,32,35,150,375,3,225
-3.800936617497140,42,45,60,125,3,65
-3.8009367474338700,32,35,70,200,3,130
-3.80119148701098,32,35,130,350,3,220
-3.8012354119875800,32,35,110,275,3,165
-3.8017188123888100,4,10,90,500,6,410
-3.801841823568520,6,15,150,375,9,225
-3.8022051466554700,68,70,70,150,2,80
-3.802649640578400,48,50,200,500,2,300
-3.8033336725089700,32,35,110,375,3,265
-3.803586793181720,4,10,100,500,6,400
-3.8040133095356000,88,90,130,150,2,20
-3.8050831542106500,4,10,90,475,6,385
-3.8053238354112400,32,35,110,300,3,190
-3.8056504729287600,62,65,80,100,3,20
-3.806057148957300,32,35,150,300,3,150
-3.8060784034687000,32,35,60,275,3,215
-3.8066995136897500,52,55,60,100,3,40
-3.807729633841460,32,35,170,250,3,80
-3.808674994357400,26,30,120,175,4,55
-3.808684635600500,4,10,100,250,6,150
-3.8087962023831700,68,70,80,150,2,70
-3.8090613243328100,32,35,80,325,3,245
-3.8092384169273500,6,15,110,200,9,90
-3.8096977260731500,58,60,170,200,2,30
-3.8097936099546200,6,15,130,300,9,170
-3.8098461647852500,14,20,50,150,6,100
-3.8101579394945200,4,10,70,350,6,280
-3.8122041449519600,4,10,160,300,6,140
-3.813010811922440,14,20,90,175,6,85
-3.813893773407250,42,45,150,175,3,25
-3.8139939850618900,26,30,60,150,4,90
-3.8140154351385300,4,10,90,275,6,185
-3.814066041507550,6,15,70,175,9,105
-3.814188995907800,6,15,130,325,9,195
-3.8151964479273100,32,35,160,225,3,65
-3.815389947126370,40,45,170,175,5,5
-3.815416808599880,30,35,140,150,5,10
-3.8157922887989,58,60,190,250,2,60
-3.816123910277310,18,25,80,100,7,20
-3.81613709888264,78,80,60,100,2,40
-3.816648744649650,32,35,150,275,3,125
-3.8175024410215200,68,70,100,150,2,50
-3.817516382622310,68,70,50,125,2,75
-3.8178731632900000,4,10,200,300,6,100
-3.8196197995671400,32,35,150,250,3,100
-3.820183623684930,4,10,160,350,6,190
-3.820360982016950,72,75,90,100,3,10
-3.820659160337090,88,90,60,100,2,40
-3.820806664050930,52,55,190,200,3,10
-3.8211270159490600,32,35,80,300,3,220
-3.8213044539135400,26,30,200,250,4,50
-3.8217852521247900,4,10,180,225,6,45
-3.822024293785120,4,10,60,200,6,140
-3.8226926827118200,6,15,140,200,9,60
-3.8228012985692500,20,25,80,150,5,70
-3.8232523081066500,98,100,190,200,2,10
-3.8236052071521900,48,50,190,500,2,310
-3.824862289081570,4,10,160,500,6,340
-3.825245589612050,20,25,100,150,5,50
-3.8255871203765600,12,20,130,150,8,20
-3.82647316754668,42,45,70,125,3,55
-3.82654377730092,4,10,160,425,6,265
-3.8266018288295500,58,60,90,175,2,85
-3.827275821684330,42,45,120,150,3,30
-3.8275347812182200,6,15,180,275,9,95
-3.82764900280232,24,30,110,125,6,15
-3.8282218509368600,6,15,120,200,9,80
-3.8287605667008900,14,20,190,225,6,35
-3.829271379816450,48,50,190,475,2,285
-3.8294747083249400,48,50,180,500,2,320
-3.829653581267890,20,25,90,150,5,60
-3.830243022024360,6,15,170,275,9,105
-3.830272133103850,6,15,180,250,9,70
-3.8310132998790800,6,15,110,175,9,65
-3.8311409014355100,24,30,80,100,6,20
-3.8315530375767100,4,10,80,350,6,270
-3.83163916843551,68,70,200,225,2,25
-3.8333975237611300,68,70,140,175,2,35
-3.8334256345020400,48,50,200,475,2,275
-3.83394276079546,32,35,130,300,3,170
-3.834003753138440,46,50,90,100,4,10
-3.8361246627911800,14,20,60,150,6,90
-3.8361957921589200,12,20,90,125,8,35
-3.8363305294806800,6,15,50,150,9,100
-3.836338485289980,32,35,140,325,3,185
-3.8369047732443400,4,10,170,300,6,130
-3.8372192239742500,32,35,160,250,3,90
-3.837285493640470,6,15,100,200,9,100
-3.8375996032878300,32,35,130,325,3,195
-3.83764711049139,4,10,140,275,6,135
-3.837820624170310,78,80,80,125,2,45
-3.838002452668090,32,35,130,275,3,145
-3.838944685394720,42,45,50,100,3,50
-3.839017894701460,14,20,190,250,6,60
-3.8395079368820200,58,60,50,150,2,100
-3.8396286153005000,58,60,100,175,2,75
-3.839719467166770,32,35,120,325,3,205
-3.8399915706533800,48,50,120,450,2,330
-3.840306818441830,68,70,130,175,2,45
-3.8404440057247300,12,20,80,125,8,45
-3.840579684203150,4,10,90,400,6,310
-3.840588648446430,6,15,120,325,9,205
-3.8412728629315400,6,15,120,300,9,180
-3.8412947434887900,4,10,70,325,6,255
-3.8414402125355200,20,25,200,225,5,25
-3.8415792385201900,4,10,70,300,6,230
-3.8416365224631000,4,10,70,500,6,430
-3.842013842567190,32,35,180,275,3,95
-3.8425367288745400,32,35,150,200,3,50
-3.843098010520940,6,15,200,275,9,75
-3.843504846723560,6,15,140,325,9,185
-3.843843265214880,48,50,160,500,2,340
-3.844112098575980,32,35,110,325,3,215
-3.8445427423486700,48,50,90,500,2,410
-3.8445601210596400,4,10,100,300,6,200
-3.8463875665719700,32,35,170,225,3,55
-3.8465905410481,14,20,100,175,6,75
-3.8477862636082200,48,50,100,500,2,400
-3.848016658297040,98,100,70,100,2,30
-3.8481603236899200,4,10,200,450,6,250
-3.8490916342238900,88,90,100,125,2,25
-3.849670393657060,26,30,70,150,4,80
-3.8505342644198200,32,35,170,275,3,105
-3.8506343400536000,48,50,200,450,2,250
-3.8523454905492400,12,20,190,200,8,10
-3.8523685105034300,68,70,90,150,2,60
-3.8525030057659200,58,60,200,250,2,50
-3.852964965167610,48,50,150,500,2,350
-3.8530198228157100,48,50,170,500,2,330
-3.853347197234080,26,30,80,150,4,70
-3.853853581085850,6,15,90,200,9,110
-3.8541651718565800,26,35,120,125,9,5
-3.8544509484392000,48,50,100,450,2,350
-3.855029068762260,4,10,100,475,6,375
-3.855606868816510,58,60,120,175,2,55
-3.8573637754987200,88,90,80,100,2,20
-3.8578995954876300,4,10,100,275,6,175
-3.858595801597280,48,50,80,250,2,170
-3.8587280257572600,48,50,180,475,2,295
-3.858937707379790,20,25,50,125,5,75
-3.859274670799320,62,65,140,150,3,10
-3.859701780971900,48,50,140,500,2,360
-3.860163543003630,32,35,60,200,3,140
-3.8608653813206200,48,50,90,475,2,385
-3.861232754383010,48,50,120,500,2,380
-3.861380826354640,96,100,120,125,4,5
-3.8614706610853100,48,50,170,475,2,305
-3.8615373289315900,32,35,80,200,3,120
-3.8625330110879300,4,10,110,225,6,115
-3.863103983208130,52,55,100,125,3,25
-3.8632609582188500,32,35,50,200,3,150
-3.8636080716996100,58,60,190,225,2,35
-3.8639617438456700,68,70,110,150,2,40
-3.8640524192175000,48,50,170,350,2,180
-3.8643961413000300,4,10,160,400,6,240
-3.8647991874849200,20,25,140,175,5,35
-3.8650474915331700,48,50,160,425,2,265
-3.865626037517580,48,50,170,400,2,230
-3.8656935934646500,60,65,120,125,5,5
-3.8657571840879000,4,10,110,250,6,140
-3.866049107742100,78,80,130,150,2,20
-3.8663253534448800,48,50,100,475,2,375
-3.866877876135520,48,50,130,450,2,320
-3.867118870240060,48,50,50,375,2,325
-3.867892976395060,32,35,120,300,3,180
-3.868325495901360,32,40,120,125,8,5
-3.868401666903750,4,10,170,500,6,330
-3.8688426740736900,48,50,50,425,2,375
-3.8691560439155800,20,25,130,175,5,45
-3.869296352466700,78,80,90,125,2,35
-3.8698040171075900,48,50,170,425,2,255
-3.870741176832360,78,80,160,175,2,15
-3.870882061069340,14,20,120,175,6,55
-3.871134227849270,32,35,180,250,3,70
-3.8715786175055800,88,90,70,100,2,30
-3.8716031846888,4,10,150,350,6,200
-3.871643722420280,32,35,200,275,3,75
-3.8717785196229,58,60,60,150,2,90
-3.871872133313930,48,50,130,500,2,370
-3.8720946832828800,48,50,160,475,2,315
-3.8722869843389800,26,30,100,150,4,50
-3.873952262767000,6,15,80,175,9,95
-3.8741033087492400,48,50,70,225,2,155
-3.874420502879820,32,35,160,200,3,40
-3.8745644008377900,48,50,70,500,2,430
-3.875130210348300,26,30,200,225,4,25
-3.875751408566320,48,50,50,400,2,350
-3.875785511602270,48,50,60,350,2,290
-3.8758352038686500,48,50,170,375,2,205
-3.8769175959101600,32,35,110,200,3,90
-3.87698244072274,48,50,50,500,2,450
-3.877363398098090,48,50,120,475,2,355
-3.8774641355878100,4,10,60,175,6,115
-3.8774916330917700,48,50,60,375,2,315
-3.8779285440273800,48,50,130,400,2,270
-3.879147519446000,48,50,100,425,2,325
-3.879152022345500,48,50,110,475,2,365
-3.8795766197966000,4,10,90,450,6,360
-3.879977274288340,48,50,160,350,2,190
-3.880147805085090,48,50,90,250,2,160
-3.8803518735139400,4,10,170,375,6,205
-3.8806855624185200,48,50,110,500,2,390
-3.8812920668290900,48,50,60,325,2,265
-3.881322102034860,32,35,180,225,3,45
-3.8816593900347200,48,50,180,450,2,270
-3.8817807044691200,48,50,190,450,2,260
-3.882155267017960,36,40,80,100,4,20
-3.882283756065680,4,10,70,450,6,380
-3.882528602506500,48,50,60,425,2,365
-3.88253448189095,48,50,120,225,2,105
-3.882733325950750,4,10,80,375,6,295
-3.883465777373950,6,15,190,275,9,85
-3.883617953964380,48,50,50,350,2,300
-3.8842389947693600,48,50,180,375,2,195
-3.884267392239090,8,15,50,375,7,325
-3.8844300961637400,48,50,120,400,2,280
-3.8845345634206400,68,70,180,200,2,20
-3.8845951118200500,38,45,120,125,7,5
-3.8846374754032900,20,25,180,200,5,20
-3.8849290001506200,32,35,50,175,3,125
-3.8853742493712600,26,30,50,125,4,75
-3.8855503253902800,8,15,70,225,7,155
-3.885671462119010,48,50,130,225,2,95
-3.8858880569049900,4,10,100,425,6,325
-3.8863045121244700,48,50,170,325,2,155
-3.886349068390490,32,35,190,275,3,85
-3.8863745756881000,4,10,170,475,6,305
-3.8870195122854400,8,15,200,500,7,300
-3.887244548899020,48,50,90,450,2,360
-3.8873195186909200,88,90,190,200,2,10
-3.887357160894480,12,20,60,100,8,40
-3.8878630358685800,48,50,130,475,2,345
-3.8885223276314100,48,50,50,450,2,400
-3.8887460940904100,20,25,110,150,5,40
-3.888959858778930,4,10,130,400,6,270
-3.8890307567806900,48,50,150,350,2,200
-3.889167251442950,48,50,180,425,2,245
-3.8892164545896700,6,15,190,225,9,35
-3.889503149850280,4,10,120,500,6,380
-3.8902710862994500,14,20,200,250,6,50
-3.890426995421230,48,50,180,400,2,220
-3.8905213530233300,48,50,70,475,2,405
-3.8915932839782700,48,50,130,375,2,245
-3.8919157278814700,8,15,50,350,7,300
-3.8924965132058500,26,30,90,150,4,60
-3.8926526529020800,48,50,70,375,2,305
-3.8926579553496900,48,50,120,425,2,305
-3.892748336405380,48,50,60,400,2,340
-3.892986846306530,24,30,140,150,6,10
-3.8932366959757100,48,50,110,450,2,340
-3.8932655321297300,48,50,160,400,2,240
-3.8936034401176700,4,10,190,450,6,260
-3.8937226713090500,32,35,60,175,3,115
-3.8938231027330600,48,50,200,400,2,200
-3.8952093859463200,82,85,170,175,3,5
-3.895680888350680,18,25,140,150,7,10
-3.8960694371352900,8,15,60,325,7,265
-3.896139894726100,4,10,70,475,6,405
-3.8963014629247600,32,35,100,200,3,100
-3.896592877913260,72,75,170,175,3,5
-3.896613854071650,48,50,90,400,2,310
-3.8966991456880700,4,10,100,325,6,225
-3.896699905595120,48,50,90,375,2,285
-3.8973913751956300,48,50,90,350,2,260
-3.8981297379551700,48,50,160,325,2,165
-3.8982175542927600,48,50,80,475,2,395
-3.898403867460960,48,50,150,400,2,250
-3.8988557632299500,32,35,90,200,3,110
-3.898891827654210,48,50,150,450,2,300
-3.899233323442840,32,35,130,200,3,70
-3.8995068918992000,68,70,60,125,2,65
-3.8995076967755700,6,15,60,150,9,90
-3.9000481061727000,4,10,180,475,6,295
-3.900099849004900,48,50,200,425,2,225
-3.900139476342080,48,50,80,500,2,420
-3.9003468168036900,48,50,150,475,2,325
-3.900727497590190,4,10,170,250,6,80
-3.901013158490600,26,30,140,175,4,35
-3.9017124547701500,32,35,120,200,3,80
-3.9020530306559300,4,10,110,500,6,390
-3.902074842545810,78,80,70,100,2,30
-3.902158062838810,4,10,80,300,6,220
-3.902184020637780,48,50,140,450,2,310
-3.902226925703710,48,50,150,325,2,175
-3.9023947189282000,48,50,80,375,2,295
-3.902729360315980,48,50,110,425,2,315
-3.9034921561062900,48,50,100,400,2,300
-3.903627418997290,48,50,50,475,2,425
-3.9039889931635900,4,10,150,500,6,350
-3.9040521379778000,48,50,140,375,2,235
-3.9047729832449200,48,50,80,450,2,370
-3.904818100654890,48,50,190,400,2,210
-3.9050885846806100,48,50,140,400,2,260
-3.905146538298200,52,55,70,100,3,30
-3.9060227336294100,42,45,160,175,3,15
-3.906023904982220,4,10,90,325,6,235
-3.906025283366180,48,50,200,300,2,100
-3.9062888566837300,48,50,150,425,2,275
-3.907007069179870,4,10,90,375,6,285
-3.907039030222020,30,35,90,100,5,10
-3.907513267018980,48,50,170,450,2,280
-3.908093177830540,32,35,70,175,3,105
-3.9083029491622100,14,20,70,150,6,80
-3.908332074168000,48,50,80,275,2,195
-3.9086823455847600,32,35,140,200,3,60
-3.908954239040260,8,15,50,275,7,225
-3.9092502042944200,48,50,130,425,2,295
-3.9092767900333800,4,10,190,325,6,135
-3.909744825466030,48,50,80,350,2,270
-3.909989792984250,48,50,190,425,2,235
-3.9100515309974000,42,45,80,125,3,45
-3.910385598636650,48,50,140,275,2,135
-3.910683318817010,48,50,60,500,2,440
-3.910724710962250,68,70,50,100,2,50
-3.91084244685405,4,10,170,425,6,255
-3.911655950597030,48,50,150,225,2,75
-3.911688732645850,48,50,100,225,2,125
-3.911788087133000,48,50,180,325,2,145
-3.9122438550046600,36,40,110,125,4,15
-3.9122539373187800,48,50,140,425,2,285
-3.912349962585700,4,10,60,500,6,440
-3.9127572266392200,6,15,90,175,9,85
-3.912953258517860,4,10,150,325,6,175
-3.913032544357210,48,50,60,300,2,240
-3.9130811837384800,48,50,190,350,2,160
-3.913114126299470,48,50,130,250,2,120
-3.9135012074198200,48,50,70,450,2,380
-3.9141234516365400,14,20,200,225,6,25
-3.9142421518652600,48,50,70,425,2,355
-3.9143510328583900,48,50,190,375,2,185
-3.914674293648370,8,15,200,475,7,275
-3.9149085678717300,48,50,190,325,2,135
-3.9149979597032300,8,15,50,400,7,350
-3.91505098994714,48,50,90,225,2,135
-3.915459474556910,48,50,140,350,2,210
-3.9161679649304300,58,60,70,150,2,80
-3.9165225054132100,4,10,70,425,6,355
-3.91657859179744,68,70,150,175,2,25
-3.9169279440085200,48,50,160,375,2,215
-3.9169557407525100,8,15,90,250,7,160
-3.9170732924410500,42,45,130,150,3,20
-3.9171871626101000,48,50,160,300,2,140
-3.917233751585680,12,20,100,125,8,25
-3.9173249456488200,4,10,80,500,6,420
-3.917329570547640,32,35,170,200,3,30
-3.9179950601112900,8,15,120,225,7,105
-3.918197739930990,48,50,70,275,2,205
-3.918411824867780,48,50,50,275,2,225
-3.9184253654243800,48,50,170,300,2,130
-3.9185490158952500,68,70,70,125,2,55
-3.9192433497049300,48,50,70,350,2,280
-3.9193324501308200,4,10,120,400,6,280
-3.9195874165624400,4,10,60,475,6,415
-3.9196670029898400,58,60,80,150,2,70
-3.9197151370237300,48,50,80,225,2,145
-3.919842063924790,58,60,200,225,2,25
-3.9202078987090500,4,10,120,475,6,355
-3.920235924588680,48,50,90,425,2,335
-3.9204454826991800,48,50,140,475,2,335
-3.92045571771688,48,50,70,250,2,180
-3.9211750993841800,4,10,180,325,6,145
-3.9211951799781500,48,50,200,350,2,150
-3.9212532668876800,20,25,60,125,5,65
-3.9212662515375300,48,50,120,350,2,230
-3.92193492659227,48,50,100,250,2,150
-3.9220460888870100,48,50,200,375,2,175
-3.922110698979810,48,50,160,450,2,290
-3.9225112629674500,26,30,130,175,4,45
-3.922905364533330,44,50,120,125,6,5
-3.9232908455643600,14,20,80,150,6,70
-3.92368235455423,8,15,130,225,7,95
-3.92399473617011,4,10,200,325,6,125
-3.9243822516731900,48,50,90,300,2,210
-3.924457231398430,48,50,140,225,2,85
-3.924574271647150,8,15,50,425,7,375
-3.924848992306250,48,50,200,325,2,125
-3.9248926298354100,8,15,190,475,7,285
-3.9263445987005200,48,50,140,250,2,110
-3.9265745998322900,4,10,130,500,6,370
-3.9269866981506600,48,50,110,400,2,290
-3.92709208122001,48,50,180,350,2,170
-3.9275952695501900,8,15,80,250,7,170
-3.9281552651503600,14,20,100,150,6,50
-3.9281937918646100,48,50,90,275,2,185
-3.928315309738720,48,50,160,275,2,115
-3.9293705750558600,58,60,100,150,2,50
-3.9294295665437100,48,50,60,475,2,415
-3.9294536504213700,48,50,110,350,2,240
-3.9294861693115600,4,10,120,425,6,305
-3.929516942488670,48,50,70,400,2,330
-3.9298128739911900,48,50,80,425,2,345
-3.9301248719283500,20,25,120,150,5,30
-3.9306501700129700,48,50,120,250,2,130
-3.9306855784300200,14,20,50,125,6,75
-3.931191640539980,8,15,190,500,7,310
-3.9314143496635900,4,10,110,450,6,340
-3.9315639947837100,4,10,120,275,6,155
-3.931714978259970,48,50,80,400,2,320
-3.9321227592209000,48,50,100,275,2,175
-3.9327777385188000,32,35,80,175,3,95
-3.933304723135670,6,15,190,250,9,60
-3.933423774176390,48,50,110,225,2,115
-3.933660958505340,48,50,100,325,2,225
-3.9340359469150500,42,45,90,125,3,35
-3.934104902120540,48,50,120,375,2,255
-3.936376151376030,48,50,60,450,2,390
-3.936676583979160,32,35,110,175,3,65
-3.9368383277430500,46,50,170,175,4,5
-3.9368948729577200,48,50,100,300,2,200
-3.937304108114860,4,10,150,400,6,250
-3.9377468784840200,4,10,80,450,6,370
-3.937834858470060,48,50,110,250,2,140
-3.937853476758560,48,50,90,325,2,235
-3.937969485196590,62,65,90,100,3,10
-3.9383294891473500,68,70,120,150,2,30
-3.938483186336300,4,10,160,275,6,115
-3.9387868062176700,8,15,60,425,7,365
-3.939325440590490,4,10,70,400,6,330
-3.9405868648763100,48,50,50,300,2,250
-3.9407949582920800,48,50,70,200,2,130
-3.941008487290270,8,15,150,225,7,75
-3.9413055027071500,48,50,110,275,2,165
-3.941514628706230,48,50,150,375,2,225
-3.941525642295320,76,80,120,125,4,5
-3.9417957521734000,4,10,130,450,6,320
-3.9418043870824400,8,15,50,500,7,450
-3.9420156819638000,78,80,100,125,2,25
-3.9426343945546000,48,50,180,300,2,120
-3.9434669651663700,26,30,180,200,4,20
-3.9435933424061100,24,30,90,100,6,10
-3.943593893508830,48,50,190,300,2,110
-3.9436347855233600,42,45,60,100,3,40
-3.944593923199600,4,10,100,400,6,300
-3.944644519742980,8,15,60,375,7,315
-3.944742639872100,48,50,100,375,2,275
-3.94592183533378,30,35,170,175,5,5
-3.9460303052880600,4,10,180,425,6,245
-3.9462130743896800,48,50,130,350,2,220
-3.9463154247144200,48,50,110,375,2,265
-3.9465696701413300,48,50,150,300,2,150
-3.9465998395471500,26,30,110,150,4,40
-3.947302418090890,4,10,110,475,6,365
-3.9479088794300300,8,15,60,350,7,290
-3.9481224934201400,48,50,100,350,2,250
-3.948282654011730,32,35,190,250,3,60
-3.9491890637991000,48,50,50,325,2,275
-3.949220632609360,58,60,90,150,2,60
-3.949258211231080,48,50,70,325,2,255
-3.949591377692460,8,15,180,500,7,320
-3.9496483492755000,8,15,90,500,7,410
-3.9497292410564700,48,50,110,300,2,190
-3.9499246115620600,4,10,160,475,6,315
-3.9500694942584500,8,15,100,500,7,400
-3.9503443084844200,48,50,50,225,2,175
-3.9508205738371500,48,50,60,275,2,215
-3.9513862880574200,8,15,120,450,7,330
-3.9516699248248800,8,15,60,400,7,340
-3.9520161489594600,48,50,70,300,2,230
-3.9531921010444000,4,10,150,250,6,100
-3.9532867305005500,8,15,50,450,7,400
-3.953778190121070,48,50,140,300,2,160
-3.9538247525178700,14,20,180,200,6,20
-3.9540036688374800,4,10,140,500,6,360
-3.954190052078330,78,80,190,200,2,10
-3.9546836262331700,4,10,180,300,6,120
-3.9548131637722800,20,25,150,175,5,25
-3.955173493099020,58,60,50,125,2,75
-3.9552523405137500,14,20,140,175,6,35
-3.9559079689276500,48,50,120,275,2,155
-3.955953286287500,8,15,100,450,7,350
-3.9559792525026600,48,50,60,225,2,165
-3.9578338653030000,58,60,130,175,2,45
-3.9587206950207200,26,30,150,175,4,25
-3.9595335605651300,8,15,90,225,7,135
-3.959572832142220,8,15,90,475,7,385
-3.959739120143130,58,60,140,175,2,35
-3.9614890569957500,4,10,140,450,6,310
-3.9614959129198700,48,50,60,250,2,190
-3.9615834601937600,14,20,90,150,6,60
-3.961696239832550,8,15,60,300,7,240
-3.9617257077146400,6,15,100,175,9,75
-3.9618873753101600,14,20,130,175,6,45
-3.9621965148194700,32,35,90,175,3,85
-3.962369583423940,4,10,200,400,6,200
-3.9630951709262300,4,10,110,275,6,165
-3.963103042367170,20,25,70,125,5,55
-3.9635520258569400,8,15,160,500,7,340
-3.9636294169829200,8,15,170,350,7,180
-3.9642481478991300,4,10,180,400,6,220
-3.964249039844440,8,15,160,325,7,165
-3.964405242518110,98,100,80,100,2,20
-3.964862748699720,48,50,80,325,2,245
-3.9655162595563100,48,50,80,300,2,220
-3.96626710871739,48,50,170,250,2,80
-3.968838165397980,8,15,200,450,7,250
-3.9688858044551200,48,50,150,275,2,125
-3.9691424736548900,48,50,120,325,2,205
-3.969395632829150,48,50,130,275,2,145
-3.969911692456450,4,10,130,375,6,245
-3.9702556615395200,18,25,90,100,7,10
-3.97028937269641,8,15,80,225,7,145
-3.9704613412142500,4,10,140,400,6,260
-3.970696476439570,8,15,170,400,7,230
-3.9712141901636800,48,50,150,250,2,100
-3.9714959294459000,48,50,130,300,2,170
-3.97166824408075,8,15,70,250,7,180
-3.9718912844617300,8,15,70,275,7,205
-3.9722915838224600,4,10,80,325,6,245
-3.973401374655800,6,15,70,150,9,80
-3.9734529979937900,4,10,180,450,6,270
-3.9736498136171400,4,10,70,175,6,105
-3.9738035758727000,8,15,80,275,7,195
-3.973829169670140,48,50,50,250,2,200
-3.9744222524188100,6,15,120,175,9,55
-3.9746045763297300,8,15,160,350,7,190
-3.974974375187530,32,35,190,225,3,35
-3.9754189993825900,32,35,50,150,3,100
-3.9755387571328300,8,15,70,500,7,430
-3.9756742636895000,8,15,50,475,7,425
-3.9762772034867100,8,15,170,325,7,155
-3.9767095564164100,48,50,160,250,2,90
-3.977170155116160,4,10,80,200,6,120
-3.9772942222047000,98,100,110,125,2,15
-3.978077937107680,4,10,110,175,6,65
-3.9782559858495300,8,15,170,500,7,330
-3.9786320209363000,20,25,50,100,5,50
-3.978988806194750,8,15,50,225,7,175
-3.9792409114065900,48,50,140,325,2,185
-3.9793600874224100,8,15,50,300,7,250
-3.9818622728932800,4,10,80,475,6,395
-3.98195860816452,4,10,130,425,6,295
-3.982151537859900,48,50,170,225,2,55
-3.982363255872690,12,20,70,100,8,30
-3.982973938675180,32,35,100,175,3,75
-3.983467272925800,48,50,110,325,2,215
-3.9841061320249800,4,10,140,200,6,60
-3.9849770779135100,4,10,130,475,6,345
-3.985011958353490,8,15,190,450,7,260
-3.985651258690900,48,50,160,225,2,65
-3.9859997876091400,8,15,100,225,7,125
-3.9865155777168500,4,10,170,450,6,280
-3.986544838250300,8,15,60,225,7,165
-3.9866977083510100,4,10,190,350,6,160
-3.987087196490120,4,10,60,450,6,390
-3.987155770216440,8,15,160,425,7,265
-3.9871982427674000,86,90,120,125,4,5
-3.98738806812355,8,15,130,250,7,120
-3.988434693340020,18,25,170,175,7,5
-3.988899683514890,8,15,70,475,7,405
-3.988932692906720,8,15,180,475,7,295
-3.990042626320800,4,10,200,425,6,225
-3.9904877378139100,8,15,150,500,7,350
-3.9909436282272600,4,10,80,425,6,345
-3.9909466702226500,6,15,180,200,9,20
-3.991333211685050,4,10,160,250,6,90
-3.9914480404925400,8,15,70,375,7,305
-3.9916266361078400,8,15,100,475,7,375
-3.9918308035943800,4,10,80,400,6,320
-3.9919956416004700,62,65,170,175,3,5
-3.9924748958285400,8,15,170,475,7,305
-3.9929416869045500,8,15,140,250,7,110
-3.992954405778280,48,50,180,275,2,95
-3.993045756685750,8,15,140,225,7,85
-3.9932945737575700,14,20,110,150,6,40
-3.9935443299167400,8,15,170,375,7,205
-3.9935730338122500,8,15,120,500,7,380
-3.994304287801420,58,60,110,150,2,40
-3.9944228612693100,4,10,150,450,6,300
-3.994800762487880,4,10,50,150,6,100
-3.994817849546930,4,10,150,300,6,150
-3.994916016950290,48,50,150,200,2,50
-3.99510876635114,58,60,180,200,2,20
-3.995140399715610,4,10,180,375,6,195
-3.9958244836996200,52,55,80,100,3,20
-3.996229182057240,8,15,70,200,7,130
-3.9962487183619500,8,15,130,500,7,370
-3.9969121926955100,8,15,90,300,7,210
-3.996979605317290,4,10,140,300,6,160
-3.9972298238221100,4,10,110,425,6,315
-3.9972910062608100,48,50,130,325,2,195
-3.9973992610943700,4,10,190,425,6,235
-3.9974373132629100,4,10,110,200,6,90
-3.9978209180367200,8,15,90,400,7,310
-3.998550165296520,26,30,120,150,4,30
-4.000698804967540,8,15,90,350,7,260
-4.000718331441810,4,10,100,375,6,275
-4.000955539700710,42,45,190,200,3,10
-4.002299795104350,68,70,80,125,2,45
-4.002498036642070,4,10,180,350,6,170
-4.002700631247660,4,10,160,375,6,215
-4.003790828364520,8,15,50,325,7,275
-4.004199479975540,4,10,90,425,6,335
-4.005098638653980,36,40,140,150,4,10
-4.005246480902790,8,15,120,475,7,355
-4.005881939213330,8,15,130,400,7,270
-4.006025770356720,6,15,50,125,9,75
-4.006078387759610,48,50,120,300,2,180
-4.006701527749060,8,15,160,400,7,240
-4.007081519100370,4,10,200,350,6,150
-4.007170742744560,28,35,120,125,7,5
-4.007285767438000,48,50,170,275,2,105
-4.007660821768960,8,15,110,500,7,390
-4.0077969770287600,8,15,60,250,7,190
-4.0083672025043300,8,15,90,450,7,360
-4.008701692549310,4,10,100,350,6,250
-4.0087303753054600,4,10,140,425,6,285
-4.008973428045930,48,50,80,200,2,120
-4.009842531786140,32,35,200,250,3,50
-4.010071905489730,4,10,190,300,6,110
-4.010165364618,8,15,120,400,7,280
-4.0104514416853900,14,20,120,150,6,30
-4.010549535118880,4,10,110,300,6,190
-4.010852242315460,8,15,100,425,7,325
-4.011197013341550,32,35,60,150,3,90
-4.011392572651970,26,30,60,125,4,65
-4.012641616824260,4,10,140,375,6,235
-4.012817972481460,8,15,150,350,7,200
-4.013046712116160,6,15,100,150,9,50
-4.013444294644340,4,10,150,475,6,325
-4.013774726678550,8,15,100,250,7,150
-4.01445817133628,8,15,50,250,7,200
-4.014679762546530,8,15,120,250,7,130
-4.015190919444990,8,15,110,475,7,365
-4.0152426505148000,32,35,120,175,3,55
-4.015327249284710,8,15,130,450,7,320
-4.015374979000820,8,15,90,375,7,285
-4.015394216892150,8,15,90,275,7,185
-4.015537979213360,88,90,110,125,2,15
-4.015696043622900,6,15,200,225,9,25
-4.0157157054890000,8,15,170,425,7,255
-4.015937629509510,8,15,170,300,7,130
-4.016305759007550,8,15,70,350,7,280
-4.016396191765140,48,50,180,250,2,70
-4.016698980427180,48,50,200,275,2,75
-4.017065909716810,4,10,190,400,6,210
-4.0171199554417800,26,30,70,125,4,55
-4.017946466753170,8,15,140,500,7,360
-4.019280841998730,8,15,200,300,7,100
-4.019420088414480,8,15,120,425,7,305
-4.019969129862880,20,25,160,175,5,15
-4.020276627812430,8,15,150,400,7,250
-4.020311896056410,8,15,160,300,7,140
-4.0213525651226600,8,15,140,275,7,135
-4.0219756559051500,8,15,80,450,7,370
-4.021987767727130,4,10,120,350,6,230
-4.022636926969650,8,15,70,450,7,380
-4.023964795204350,68,70,130,150,2,20
-4.024214928946500,4,10,150,425,6,275
-4.024298395155800,8,15,100,400,7,300
-4.024970804601020,58,60,150,175,2,25
-4.025030106945990,4,10,150,275,6,125
-4.0252820484168,8,15,130,475,7,345
-4.0255166494259,8,15,80,350,7,270
-4.025659542355650,8,15,80,375,7,295
-4.025841843714050,8,15,180,325,7,145
-4.025860763835600,68,70,90,125,2,35
-4.026536021752530,24,30,170,175,6,5
-4.026548774801660,32,35,70,150,3,80
-4.026749196902150,8,15,180,450,7,270
-4.027013995545120,48,50,60,200,2,140
-4.028002475461270,48,50,190,275,2,85
-4.028438282644510,4,10,110,400,6,290
-4.029215432815010,8,15,70,425,7,355
-4.029391751671270,4,10,130,200,6,70
-4.029491529519890,8,15,180,425,7,245
-4.0299506856138300,48,50,160,200,2,40
-4.029961457002750,48,50,130,200,2,70
-4.0301452915848800,42,45,100,125,3,25
-4.030156156702160,8,15,130,375,7,245
-4.030190467375950,8,15,160,475,7,315
-4.031626504571840,8,15,60,275,7,215
-4.0320921094428700,58,60,120,150,2,30
-4.0324405371195700,48,50,110,200,2,90
-4.0324634900858600,26,30,160,175,4,15
-4.032577606826990,8,15,60,500,7,440
-4.032859599087080,8,15,150,450,7,300
-4.032985037854050,52,55,110,125,3,15
-4.033891271409050,8,15,190,425,7,235
-4.033907213699550,6,15,200,250,9,50
-4.03402437649312,8,15,80,500,7,420
-4.035054039074100,8,15,70,325,7,255
-4.035412130853560,8,15,100,325,7,225
-4.0355297865172700,4,10,140,350,6,210
-4.036010696578370,8,15,200,400,7,200
-4.036268396933040,8,15,110,450,7,340
-4.036350757841930,20,25,130,150,5,20
-4.037023985009650,8,15,140,400,7,260
-4.037091665224590,8,15,200,325,7,125
-4.037137575101870,8,15,200,425,7,225
-4.0371733076630000,20,25,80,125,5,45
-4.037822197574480,14,20,150,175,6,25
-4.038147635319610,68,70,160,175,2,15
-4.038440353685190,4,10,130,350,6,220
-4.03887548616606,8,15,180,400,7,220
-4.03890534597236,4,10,130,275,6,145
-4.039141475926250,4,10,110,350,6,240
-4.039143712643840,48,50,50,200,2,150
-4.039335482964860,8,15,60,475,7,415
-4.039593096703480,8,15,150,325,7,175
-4.039898630320980,48,50,90,200,2,110
-4.0412472819078600,8,15,70,300,7,230
-4.041484057033360,4,10,120,200,6,80
-4.0418517867256900,8,15,180,350,7,170
-4.041991000225620,8,15,130,425,7,295
-4.0423686063596000,8,15,170,450,7,280
-4.0427531893005600,8,15,150,425,7,275
-4.043040557915370,36,40,90,100,4,10
-4.043416827400320,58,60,70,125,2,55
-4.043923547924830,8,15,160,225,7,65
-4.0443586421568600,20,25,90,125,5,35
-4.044636290293360,58,60,60,125,2,65
-4.044650563690550,8,15,150,200,7,50
-4.045160088990900,8,15,190,325,7,135
-4.045441776002050,8,15,110,250,7,140
-4.045470491934380,6,15,140,175,9,35
-4.045856132692250,8,15,190,350,7,160
-4.0470129929398100,8,15,80,475,7,395
-4.047090008292660,48,50,100,200,2,100
-4.047766480730670,48,50,180,225,2,45
-4.048129192455190,8,15,90,325,7,235
-4.0483418932392900,48,50,50,175,2,125
-4.04840074006803,42,45,70,100,3,30
-4.048404104427150,8,15,100,300,7,200
-4.048446596234160,4,10,100,200,6,100
-4.049106917811300,8,15,100,275,7,175
-4.051070187554500,8,15,140,450,7,310
-4.051382205871220,8,15,140,425,7,285
-4.051531051231970,48,50,120,200,2,80
-4.052535173022070,50,55,120,125,5,5
-4.052731924019350,6,15,80,150,9,70
-4.052777750219860,8,15,190,400,7,210
-4.053618829983450,8,15,110,225,7,115
-4.054490214392900,68,70,60,100,2,40
-4.054761828145380,8,15,160,375,7,215
-4.054809910217780,8,15,180,375,7,195
-4.055425774263350,8,15,120,275,7,155
-4.056665834307830,8,15,150,475,7,325
-4.0572619282116100,4,10,190,375,6,185
-4.057444901210780,26,30,50,100,4,50
-4.057814386461980,32,35,80,150,3,70
-4.05792758258103,58,60,50,100,2,50
-4.058116636316950,12,20,110,125,8,15
-4.058967065742030,8,15,70,400,7,330
-4.059687843637080,8,15,110,425,7,315
-4.062184785995140,8,15,140,375,7,235
-4.062669611393520,8,15,110,275,7,165
-4.0628445945207500,8,15,60,450,7,390
-4.062972621678510,8,15,200,350,7,150
-4.063768868902050,8,15,170,250,7,80
-4.063881371545370,14,20,60,125,6,65
-4.064082904530340,8,15,160,275,7,115
-4.065018706760230,8,15,80,425,7,345
-4.0654376803441800,8,15,140,350,7,210
-4.065965507368850,4,10,110,325,6,215
-4.066167432281030,8,15,140,300,7,160
-4.066743599662140,8,15,160,250,7,90
-4.066939729815140,8,15,80,300,7,220
-4.067451121558720,98,100,140,150,2,10
-4.069049465581630,48,50,60,175,2,115
-4.069332554243530,4,10,140,475,6,335
-4.069932258080020,48,50,70,175,2,105
-4.070124263886150,14,20,160,175,6,15
-4.0703184874658800,8,15,180,300,7,120
-4.07063170669846,8,15,140,475,7,335
-4.071117613634020,8,15,90,425,7,335
-4.071791719327330,8,15,190,375,7,185
-4.072177128275400,8,15,150,250,7,100
-4.073180150508450,32,35,100,150,3,50
-4.073387928153950,48,50,140,200,2,60
-4.07555286452191,6,15,110,150,9,40
-4.076366406434390,8,15,120,350,7,230
-4.076588804959980,8,15,180,225,7,45
-4.077156556363920,4,10,180,200,6,20
-4.077527995644520,66,70,120,125,4,5
-4.077531000357790,8,15,110,350,7,240
-4.077823871724420,8,15,100,350,7,250
-4.078360125181680,12,20,80,100,8,20
-4.078968677406900,8,15,200,375,7,175
-4.079660318431470,8,15,160,450,7,290
-4.080005142274300,14,20,50,100,6,50
-4.081951977009400,14,20,70,125,6,55
-4.082760343659710,4,10,160,450,6,290
-4.082962299078210,4,10,60,150,6,90
-4.083222355643130,8,15,80,400,7,320
-4.083717185273780,8,15,110,400,7,290
-4.083817084375860,8,15,60,200,7,140
-4.084647622223590,8,15,50,200,7,150
-4.084993156952570,8,15,170,225,7,55
-4.085370676826280,8,15,110,300,7,190
-4.085663458047500,20,25,190,200,5,10
-4.085782706271410,8,15,80,325,7,245
-4.086377974991440,8,15,150,300,7,150
-4.086472329493710,48,50,110,175,2,65
-4.086735317896350,8,15,190,300,7,110
-4.086776874490110,32,35,50,125,3,75
-4.08701427891015,32,35,90,150,3,60
-4.087329540113100,6,15,90,150,9,60
-4.088439272648020,8,15,80,200,7,120
-4.089289149705470,8,15,130,350,7,220
-4.089744486205130,8,15,160,200,7,40
-4.090663382673220,8,15,100,375,7,275
-4.091139679254980,68,70,190,200,2,10
-4.092416966746080,32,35,200,225,3,25
-4.093223209140630,48,50,80,175,2,95
-4.093935224414460,4,10,130,300,6,170
-4.095222135704050,6,15,120,150,9,30
-4.096400647547190,26,30,80,125,4,45
-4.096887711868630,8,15,50,175,7,125
-4.097691652544460,32,35,140,175,3,35
-4.098808420198010,4,10,200,375,6,175
-4.098845861799570,4,10,110,375,6,265
-4.0990934400163400,8,15,130,275,7,145
-4.100621987422130,78,80,80,100,2,20
-4.100668764954920,26,30,130,150,4,20
-4.100692673593440,4,10,190,225,6,35
-4.102769870846810,34,40,120,125,6,5
-4.103334013994160,8,15,150,275,7,125
-4.103643029216530,6,15,130,175,9,45
-4.104878005629110,8,15,120,375,7,255
-4.105698179649600,4,10,180,250,6,70
-4.107060588791490,48,50,190,250,2,60
-4.107205777675360,20,25,60,100,5,40
-4.107677862659950,48,50,90,175,2,85
-4.107724554521000,78,80,110,125,2,15
-4.108070767795890,8,15,150,375,7,225
-4.109570511242340,8,15,110,325,7,215
-4.109651459285020,16,20,200,500,4,300
-4.1097477285703600,6,15,50,100,9,50
-4.110319349421890,6,15,160,175,9,15
-4.112193655263140,4,10,120,375,6,255
-4.112667651047900,32,35,130,175,3,45
-4.112804908871390,26,30,90,125,4,35
-4.113006373223050,4,10,90,200,6,110
-4.113787159261450,52,55,140,150,3,10
-4.116260244620110,8,15,110,375,7,265
-4.1169291291159600,58,60,160,175,2,15
-4.119183559196840,48,50,170,200,2,30
-4.12137774451123,36,40,170,175,4,5
-4.122663772558130,20,25,100,125,5,25
-4.122806473483290,32,35,180,200,3,20
-4.124341716130110,8,15,130,300,7,170
-4.1269281087674200,6,15,150,175,9,25
-4.127203566027520,4,10,80,175,6,95
-4.127675019599920,16,20,190,475,4,285
-4.128065122454150,58,60,80,125,2,45
-4.12825859520766,8,15,170,200,7,30
-4.128910427753000,16,20,190,500,4,310
-4.129830741103420,4,10,200,275,6,75
-4.1307342231908,48,50,100,175,2,75
-4.1314951721925900,32,35,110,150,3,40
-4.132798025788520,88,90,140,150,2,10
-4.1339481012891400,92,95,120,125,3,5
-4.134732792203100,16,20,200,475,4,275
-4.134775284575050,68,70,100,125,2,25
-4.134854720753960,88,90,90,100,2,10
-4.1360467205968100,4,10,170,275,6,105
-4.137654833675060,8,15,60,175,7,115
-4.138120990349960,48,50,50,150,2,100
-4.13821121524478,16,20,50,350,4,300
-4.138973591537340,16,20,50,375,4,325
-4.139347980865120,12,20,140,150,8,10
-4.139387550297360,4,10,120,300,6,180
-4.14060510531643,8,15,120,325,7,205
-4.140715750772810,4,10,180,275,6,95
-4.14253711648761,4,10,150,375,6,225
-4.143185694563900,16,20,50,400,4,350
-4.143425487436980,98,100,90,100,2,10
-4.14426112573234,8,15,140,325,7,185
-4.144318046002630,8,15,170,275,7,105
-4.146279664682760,26,30,60,100,4,40
-4.146855520097070,14,20,80,125,6,45
-4.146976702752270,16,20,50,425,4,375
-4.147636232280770,8,15,110,200,7,90
-4.149433697882390,8,15,130,325,7,195
-4.149686408847160,8,15,180,275,7,95
-4.151721854872490,58,60,130,150,2,20
-4.153812728345700,16,20,180,500,4,320
-4.154062271748500,16,20,70,225,4,155
-4.154179443653160,22,25,200,500,3,300
-4.15443827392118,8,15,130,200,7,70
-4.154508206056460,16,20,60,325,4,265
-4.154776381363340,56,60,120,125,4,5
-4.154817574977980,48,50,190,225,2,35
-4.154973705176200,58,60,90,125,2,35
-4.155377575213730,8,15,70,175,7,105
-4.155458896246750,16,20,80,250,4,170
-4.156149126071640,8,15,120,300,7,180
-4.15635135982214,8,15,90,200,7,110
-4.157661263598120,38,40,200,500,2,300
-4.157738728250610,4,10,90,175,6,85
-4.15778351431107,48,50,200,250,2,50
-4.157849328510780,8,15,100,200,7,100
-4.15797435110244,16,20,90,250,4,160
-4.158654994341620,16,20,160,500,4,340
-4.158989375567150,26,30,190,200,4,10
-4.159967216470680,8,15,120,200,7,80
-4.160771064920540,4,10,140,325,6,185
-4.161185669213610,4,10,130,325,6,195
-4.161206254851120,68,70,70,100,2,30
-4.162474991515620,14,20,130,150,6,20
-4.163120087643530,16,20,170,350,4,180
-4.163216204236480,16,20,90,475,4,385
-4.164083298726600,16,20,100,500,4,400
-4.167269796144480,14,20,90,125,6,35
-4.1674470000226400,32,35,150,175,3,25
-4.167505559398560,32,35,120,150,3,30
-4.168097797029560,16,20,120,450,4,330
-4.168704263702730,4,10,120,325,6,205
-4.1693018906798200,8,15,200,275,7,75
-4.170256324468600,42,45,110,125,3,15
-4.170260787938800,16,20,90,500,4,410
-4.170461664114010,48,50,60,150,2,90
-4.170713963436260,42,45,80,100,3,20
-4.170848331704290,8,15,110,175,7,65
-4.171885889041570,16,20,60,425,4,365
-4.172050162232450,16,20,50,500,4,450
-4.172804661500230,48,50,120,175,2,55
-4.174975702047400,38,40,200,475,2,275
-4.175401139910590,16,20,170,400,4,230
-4.1755528716210400,16,20,200,450,4,250
-4.175657835648960,8,15,140,200,7,60
-4.175798587338780,16,20,160,425,4,265
-4.1759611188661900,16,20,130,225,4,95
-4.176276650080180,22,25,200,475,3,275
-4.177282701659170,16,20,120,225,4,105
-4.178222652596220,16,20,50,450,4,400
-4.178399503194340,16,20,60,350,4,290
-4.178766836204450,14,20,60,100,6,40
-4.17885842971719,8,15,180,250,7,70
-4.179275466280130,26,30,100,125,4,25
-4.179630805233800,38,40,190,500,2,310
-4.180030776814560,16,20,150,500,4,350
-4.181936998284470,16,20,70,375,4,305
-4.181964746325670,32,35,60,125,3,65
-4.182901556584940,16,20,100,475,4,375
-4.183425659281310,22,25,190,500,3,310
-4.184421626607970,22,25,190,475,3,285
-4.184552038644570,16,20,100,450,4,350
-4.184933613106260,16,20,140,500,4,360
-4.185289950519440,16,20,170,500,4,330
-4.185507442522010,16,20,50,275,4,225
-4.18625135252783,16,20,180,475,4,295
-4.1870524862880300,22,25,50,375,3,325
-4.187429355458630,16,20,60,375,4,315
-4.18785898087343,38,40,180,500,2,320
-4.188177563897670,16,20,70,500,4,430
-4.188790355363490,52,55,90,100,3,10
-4.189063915516980,38,40,190,475,2,285
-4.190091820387710,16,20,170,325,4,155
-4.190256961929810,6,15,60,125,9,65
-4.190829171915580,20,25,70,100,5,30
-4.19098756554102,16,20,50,475,4,425
-4.191291737717980,16,20,150,225,4,75
-4.191732243868430,32,35,70,125,3,55
-4.192205041497690,16,20,170,375,4,205
-4.192485466877710,16,20,160,350,4,190
-4.192883440947020,8,15,50,150,7,100
-4.192929637867250,38,40,50,375,2,325
-4.19301282257603,4,10,50,100,6,50
-4.19308823015654,16,20,120,500,4,380
-4.19378682352285,16,20,120,475,4,355
-4.194406459990390,16,20,170,475,4,305
-4.194788325928290,16,20,190,450,4,260
-4.194881494614710,22,30,120,125,8,5
-4.195528203828370,22,25,180,500,3,320
-4.195720749298520,6,15,70,125,9,55
-4.195773000403860,16,20,110,500,4,390
-4.195834855317380,22,25,50,400,3,350
-4.196103049819810,16,20,140,400,4,260
-4.196895634567180,6,15,130,150,9,20
-4.197049753524080,6,15,190,200,9,10
-4.19720801470786,16,20,200,300,4,100
-4.198146453870740,16,20,60,400,4,340
-4.198431892326740,16,20,160,300,4,140
-4.198991239760240,48,50,70,150,2,80
-4.1994241611511300,16,20,90,450,4,360
-4.2001273988848700,16,20,160,325,4,165
-4.200361268014820,22,25,50,425,3,375
-4.201062938397830,22,25,170,350,3,180
-4.201116289057480,22,25,160,500,3,340
-4.201557971682870,16,20,160,400,4,240
-4.202530417563320,16,20,150,450,4,300
-4.203193289134560,16,20,130,500,4,370
-4.203205346474700,8,15,190,275,7,85
-4.2032459081497800,16,20,130,450,4,320
-4.203867428178580,16,20,160,475,4,315
-4.204172973305060,38,40,120,450,2,330
-4.204229795345720,38,40,100,500,2,400
-4.204254886094910,16,20,180,425,4,245
-4.204740851472680,16,20,70,250,4,180
-4.2048568474682000,22,25,170,500,3,330
-4.20499147345809,22,25,100,500,3,400
-4.205651048982500,16,20,90,400,4,310
-4.205818390670950,16,20,150,475,4,325
-4.205907383078590,16,20,130,250,4,120
-4.205984888634070,16,20,90,225,4,135
-4.206174756193950,22,25,60,350,3,290
-4.206488160167080,16,20,150,400,4,250
-4.206930346137230,38,40,90,500,2,410
-4.207345306007200,38,40,90,475,2,385
-4.207679898233290,22,25,120,450,3,330
-4.2079886842972600,16,20,50,225,4,175
-4.208253492138170,22,25,60,425,3,365
-4.208298876814110,16,20,70,475,4,405
-4.208337198955830,58,60,190,200,2,10
-4.2084274003928000,16,20,100,425,4,325
-4.2087114389914300,38,40,160,500,2,340
-4.209490354987850,14,20,190,200,6,10
-4.209672024597150,16,20,170,300,4,130
-4.209811063157400,22,25,90,250,3,160
-4.210380268533520,16,20,110,475,4,365
-4.210563661760440,22,25,50,350,3,300
-4.210695310103250,38,40,120,500,2,380
-4.210975497258160,22,25,70,225,3,155
-4.211033139702510,22,25,60,325,3,265
-4.211091148384950,38,40,100,475,2,375
-4.211519810037770,22,25,50,500,3,450
-4.211521381128340,38,40,200,450,2,250
-4.212028450571610,16,20,130,375,4,245
-4.212129663011890,22,25,100,450,3,350
-4.212828067809680,16,20,170,425,4,255
-4.212976895998880,12,20,90,100,8,10
-4.213091191487080,16,20,140,250,4,110
-4.213597373924050,16,20,140,225,4,85
-4.213815367173420,38,40,160,425,2,265
-4.214169043771030,16,20,90,350,4,260
-4.2142816993888000,22,25,130,225,3,95
-4.214515639820290,16,20,120,400,4,280
-4.214613411667000,16,20,130,400,4,270
-4.214699725594910,58,60,60,100,2,40
-4.214863464287210,22,25,60,375,3,315
-4.214867143073610,38,40,170,475,2,305
-4.214969205567320,22,25,120,225,3,105
-4.215061955757060,16,20,100,225,4,125
-4.2150955291915100,4,10,100,150,6,50
-4.215313636093250,22,25,90,500,3,410
-4.215876113269100,16,20,150,350,4,200
-4.216709954627320,16,20,90,300,4,210
-4.218040360001050,22,25,200,450,3,250
-4.218102300077010,38,40,130,500,2,370
-4.2181850838299000,38,40,170,350,2,180
-4.21834784782335,58,60,100,125,2,25
-4.2187758605883100,16,20,180,450,4,270
-4.218912516384910,8,15,80,175,7,95
-4.218920257396430,48,50,80,150,2,70
-4.218961522182320,26,30,70,100,4,30
-4.219205260953140,16,20,80,225,4,145
-4.219612939372920,16,20,70,450,4,380
-4.219803114110410,16,20,140,275,4,135
-4.219880308004510,16,20,60,300,4,240
-4.220267070152530,16,20,80,350,4,270
-4.220643440099490,38,40,100,450,2,350
-4.220748188284490,22,25,150,500,3,350
-4.220748419561630,16,20,200,400,4,200
-4.22092843226794,22,25,170,325,3,155
-4.221292288256950,16,20,100,250,4,150
-4.221398177162260,16,20,120,425,4,305
-4.221704515373320,38,40,70,225,2,155
-4.22206846167086,16,20,110,450,4,340
-4.222484681773110,38,40,170,500,2,330
-4.222503619591920,16,20,170,450,4,280
-4.222890161603230,48,50,200,225,2,25
-4.22293811154159,16,20,70,275,4,205
-4.223190347690090,16,20,90,275,4,185
-4.223808442845730,16,20,70,350,4,280
-4.224254777309400,16,20,140,450,4,310
-4.224382930029310,16,20,130,475,4,345
-4.225043506681810,38,40,60,350,2,290
-4.225114371872190,16,20,80,475,4,395
-4.225366632362990,16,20,130,425,4,295
-4.225377459611520,16,20,120,250,4,130
-4.225403939457600,38,40,170,425,2,255
-4.225459726780970,38,40,50,350,2,300
-4.225661773558840,16,20,80,450,4,370
-4.225952906366030,16,20,180,375,4,195
-4.226077566229870,22,25,90,475,3,385
-4.226180680536060,4,10,160,175,6,15
-4.226750353854930,40,45,120,125,5,5
-4.226831369801170,16,20,80,275,4,195
-4.226958129641550,4,10,50,125,6,75
-4.2275560054154500,22,25,80,250,3,170
-4.227620457354470,22,25,170,425,3,255
-4.227765429031460,22,25,170,475,3,305
-4.227891432833700,4,10,100,175,6,75
-4.228171646682910,16,20,60,500,4,440
-4.228223164738430,38,40,180,475,2,295
-4.2286882790003200,4,10,200,225,6,25
-4.229242976851150,22,25,100,475,3,375
-4.229284138485650,16,20,70,200,4,130
-4.229294462358700,38,40,60,425,2,365
-4.2296835568070400,38,40,170,400,2,230
-4.2297548925539300,16,20,60,475,4,415
-4.229872157097950,22,25,50,475,3,425
-4.22997988494947,22,25,160,350,3,190
-4.23008049945413,22,25,120,500,3,380
-4.230128685721290,16,20,200,425,4,225
-4.230355130734950,4,10,190,275,6,85
-4.230571835438120,12,20,170,175,8,5
-4.230818715188630,38,40,60,375,2,315
-4.2308670994327100,22,25,90,400,3,310
-4.231182917255380,38,40,190,450,2,260
-4.231391928407930,16,20,180,400,4,220
-4.231627497545140,38,40,160,325,2,165
-4.231952151245260,38,40,140,500,2,360
-4.232170483736680,22,25,170,375,3,205
-4.232177991575320,38,40,120,225,2,105
-4.2322748464559500,22,25,160,425,3,265
-4.232597586190850,38,40,100,425,2,325
-4.232809915852750,48,50,100,150,2,50
-4.232849077934400,38,40,170,375,2,205
-4.2331558130747400,22,25,170,400,3,230
-4.233746844335100,38,40,90,250,2,160
-4.2341218441292100,16,20,70,425,4,355
-4.234160577504690,22,25,190,450,3,260
-4.234429114762110,52,55,170,175,3,5
-4.234662922104950,38,40,150,500,2,350
-4.235142449114340,32,35,50,100,3,50
-4.235243861515330,22,25,70,500,3,430
-4.235247146216970,16,20,100,400,4,300
-4.235262946813210,16,20,80,500,4,420
-4.235440911405140,22,25,60,400,3,340
-4.235608585398300,16,20,190,325,4,135
-4.235713287650160,22,25,100,225,3,125
-4.235792644786990,16,20,190,425,4,235
-4.2359540759218500,16,20,70,325,4,255
-4.235978023116370,16,20,100,325,4,225
-4.236084034742160,78,80,140,150,2,10
-4.236109055318440,38,40,50,425,2,375
-4.236187596876970,16,20,180,350,4,170
-4.236379589692600,38,40,160,475,2,315
-4.236822490510820,16,20,110,425,4,315
-4.236902085702190,16,20,50,250,4,200
-4.236963206786220,16,20,90,375,4,285
-4.237002015954490,16,20,150,425,4,275
-4.237017659398170,48,50,130,175,2,45
-4.237344668777670,16,20,90,425,4,335
-4.237402666786170,22,25,160,325,3,165
-4.238372218685480,38,40,50,400,2,350
-4.238566542064150,16,20,150,325,4,175
-4.238772588131770,22,25,50,275,3,225
-4.238860144226290,38,40,130,225,2,95
-4.23902773898163,16,20,80,375,4,295
-4.239107486159500,38,40,150,475,2,325
-4.239116952828770,38,40,50,500,2,450
-4.240172050995010,38,40,170,325,2,155
-4.240271260159450,38,40,110,500,2,390
-4.240294964057400,38,40,160,350,2,190
-4.2409719851974000,8,15,90,175,7,85
-4.241023906428120,22,25,50,450,3,400
-4.2412493031849800,16,20,50,300,4,250
-4.241307976310580,22,25,90,450,3,360
-4.241461918915720,16,20,70,400,4,330
-4.24189198799421,38,40,80,250,2,170
-4.241975600455540,38,40,200,400,2,200
-4.242138620282100,38,40,60,400,2,340
-4.242566255962050,22,25,120,475,3,355
-4.2425822638321800,16,20,200,325,4,125
-4.2425922735815300,48,50,90,150,2,60
-4.242659283015370,16,20,140,375,4,235
-4.242665167150350,38,40,200,425,2,225
-4.242966897950540,38,40,70,500,2,430
-4.243225762099740,22,25,70,375,3,305
-4.243303352187820,94,95,200,500,1,300
-4.243391748673830,22,25,160,475,3,315
-4.2434367382340500,22,25,150,225,3,75
-4.24344373669024,22,25,180,475,3,295
-4.243461126169030,16,20,140,425,4,285
-4.243529505923560,22,25,100,425,3,325
-4.243540938787680,22,25,130,450,3,320
-4.243629923731700,48,50,50,125,2,75
-4.2442086986453000,38,40,130,475,2,345
-4.245119229708230,48,50,140,175,2,35
-4.24514358591303,16,20,50,325,4,275
-4.245967228451100,16,20,60,225,4,165
-4.246133569722800,38,40,180,450,2,270
-4.2461692355227500,22,25,160,300,3,140
-4.246391236862620,22,25,110,475,3,365
-4.247007045892960,38,40,130,400,2,270
-4.247055900990460,38,40,50,450,2,400
-4.247321619699050,16,20,100,275,4,175
-4.2475553401636,22,25,130,475,3,345
-4.247758200636350,8,15,60,150,7,90
-4.2479379135372800,58,60,70,100,2,30
-4.248097569943850,38,40,50,475,2,425
-4.248197755615620,38,40,150,400,2,250
-4.2482043597402600,38,40,160,400,2,240
-4.2482238495438200,22,25,70,475,3,405
-4.248230377818640,16,20,190,350,4,160
-4.248380790492590,22,25,110,500,3,390
-4.248452730360920,22,25,140,500,3,360
-4.248567127219330,16,20,180,325,4,145
-4.248730368217640,22,25,130,500,3,370
-4.2487543881874200,16,20,100,300,4,200
-4.248898273634030,38,40,120,475,2,355
-4.249030593538220,38,40,180,425,2,245
-4.249071418380620,38,40,110,475,2,365
-4.249598293547490,16,20,110,250,4,140
-4.249636354093370,16,20,70,300,4,230
-4.250232727077370,38,40,90,450,2,360
-4.250615422648620,16,20,200,350,4,150
-4.250656545718520,38,40,130,450,2,320
-4.250937014576730,42,45,140,150,3,10
-4.251027237069310,38,40,90,400,2,310
-4.251373048482050,16,20,160,375,4,215
-4.251463897783680,22,25,60,300,3,240
-4.251531701707480,22,25,160,400,3,240
-4.251543743436990,22,25,70,250,3,180
-4.251770019558240,8,15,190,225,7,35
-4.251844563391810,32,35,160,175,3,15
-4.252147616922040,16,20,170,225,4,55
-4.252672765222530,32,35,80,125,3,45
-4.252875512795900,16,20,190,375,4,185
-4.253084049421830,4,10,70,150,6,80
-4.253103908350710,16,20,80,425,4,345
-4.253483665781510,16,20,60,450,4,390
-4.2539796182408400,16,20,180,300,4,120
-4.254099689113760,38,40,70,375,2,305
-4.254108673484920,38,40,80,450,2,370
-4.25423623654727,38,40,120,400,2,280
-4.254439787085980,22,25,180,425,3,245
-4.254616520153250,22,25,50,225,3,175
-4.254620655039720,16,20,140,475,4,335
-4.254698526160280,14,20,100,125,6,25
-4.254787426588730,38,40,180,375,2,195
-4.254818138128890,22,25,150,400,3,250
-4.255460160601550,22,25,100,250,3,150
-4.255968710538120,22,25,180,450,3,270
-4.256140309387190,16,20,190,300,4,110
-4.256404458664160,22,25,90,225,3,135
-4.256472512397830,22,25,200,300,3,100
-4.25659350741331,16,20,120,350,4,230
-4.256699602079890,38,40,140,450,2,310
-4.256757331651710,16,25,120,125,9,5
-4.2573314108343700,38,40,150,450,2,300
-4.257481584905810,38,40,130,375,2,245
-4.257531454364680,8,15,190,250,7,60
-4.257868211793800,94,95,200,475,1,275
-4.258620501910260,38,40,80,475,2,395
-4.258903656383260,38,40,130,250,2,120
-4.258910730555400,38,40,110,450,2,340
-4.259050078510910,38,40,170,300,2,130
-4.25906376705657,22,25,90,350,3,260
-4.259064428695380,22,25,180,400,3,220
-4.25924550050358,22,25,90,300,3,210
-4.259540922009230,16,20,170,250,4,80
-4.2595670564203400,22,25,60,225,3,165
-4.259862977215420,38,40,60,325,2,265
-4.259937721041250,38,40,170,450,2,280
-4.2601072396503200,16,20,120,275,4,155
-4.260132491417590,16,20,190,400,4,210
-4.260197439085730,22,25,80,350,3,270
-4.260317714471880,16,20,160,225,4,65
-4.260403780949510,22,25,200,400,3,200
-4.260622983710490,68,70,80,100,2,20
-4.260696339743450,16,20,160,450,4,290
-4.260802407400550,22,25,120,400,3,280
-4.261152030655100,38,40,80,275,2,195
-4.261462968931690,38,40,90,300,2,210
-4.261567257387640,38,40,130,425,2,295
-4.262125700380200,22,25,150,350,3,200
-4.262241037767970,38,40,190,425,2,235
-4.262317023971750,22,25,130,400,3,270
-4.262432585880980,22,25,80,225,3,145
-4.262575979074090,38,40,200,300,2,100
-4.262772812686250,22,25,110,450,3,340
-4.262828551507070,82,85,120,125,3,5
-4.263462077646360,38,40,70,475,2,405
-4.263463814236670,38,40,70,425,2,355
-4.2634644089622200,22,25,70,450,3,380
-4.263683055842110,38,40,150,325,2,175
-4.263978203575710,22,25,140,250,3,110
-4.264432268915550,16,20,110,350,4,240
-4.264846408514170,22,25,170,300,3,130
-4.2648727456568200,38,40,150,425,2,275
-4.2650605939312400,38,40,90,225,2,135
-4.265263603146040,16,20,200,375,4,175
-4.265601604497080,22,25,140,275,3,135
-4.265810902578980,38,40,200,350,2,150
-4.2659520894952800,38,40,150,350,2,200
-4.266126933435470,22,25,120,425,3,305
-4.266212832152580,16,20,60,275,4,215
-4.2662849945551400,38,40,120,425,2,305
-4.266419753324270,16,20,80,400,4,320
-4.266488556735340,38,40,180,400,2,220
-4.267091056037300,4,10,120,150,6,30
-4.267285209622000,22,25,130,250,3,120
-4.267813173397990,22,25,190,350,3,160
-4.267964308812110,22,25,90,275,3,185
-4.267980531747070,16,20,110,400,4,290
-4.2680389575736,38,40,150,225,2,75
-4.268052034447050,22,25,80,475,3,395
-4.268156428793530,38,40,60,300,2,240
-4.26816876257454,22,25,130,375,3,245
-4.268213934508040,22,25,120,250,3,130
-4.268368338876770,22,25,150,475,3,325
-4.268672507801630,16,20,60,250,4,190
-4.268948765586420,22,25,200,425,3,225
-4.269021661320780,38,40,90,350,2,260
-4.269138170969440,16,20,140,350,4,210
-4.269268945950100,16,20,110,300,4,190
-4.269347981374860,38,40,190,350,2,160
-4.269495662419210,22,25,70,425,3,355
-4.269646984386980,38,40,50,275,2,225
-4.269994030752570,16,20,90,325,4,235
-4.270262645270440,38,40,80,225,2,145
-4.2703065490260300,98,100,170,175,2,5
-4.270354055958350,38,40,100,250,2,150
-4.270562184140760,16,20,80,300,4,220
-4.270664967947380,16,20,100,375,4,275
-4.270797833029420,38,40,140,275,2,135
-4.271000239269930,38,40,140,400,2,260
-4.271290272770570,94,95,190,500,1,310
-4.271418291697210,48,50,110,150,2,40
-4.271563559037350,38,40,160,300,2,140
-4.271708851631870,22,25,170,450,3,280
-4.271806337776830,38,40,190,375,2,185
-4.271958423571380,22,25,190,400,3,210
-4.271962063523350,22,25,70,275,3,205
-4.27203523440091,88,90,170,175,2,5
-4.272293331827170,22,25,50,300,3,250
-4.272824693675050,22,25,70,350,3,280
-4.272966240121490,16,20,160,275,4,115
-4.273011733706870,22,25,140,450,3,310
-4.273287688868960,38,40,80,375,2,295
-4.273424502280170,22,25,80,275,3,195
-4.273471053890970,16,20,110,225,4,115
-4.273499547446710,22,25,150,450,3,300
-4.273834444319060,38,40,140,475,2,335
-4.2740644729851000,16,20,100,350,4,250
-4.274164361841790,38,40,70,250,2,180
-4.274496639525180,38,40,70,450,2,380
-4.274655263140050,38,40,100,225,2,125
-4.274725838295450,48,50,180,200,2,20
-4.2747389187299500,38,40,70,275,2,205
-4.274785440663200,22,25,80,450,3,370
-4.274850029641040,22,25,180,375,3,195
-4.274955804190890,38,40,70,350,2,280
-4.2751736226207400,94,95,190,475,1,285
-4.275346030619140,38,40,110,425,2,315
-4.275467182164050,6,15,90,125,9,35
-4.275631154076900,22,25,150,425,3,275
-4.275780346532910,16,20,150,300,4,150
-4.276140601374030,22,25,140,400,3,260
-4.27664236003327,22,25,130,425,3,295
-4.276668037964250,38,40,120,250,2,130
-4.276857848233280,16,20,150,250,4,100
-4.277005776312260,22,25,60,475,3,415
-4.277237922498890,22,25,80,375,3,295
-4.277584189539900,22,25,110,425,3,315
-4.277602322063170,22,25,200,350,3,150
-4.277640975638140,22,25,100,400,3,300
-4.277643508883390,22,25,60,500,3,440
-4.277741917165910,38,40,80,500,2,420
-4.277776783866770,38,40,90,375,2,285
-4.277779099463500,4,10,190,250,6,60
-4.278408584301020,38,40,140,250,2,110
-4.278561571205690,94,95,180,500,1,320
-4.279252189254220,38,40,100,400,2,300
-4.27951270407883,16,20,110,375,4,265
-4.279784783416840,22,25,80,500,3,420
-4.279854419067130,22,25,150,325,3,175
-4.280108535150490,4,10,120,175,6,55
-4.280136499093380,16,20,110,275,4,165
-4.280194844695240,38,40,90,275,2,185
-4.28039713710219,22,25,140,425,3,285
-4.2806468828857300,38,40,140,425,2,285
-4.280705181177730,38,40,60,475,2,415
-4.280760861441490,16,20,80,325,4,245
-4.281276051666340,8,15,100,175,7,75
-4.28130186510696,14,20,70,100,6,30
-4.281543509453150,16,20,120,375,4,255
-4.2817174388268800,38,40,190,400,2,210
-4.281789373429160,22,25,180,350,3,170
-4.281921638737490,22,25,100,275,3,175
-4.281971947535480,38,40,80,350,2,270
-4.282271192586250,38,40,60,450,2,390
-4.282278794329400,38,40,180,300,2,120
-4.28228028810935,38,40,140,225,2,85
-4.282650387073820,22,25,140,225,3,85
-4.282771417850950,38,40,140,375,2,235
-4.282895594097410,38,40,110,250,2,140
-4.283127221080610,22,25,190,425,3,235
-4.283794220155510,20,25,110,125,5,15
-4.28423209137496,38,40,200,325,2,125
-4.284309825390230,8,15,120,175,7,55
-4.284594877858000,22,25,160,375,3,215
-4.285133456275520,38,40,100,375,2,275
-4.2853372979695200,38,40,160,375,2,215
-4.285505840190410,22,25,50,250,3,200
-4.28673450015145,16,20,160,250,4,90
-4.286813838243370,38,40,100,325,2,225
-4.287112588573350,38,40,180,325,2,145
-4.28721246965494,38,40,100,275,2,175
-4.287399788525720,38,40,180,350,2,170
-4.287402453689830,32,35,90,125,3,35
-4.287428663747080,38,40,120,275,2,155
-4.287464510512940,22,25,60,450,3,390
-4.287546228721680,16,20,130,350,4,220
-4.2879348286148100,22,25,190,375,3,185
-4.288363014005680,68,70,110,125,2,15
-4.2886915496257100,38,40,90,425,2,335
-4.289051261917420,4,10,140,175,6,35
-4.289551482331360,38,40,160,450,2,290
-4.289653045363970,38,40,200,375,2,175
-4.290119387563550,38,40,140,350,2,210
-4.290238196796200,16,20,140,300,4,160
-4.290410620559820,16,20,150,275,4,125
-4.290875183901110,6,15,80,125,9,45
-4.291228534184890,22,25,70,200,3,130
-4.291688761963910,38,40,110,400,2,290
-4.291811588885620,38,40,60,500,2,440
-4.291875199691380,22,25,160,450,3,290
-4.291933074628960,22,25,140,350,3,210
-4.291945742476860,38,40,80,400,2,320
-4.292106224428690,78,80,90,100,2,10
-4.292242368868840,22,25,100,325,3,225
-4.292699876416270,22,25,50,325,3,275
-4.293634482067840,32,35,130,150,3,20
-4.293806480087080,6,15,60,100,9,40
-4.293978030336910,16,20,150,200,4,50
-4.294015213972550,38,40,80,425,2,345
-4.294160974052310,38,40,120,350,2,230
-4.294469800627800,22,25,180,325,3,145
-4.294736281015720,22,25,90,375,3,285
-4.294982830960530,22,25,190,325,3,135
-4.295146595040420,22,25,140,375,3,235
-4.295750804676180,22,25,140,475,3,335
-4.296115264113090,22,25,200,375,3,175
-4.296266501997560,22,25,70,325,3,255
-4.296284590741510,22,25,90,425,3,335
-4.296470458909170,38,40,190,325,2,135
-4.296687732973520,16,20,50,175,4,125
-4.296910627075120,38,40,130,350,2,220
-4.297049379108110,38,40,50,325,2,275
-4.297253357359310,22,25,190,300,3,110
-4.297559506178140,16,20,130,275,4,145
-4.297734642080650,38,40,120,375,2,255
-4.297867139423610,38,40,50,300,2,250
-4.297876103948720,16,20,110,325,4,215
-4.2979255368215200,22,25,100,375,3,275
-4.297988206410300,94,95,160,500,1,340
-4.29820864180425,20,25,80,100,5,20
-4.298226565845010,94,95,70,225,1,155
-4.298276721421280,22,25,100,300,3,200
-4.298591680400000,22,25,110,250,3,140
-4.298865662995950,22,25,110,225,3,115
-4.299171141424780,38,40,110,275,2,165
-4.299246348805020,22,25,80,300,3,220
-4.299460763797260,38,40,100,300,2,200
-4.299571439388410,22,25,80,325,3,245
-4.300117171311350,22,25,160,275,3,115
-4.300315695794640,16,20,150,375,4,225
-4.300597453608810,22,25,60,250,3,190
-4.300761275910670,94,95,200,450,1,250
-4.301238570726700,22,25,110,275,3,165
-4.301845536800620,22,25,90,325,3,235
-4.302274233307730,22,25,70,400,3,330
-4.302544350775010,38,40,110,350,2,240
-4.302572410507140,38,40,100,350,2,250
-4.303122841574340,22,25,180,300,3,120
-4.304178500716870,22,25,200,325,3,125
-4.304434654852100,94,95,170,500,1,330
-4.304488026262060,38,40,80,325,2,245
-4.304769839448700,94,95,100,500,1,400
-4.305354341264400,22,25,100,350,3,250
-4.305629757386690,16,20,130,300,4,170
-4.305648405832380,38,40,110,375,2,265
-4.305680111978840,94,95,90,500,1,410
-4.30572554149453,38,40,50,225,2,175
-4.305800289331860,94,95,150,500,1,350
-4.306131706522010,22,25,150,375,3,225
-4.306196041839010,38,40,50,250,2,200
-4.306457448409040,22,25,80,425,3,345
-4.3068140817695400,22,25,170,250,3,80
-4.3069273332700200,22,25,120,350,3,230
-4.3069840109082200,8,15,70,150,7,80
-4.307084428043980,38,40,60,225,2,165
-4.307943471286840,22,25,80,400,3,320
-4.307959766031100,38,40,160,275,2,115
-4.308450086385890,22,25,110,400,3,290
-4.308946404377230,16,20,120,325,4,205
-4.309000969860750,94,95,170,350,1,180
-4.309235685238080,94,95,120,450,1,330
-4.309386249362490,38,40,60,250,2,190
-4.309639163306490,94,95,50,375,1,325
-4.31011971244351,38,40,110,225,2,115
-4.310200460915740,38,40,110,300,2,190
-4.310205895367880,22,25,120,375,3,255
-4.3110196264997800,38,40,170,250,2,80
-4.311045319492310,38,40,70,325,2,255
-4.31109457701794,38,40,70,400,2,330
-4.311211628437260,16,20,180,225,4,45
-4.311711982218400,16,20,50,200,4,150
-4.312242758399090,38,40,190,300,2,110
-4.312296991630330,22,25,70,300,3,230
-4.312349208302310,72,75,120,125,3,5
-4.3128450587084900,38,40,150,300,2,150
-4.313062292000750,38,40,90,325,2,235
-4.313869197612060,22,25,120,275,3,155
-4.314042261481290,38,40,70,200,2,130
-4.314427273705210,22,25,130,350,3,220
-4.31468226722592,94,95,120,500,1,380
-4.315694241274160,94,95,50,500,1,450
-4.315823239041300,22,25,160,225,3,65
-4.315898990835840,22,25,150,250,3,100
-4.316473631537480,4,10,190,200,6,10
-4.3164998209103,94,95,170,400,1,230
-4.316551927302450,94,95,160,350,1,190
-4.316707800363160,94,95,170,475,1,305
-4.317027681518980,94,95,50,400,1,350
-4.317219955537140,42,45,90,100,3,10
-4.317611397569970,22,25,60,275,3,215
-4.317925440206590,38,40,140,300,2,160
-4.318156980639700,94,95,130,500,1,370
-4.318691615614040,22,25,110,350,3,240
-4.318820724808130,22,25,110,375,3,265
-4.318870949990050,94,95,160,425,1,265
-4.319646478026720,38,40,70,300,2,230
-4.31981219841322,94,95,90,475,1,385
-4.319839169323370,94,95,50,475,1,425
-4.320315004635560,94,95,50,350,1,300
-4.320953270439170,94,95,50,425,1,375
-4.321776259835290,94,95,100,450,1,350
-4.321792233001830,22,25,150,300,3,150
-4.322263456145770,94,95,60,375,1,315
-4.322435765464870,94,95,60,425,1,365
-4.322874110892430,94,95,60,350,1,290
-4.3230400368395800,16,20,170,275,4,105
-4.323081083432880,38,40,60,275,2,215
-4.323094361972860,22,25,110,300,3,190
-4.324527013868830,22,25,140,300,3,160
-4.3246189139713300,48,50,150,175,2,25
-4.325060670478580,48,50,60,125,2,65
-4.325597846783470,38,40,150,375,2,225
-4.3257231592917700,22,25,160,250,3,90
-4.325830795837250,94,95,160,475,1,315
-4.325875369142170,94,95,180,475,1,295
-4.325914000629940,94,95,140,500,1,360
-4.326187183654360,16,20,60,200,4,140
-4.326913718569640,94,95,190,450,1,260
-4.327066453364360,16,20,160,200,4,40
-4.327094910192090,38,40,150,250,2,100
-4.327144136246850,48,50,120,150,2,30
-4.327159997405490,46,50,120,125,4,5
-4.327515202702110,94,95,90,250,1,160
-4.328213621730580,38,40,80,300,2,220
-4.328649557858880,94,95,50,450,1,400
-4.328726256782480,8,15,200,250,7,50
-4.330198865504990,38,40,110,325,2,215
-4.330761607764630,94,95,100,475,1,375
-4.3312736711080300,94,95,180,425,1,245
-4.331504283333700,94,95,130,450,1,320
-4.332169652680370,16,20,140,325,4,185
-4.332190825707910,38,40,160,225,2,65
-4.332592914647050,16,20,180,275,4,95
-4.333182672945380,38,40,150,275,2,125
-4.333195356161090,16,20,110,200,4,90
-4.333650408004210,16,20,120,300,4,180
-4.333724162802130,94,95,130,475,1,345
-4.334290480945810,94,95,80,250,1,170
-4.33457555387435,38,40,160,250,2,90
-4.334750128724880,94,95,160,400,1,240
-4.335351295395350,94,95,200,425,1,225
-4.335948749194650,16,20,90,200,4,110
-4.33661247497246,94,95,120,475,1,355
-4.3369627767542000,22,25,110,325,3,215
-4.337882377086410,94,95,110,500,1,390
-4.338095638708790,4,10,110,150,6,40
-4.338353781642070,94,95,170,425,1,255
-4.338473952965630,48,50,70,125,2,55
-4.338489979062810,22,25,170,225,3,55
-4.338694009754850,22,25,150,200,3,50
-4.338752126073170,94,95,130,225,1,95
-4.339088842926800,94,95,180,450,1,270
-4.339107070385060,32,35,60,100,3,40
-4.339243358043000,94,95,170,375,1,205
-4.339954893158410,94,95,170,325,1,155
-4.339985232346640,16,20,100,200,4,100
-4.340076668064040,94,95,70,500,1,430
-4.340378982642480,22,25,150,275,3,125
-4.340799209408770,16,20,180,250,4,70
-4.340903775736560,38,40,130,300,2,170
-4.34092699415417,94,95,60,325,1,265
-4.3415851759620000,8,15,50,125,7,75
-4.341861837251390,8,15,140,175,7,35
-4.34217001703168,94,95,60,400,1,340
-4.342339531314940,32,35,190,200,3,10
-4.342772169626240,8,15,200,225,7,25
-4.343589576180090,94,95,140,450,1,310
-4.34359863866604,94,95,200,400,1,200
-4.343701787843640,94,95,130,400,1,270
-4.343987028662430,94,95,70,450,1,380
-4.344053957901330,94,95,160,325,1,165
-4.344061139859860,38,40,130,275,2,145
-4.344168506043750,16,20,130,325,4,195
-4.344315531519910,94,95,110,450,1,340
-4.344712356365920,16,20,80,200,4,120
-4.345043901591030,94,95,130,425,1,295
-4.345576163446650,38,40,140,325,2,185
-4.345813916357180,94,95,110,475,1,365
-4.346375788278740,94,95,150,450,1,300
-4.346941649993920,94,95,150,400,1,250
-4.34723390208481,38,40,120,325,2,205
-4.347369021262600,94,95,180,375,1,195
-4.348218986723750,94,95,70,375,1,305
-4.3486811012597700,94,95,100,425,1,325
-4.348899526498870,94,95,170,450,1,280
-4.348992564845200,94,95,70,475,1,405
-4.349263526035270,94,95,150,475,1,325
-4.349319548067010,38,40,130,325,2,195
-4.350094227306740,38,40,80,200,2,120
-4.350161932800620,16,20,200,275,4,75
-4.350319553568380,94,95,90,400,1,310
-4.350349077065310,94,95,70,425,1,355
-4.350422213310840,94,95,160,300,1,140
-4.350453647609320,94,95,90,350,1,260
-4.350638832044180,94,95,80,450,1,370
-4.350870822215650,78,80,170,175,2,5
-4.3512768252156400,94,95,170,300,1,130
-4.351463767103950,94,95,140,400,1,260
-4.352043062288590,38,40,170,225,2,55
-4.3532679067206000,94,95,120,225,1,105
-4.353549371313730,8,15,100,150,7,50
-4.354075585956340,38,40,150,200,2,50
-4.3541817853827000,94,95,180,400,1,220
-4.3541842701539,26,30,80,100,4,20
-4.354597183720490,16,20,60,175,4,115
-4.354647893146100,94,95,190,350,1,160
-4.354736748447830,22,25,130,275,3,145
-4.3557696948670000,94,95,50,275,1,225
-4.355825828698790,8,15,180,200,7,20
-4.356101637539680,22,25,170,275,3,105
-4.356631006785120,26,30,110,125,4,15
-4.356844807214210,94,95,60,500,1,440
-4.356918843706300,16,20,190,275,4,85
-4.357037033556280,22,25,120,325,3,205
-4.357303075669770,94,95,90,450,1,360
-4.358936118004560,94,95,70,250,1,180
-4.359080524280260,94,95,120,400,1,280
-4.359395105984850,22,25,110,200,3,90
-4.359755662831650,94,95,190,425,1,235
-4.359934619330350,94,95,60,300,1,240
-4.360012904307490,94,95,190,375,1,185
-4.360617710281750,94,95,70,350,1,280
-4.360668009727180,68,70,140,150,2,10
-4.361542252685440,94,95,150,325,1,175
-4.36169752593893,22,25,60,200,3,140
-4.3617261832593800,94,95,140,425,1,285
-4.3619616464876000,22,25,140,325,3,185
-4.362211142759230,94,95,200,350,1,150
-4.362832974179960,94,95,200,300,1,100
-4.363118126153920,4,10,130,150,6,20
-4.363589627998900,4,10,80,150,6,70
-4.363887080053420,94,95,160,450,1,290
-4.3640057509966,94,95,130,375,1,245
-4.364227577164740,94,95,160,375,1,215
-4.364424179181880,94,95,80,475,1,395
-4.364548578228880,22,25,130,325,3,195
-4.364810657202230,38,40,170,275,2,105
-4.364948613384800,94,95,150,350,1,200
-4.365212120849440,22,25,130,300,3,170
-4.365322101933890,20,25,140,150,5,10
-4.365483554982110,94,95,80,500,1,420
-4.365529601877180,32,35,100,125,3,25
-4.36643926000288,8,15,80,150,7,70
-4.3664692809757400,94,95,100,400,1,300
-4.3673534996685500,94,95,60,475,1,415
-4.367547319668010,94,95,200,375,1,175
-4.367643010533920,94,95,120,425,1,305
-4.367839245560620,94,95,140,275,1,135
-4.368202598189360,94,95,130,250,1,120
-4.369149303832310,94,95,140,375,1,235
-4.369155806453530,4,10,150,175,6,25
-4.369423144716270,94,95,190,400,1,210
-4.370637820002910,94,95,140,475,1,335
-4.371594531140980,22,25,50,200,3,150
-4.371727117745520,22,25,180,275,3,95
-4.37205991518727,16,20,140,200,4,60
-4.372614653952970,22,25,180,225,3,45
-4.372976774659460,94,95,140,250,1,110
-4.373174221101600,94,95,70,275,1,205
-4.373219534848760,38,40,60,200,2,140
-4.373306479235340,94,95,80,225,1,145
-4.373501701226130,94,95,80,375,1,295
-4.373534756622150,94,95,90,225,1,135
-4.374120871288500,38,40,120,300,2,180
-4.374247305282340,94,95,110,425,1,315
-4.374841693928630,94,95,140,350,1,210
-4.375362131612000,94,95,150,425,1,275
-4.375375368691090,94,95,120,250,1,130
-4.376200687067,38,40,200,275,2,75
-4.376206478683990,22,25,120,300,3,180
-4.376481715541910,16,20,120,200,4,80
-4.3768913328015000,38,40,50,200,2,150
-4.376900825812260,94,95,80,275,1,195
-4.3782178193888000,94,95,80,350,1,270
-4.378397385221740,94,95,90,425,1,335
-4.379201282145760,94,95,180,325,1,145
-4.379231342605260,94,95,60,450,1,390
-4.3793238161959200,22,25,200,275,3,75
-4.380486763418900,38,40,180,275,2,95
-4.38060671166133,58,60,80,100,2,20
-4.38078162108478,22,25,80,200,3,120
-4.381122892793490,94,95,110,250,1,140
-4.382013004700450,94,95,200,325,1,125
-4.382053571758240,94,95,120,275,1,155
-4.38245717564234,94,95,120,350,1,230
-4.382728104631540,94,95,180,350,1,170
-4.383252920408300,94,95,90,375,1,285
-4.3834140737933200,94,95,70,400,1,330
-4.383919526536560,94,95,150,225,1,75
-4.383989870142700,48,50,50,100,2,50
-4.384175331151360,38,40,180,225,2,45
-4.384389689947730,94,95,80,425,1,345
-4.384473945378820,94,95,100,225,1,125
-4.384716486861570,38,40,160,200,2,40
-4.385041652301510,16,20,70,175,4,105
-4.385054191291160,38,40,180,250,2,70
-4.385226200476700,94,95,100,275,1,175
-4.385312663271680,58,60,110,125,2,15
-4.38553070357448,94,95,180,300,1,120
-4.385605458288230,94,95,160,275,1,115
-4.386422665838550,94,95,140,225,1,85
-4.386495990700060,94,95,100,250,1,150
-4.386924640641520,94,95,90,300,1,210
-4.387129552188810,94,95,70,300,1,230
-4.387937481068130,94,95,190,325,1,135
-4.387975403011710,94,95,60,275,1,215
-4.3879891912411400,22,25,180,250,3,70
-4.38824561936529,94,95,110,400,1,290
-4.388769735768620,94,95,50,300,1,250
-4.388978654874230,22,25,60,175,3,115
-4.390276771482940,16,20,130,200,4,70
-4.390460996814820,16,20,170,200,4,30
-4.392040826296490,94,95,120,375,1,255
-4.39244666756583,94,95,150,375,1,225
-4.3925077630031400,16,20,110,175,4,65
-4.392645678283850,38,40,90,200,2,110
-4.392942037151100,94,95,150,300,1,150
-4.392962037978770,30,35,120,125,5,5
-4.392977077446780,4,10,200,250,6,50
-4.393293851959390,94,95,90,275,1,185
-4.3933449069087100,94,95,50,225,1,175
-4.393756571438730,38,40,110,200,2,90
-4.394669284797860,94,95,100,300,1,200
-4.394809807272760,8,15,90,150,7,60
-4.395011501063700,94,95,50,250,1,200
-4.3950986289245100,94,95,60,250,1,190
-4.396136266173700,94,95,50,325,1,275
-4.39630176635016,94,95,100,350,1,250
-4.396875383388710,94,95,100,375,1,275
-4.396900568646900,94,95,110,350,1,240
-4.397549617683850,6,15,70,100,9,30
-4.3981859372642900,22,25,100,200,3,100
-4.398471988938330,94,95,100,325,1,225
-4.398609092924390,94,95,80,400,1,320
-4.398646272717640,94,95,70,200,1,130
-4.399142633018470,62,65,120,125,3,5
-4.399374423152000,6,15,100,125,9,25
-4.399521791078420,8,15,110,150,7,40
-4.399739977928500,22,25,50,175,3,125
-4.40114593443946,94,95,190,300,1,110
-4.402268911190410,94,95,70,325,1,255
-4.402911402918700,94,95,80,325,1,245
-4.403197385370800,94,95,170,250,1,80
-4.404679997116120,22,25,90,200,3,110
-4.404688698197100,38,40,190,275,2,85
-4.4047789728571600,94,95,110,375,1,265
-4.405451162242480,32,35,70,100,3,30
-4.405578086946630,22,25,190,275,3,85
-4.4068850603120300,22,25,70,175,3,105
-4.407320272340150,16,20,80,175,4,95
-4.40739017374413,38,40,120,200,2,80
-4.4075126122780400,4,10,90,150,6,60
-4.407766017630920,94,95,130,350,1,220
-4.407981597454790,22,25,130,200,3,70
-4.408230080834960,22,25,160,200,3,40
-4.409337978433120,94,95,60,225,1,165
-4.40934233446609,94,95,110,225,1,115
-4.409602752020710,14,20,80,100,6,20
-4.4105546634540000,94,95,90,325,1,235
-4.411175004939220,48,50,80,125,2,45
-4.411466100701290,38,40,130,200,2,70
-4.412111893525380,38,40,140,200,2,60
-4.412354157934500,94,95,140,300,1,160
-4.412543226239420,94,95,150,250,1,100
-4.413240076920310,38,40,100,200,2,100
-4.413432669549520,38,40,50,175,2,125
-4.414070488377720,42,45,170,175,3,5
-4.414994712264610,94,95,110,275,1,165
-4.415650486630600,8,15,130,175,7,45
-4.415870869154860,22,25,120,200,3,80
-4.415947561197780,16,20,50,150,4,100
-4.416616474601020,94,95,120,325,1,205
-4.420724706561240,48,50,160,175,2,15
-4.421299004837170,94,95,150,275,1,125
-4.4236746364838300,22,25,140,200,3,60
-4.424396338682060,94,95,110,300,1,190
-4.426974518364910,94,95,80,300,1,220
-4.427304687757610,94,95,130,275,1,145
-4.427759309902240,14,20,110,125,6,15
-4.429186609049860,8,15,120,150,7,30
-4.429867778223050,94,95,160,250,1,90
-4.430356434057810,16,20,90,175,4,85
-4.43157080835984,94,95,110,325,1,215
-4.4320585255522900,94,95,130,300,1,170
-4.433931564737200,38,40,70,175,2,105
-4.434273503189180,94,95,160,225,1,65
-4.435691479700110,38,40,60,175,2,115
-4.436285099655410,10,15,50,375,5,325
-4.437046235443890,10,15,200,500,5,300
-4.438540500881350,16,20,190,225,4,35
-4.439148449566550,94,95,180,275,1,95
-4.43936786878489,94,95,170,275,1,105
-4.4402661046574900,94,95,140,325,1,185
-4.4409386482359800,38,40,110,175,2,65
-4.441995689182880,94,95,150,200,1,50
-4.442500231704770,94,95,50,200,1,150
-4.443522708334150,68,70,90,100,2,10
-4.4447906364397900,10,15,50,350,5,300
-4.446176331469400,48,50,90,125,2,35
-4.448882144624050,22,25,110,175,3,65
-4.449899670271040,16,20,60,150,4,90
-4.449984416410480,20,25,90,100,5,10
-4.449995387993380,10,15,200,475,5,275
-4.450789351665790,94,95,130,325,1,195
-4.451880661672080,26,30,140,150,4,10
-4.452265162551460,38,40,90,175,2,85
-4.4532620656734600,22,25,170,200,3,30
-4.454300404678080,10,15,190,475,5,285
-4.455086003276730,94,95,80,200,1,120
-4.455249537679220,94,95,170,225,1,55
-4.455398402217960,38,40,80,175,2,95
-4.456110720769020,16,20,190,250,4,60
-4.456651838210010,10,15,70,225,5,155
-4.458108529741850,94,95,120,300,1,180
-4.458733315634300,94,95,200,275,1,75
-4.458870609287940,4,10,170,175,6,5
-4.459143890967890,24,30,120,125,6,5
-4.459721445623690,10,15,80,250,5,170
-4.459760200347080,48,50,190,200,2,10
-4.459778270538530,58,60,140,150,2,10
-4.460487720878450,94,95,50,175,1,125
-4.461261785107220,8,15,160,175,7,15
-4.462094735537510,10,15,190,500,5,310
-4.462614201249900,10,15,90,250,5,160
-4.463141771254190,22,25,80,175,3,95
-4.463527605973330,94,95,110,200,1,90
-4.464935302838740,8,15,50,100,7,50
-4.46532839765218,38,40,190,250,2,60
-4.465715606282710,16,20,100,175,4,75
-4.46587633786137,10,15,50,425,5,375
-4.466796956103850,48,50,130,150,2,20
-4.467943840429940,8,15,150,175,7,25
-4.468713616730030,48,50,60,100,2,40
-4.470638645072680,94,95,60,200,1,140
-4.470678714827820,18,25,120,125,7,5
-4.471846673126440,22,25,190,250,3,60
-4.472913604527620,20,25,170,175,5,5
-4.473985161120060,4,10,130,175,6,45
-4.474857833498710,38,40,170,200,2,30
-4.4755789565320300,22,25,90,175,3,85
-4.476531436907140,10,15,180,500,5,320
-4.476632708928110,10,15,60,325,5,265
-4.477163920251670,14,20,140,150,6,10
-4.477818449545020,10,15,50,275,5,225
-4.477989056350750,10,15,100,500,5,400
-4.478013405899450,16,20,120,175,4,55
-4.478060134229460,38,40,100,175,2,75
-4.478157645147860,94,95,180,250,1,70
-4.479440227417690,10,15,50,400,5,350
-4.479684713776440,38,40,190,225,2,35
-4.480111380809890,94,95,190,275,1,85
-4.480179835180280,10,15,60,375,5,315
-4.481878198718840,10,15,130,225,5,95
-4.482572324765210,10,15,120,225,5,105
-4.485440252383170,10,15,170,350,5,180
-4.485922652807750,94,95,60,175,1,115
-4.486354443085820,10,15,50,450,5,400
-4.487461877064560,22,25,50,150,3,100
-4.48782364104863,6,15,110,125,9,15
-4.4886685672883400,10,15,120,450,5,330
-4.489202692528610,10,15,60,400,5,340
-4.489723133557010,94,95,70,175,1,105
-4.490379084526030,26,30,90,100,4,10
-4.490765401456250,38,40,50,150,2,100
-4.491042371330850,16,20,200,250,4,50
-4.491140535257560,94,95,90,200,1,110
-4.492053723220000,10,15,70,250,5,180
-4.492363834485330,10,15,60,350,5,290
-4.494753427881950,8,15,60,125,7,65
-4.497892818344220,94,95,120,200,1,80
-4.498227457156370,94,95,180,225,1,45
-4.498650634435470,94,95,100,200,1,100
-4.499888462881650,10,15,160,500,5,340
-4.501019009753350,10,15,200,450,5,250
-4.501285869181960,10,15,90,475,5,385
-4.501509621574980,84,85,200,500,1,300
-4.502501394688710,4,10,70,125,6,55
-4.503197386271320,10,15,100,450,5,350
-4.503497351380850,68,70,170,175,2,5
-4.503590957510110,10,15,150,225,5,75
-4.503912972673180,10,15,90,500,5,410
-4.504437867080820,94,95,130,200,1,70
-4.505129346657470,38,40,200,250,2,50
-4.5056174567549700,10,15,90,225,5,135
-4.5058718313381000,22,25,100,175,3,75
-4.507788072596500,10,15,70,500,5,430
-4.508109106714960,10,15,170,400,5,230
-4.508651146208740,10,15,50,500,5,450
-4.50913540835428,22,25,190,225,3,35
-4.50972505231891,58,60,90,100,2,10
-4.510863751443300,10,15,60,425,5,365
-4.511381165742760,8,15,70,125,7,55
-4.512290126276660,38,40,120,175,2,55
-4.513265721094750,22,25,60,150,3,90
-4.513486529953640,4,10,60,125,6,65
-4.515484849722780,10,15,160,350,5,190
-4.516365022354240,38,40,60,150,2,90
-4.516748060027600,10,15,120,500,5,380
-4.517616277958250,16,20,70,150,4,80
-4.51797909697157,10,15,100,475,5,375
-4.518065784079900,4,10,60,100,6,40
-4.518088655627110,10,15,100,425,5,325
-4.518421582996400,10,15,170,325,5,155
-4.519162638516970,6,15,170,175,9,5
-4.519573848965140,10,15,90,350,5,260
-4.520306081716330,10,15,90,300,5,210
-4.521740759034540,16,20,100,150,4,50
-4.5219323789646200,10,15,60,300,5,240
-4.522137541367350,10,15,140,225,5,85
-4.523001755981350,84,85,200,475,1,275
-4.523106726064210,94,95,160,200,1,40
-4.523277283010860,10,15,160,425,5,265
-4.52547040684868,10,15,160,325,5,165
-4.525499586840970,84,85,190,500,1,310
-4.526702809965560,74,75,200,500,1,300
-4.526915593048250,10,15,50,475,5,425
-4.527006199233770,10,15,70,375,5,305
-4.528139015777180,10,15,180,475,5,295
-4.528212626273740,16,20,80,150,4,70
-4.528383470490870,10,15,170,500,5,330
-4.528938743606650,8,15,130,150,7,20
-4.5307005925185700,10,15,150,500,5,350
-4.531380061772490,10,15,80,225,5,145
-4.531833657283890,10,15,160,400,5,240
-4.532031062912670,10,15,100,225,5,125
-4.532476314847470,10,15,190,450,5,260
-4.53250238831414,22,25,200,250,3,50
-4.532822788475940,10,15,80,275,5,195
-4.532882841598960,94,95,140,200,1,60
-4.533585940061700,10,15,140,500,5,360
-4.533627986126160,10,15,130,250,5,120
-4.533654244407480,48,50,100,125,2,25
-4.533915399877460,10,15,140,250,5,110
-4.533960873533030,10,15,50,225,5,175
-4.534017300236460,10,15,170,475,5,305
-4.534412930199600,32,35,80,100,3,20
-4.535625492988620,84,85,190,475,1,285
-4.536381667748620,94,95,80,175,1,95
-4.537881049158890,10,15,120,475,5,355
-4.538020427024040,10,15,110,500,5,390
-4.538311367451900,10,15,50,300,5,250
-4.5385532173841,10,15,90,400,5,310
-4.538599341254020,10,15,130,450,5,320
-4.539942891320130,10,15,60,250,5,190
-4.53996672931658,10,15,70,275,5,205
-4.539977164437810,16,20,200,225,4,25
-4.540060144260590,84,85,180,500,1,320
-4.540265851278080,10,15,70,475,5,405
-4.540362086240880,84,85,160,500,1,340
-4.54059328907147,84,85,120,450,1,330
-4.5408439992378000,10,15,130,400,5,270
-4.541248700023770,74,75,190,500,1,310
-4.541475495876250,10,15,140,275,5,135
-4.541483105329620,10,15,60,225,5,165
-4.542524474028330,94,95,60,150,1,90
-4.542561133146220,10,15,170,375,5,205
-4.543577857014550,14,20,90,100,6,10
-4.543747230014020,10,15,170,425,5,255
-4.543807850281110,14,20,170,175,6,5
-4.5438619728222300,94,95,110,175,1,65
-4.544203405398190,10,15,180,425,5,245
-4.545153348859180,26,30,170,175,4,5
-4.545163789417190,10,15,50,325,5,275
-4.545440999000890,10,15,100,250,5,150
-4.545840848336280,10,15,130,500,5,370
-4.5458970991019300,10,15,130,475,5,345
-4.546429926018080,10,15,90,275,5,185
-4.546535335447140,16,20,50,125,4,75
-4.54705475303485,32,35,110,125,3,15
-4.547188030044030,10,15,70,425,5,355
-4.547250155095840,74,75,200,475,1,275
-4.547743228750040,10,15,70,450,5,380
-4.548217263731820,22,25,120,175,3,55
-4.548652826757270,10,15,50,250,5,200
-4.549096773153970,84,85,200,450,1,250
-4.54933976403743,10,15,80,450,5,370
-4.54958894791337,10,15,200,400,5,200
-4.549823563606170,10,15,140,400,5,260
-4.550040033790430,94,95,90,175,1,85
-4.550090529558830,10,15,120,250,5,130
-4.55031502354911,10,15,160,300,5,140
-4.550520768931950,16,20,140,175,4,35
-4.550665971446480,10,15,170,300,5,130
-4.551209390603000,10,15,160,475,5,315
-4.551211110708750,10,15,70,350,5,280
-4.5515540214612400,10,15,90,450,5,360
-4.551744333711080,36,40,120,125,4,5
-4.551975899908550,10,15,110,475,5,365
-4.552020795089270,94,95,190,250,1,60
-4.552034206750390,84,85,170,500,1,330
-4.553203003119460,94,95,50,150,1,100
-4.5538501429081000,10,15,150,425,5,275
-4.554625774510790,84,85,150,500,1,350
-4.555195909733640,84,85,160,425,1,265
-4.555701723525350,10,15,150,400,5,250
-4.556192638418790,84,85,90,500,1,410
-4.556364223927210,10,15,180,400,5,220
-4.556720000540960,10,15,150,450,5,300
-4.55702998632154,74,75,190,475,1,285
-4.557753795269820,84,85,120,500,1,380
-4.558102038798520,10,15,200,300,5,100
-4.558102816117070,84,85,170,475,1,305
-4.558438342752630,10,15,100,300,5,200
-4.558770492337850,10,15,130,425,5,295
-4.559014652919200,10,15,150,350,5,200
-4.5596060171479600,10,15,120,400,5,280
-4.560654034461550,10,15,140,450,5,310
-4.560684835845120,10,15,90,375,5,285
-4.560753128416650,84,85,160,400,1,240
-4.560877172864290,10,15,70,200,5,130
-4.560963997480410,74,75,180,500,1,320
-4.562167656861390,84,85,90,475,1,385
-4.56242521338334,48,50,70,100,2,30
-4.562898009410350,10,15,60,500,5,440
-4.563079079043560,74,75,160,500,1,340
-4.563204421234900,84,85,180,475,1,295
-4.5634318702316700,74,75,100,500,1,400
-4.563558744515230,74,75,120,450,1,330
-4.563634310036920,10,15,180,300,5,120
-4.564644200356800,84,85,170,350,1,180
-4.564689442506270,10,15,200,425,5,225
-4.565002905241400,10,15,60,475,5,415
-4.565153521118060,10,15,80,475,5,395
-4.565178049839420,84,85,100,500,1,400
-4.565590315945120,84,85,160,475,1,315
-4.565766336288090,84,85,140,500,1,360
-4.566228483308930,74,75,100,450,1,350
-4.567230987563320,10,15,150,475,5,325
-4.568064301484420,16,20,180,200,4,20
-4.5680854776541500,10,15,80,500,5,420
-4.56820174548381,10,15,110,250,5,140
-4.568688221466940,84,85,100,475,1,375
-4.568798716514370,38,40,70,150,2,80
-4.568875197332750,10,15,100,275,5,175
-4.568939013218510,38,40,80,150,2,70
-4.569448852084290,22,25,70,150,3,80
-4.5698696134520500,10,15,80,350,5,270
-4.569961947486830,84,85,130,500,1,370
-4.570241699939980,6,15,80,100,9,20
-4.570388176350690,84,85,110,500,1,390
-4.57058707693615,16,20,90,150,4,60
-4.570724325026120,84,85,100,450,1,350
-4.570895088584760,10,15,180,450,5,270
-4.571355514781750,10,15,130,375,5,245
-4.571543246853590,10,15,150,325,5,175
-4.571584697259180,10,15,90,325,5,235
-4.571804535595200,74,75,150,500,1,350
-4.571979433464010,10,15,80,375,5,295
-4.572033720795710,84,85,50,375,1,325
-4.5720593139649900,74,75,170,500,1,330
-4.572356808991050,84,85,190,450,1,260
-4.572508519312560,10,15,110,450,5,340
-4.572512589757910,10,15,70,325,5,255
-4.572832222762630,8,15,190,200,7,10
-4.572918386675450,84,85,50,425,1,375
-4.573234752330700,10,15,90,425,5,335
-4.573457975696730,10,15,140,425,5,285
-4.573754380140430,10,15,120,425,5,305
-4.57435225828495,10,15,100,325,5,225
-4.574431514020130,10,15,180,375,5,195
-4.57494394194844,10,15,190,425,5,235
-4.575227632012650,10,15,180,350,5,170
-4.575394972391050,10,15,200,325,5,125
-4.5754179656977100,10,15,110,225,5,115
-4.575930961314050,98,100,120,125,2,5
-4.576011794525970,84,85,170,400,1,230
-4.576311075871330,84,85,120,225,1,105
-4.576574219432620,10,15,170,450,5,280
-4.576824286961640,10,15,180,325,5,145
-4.577073830964450,84,85,50,350,1,300
-4.577200067747170,10,15,190,350,5,160
-4.577724560308920,22,25,200,225,3,25
-4.57772615115984,84,85,180,425,1,245
-4.578031678219140,10,15,100,400,5,300
-4.578227826987080,74,75,90,500,1,410
-4.57889048920811,10,15,190,325,5,135
-4.579179582789780,10,15,110,425,5,315
-4.579200717835180,74,75,50,375,1,325
-4.5795179116076200,10,15,70,300,5,230
-4.579547560446390,74,75,50,400,1,350
-4.579769592596610,74,75,180,475,1,295
-4.579844726944580,10,15,160,225,5,65
-4.5798599008974000,74,75,200,450,1,250
-4.5799904090417800,84,85,130,450,1,320
-4.580141295736480,84,85,50,400,1,350
-4.58041801325237,84,85,150,425,1,275
-4.580517306217330,10,15,60,275,5,215
-4.5814850645204100,84,85,130,400,1,270
-4.581525737176330,84,85,120,475,1,355
-4.581923784910870,84,85,160,350,1,190
-4.582383520852720,74,75,100,425,1,325
-4.582459827013680,84,85,170,325,1,155
-4.582547251483630,84,85,90,250,1,160
-4.5829331233073900,74,75,170,400,1,230
-4.583294117675690,94,95,100,175,1,75
-4.583307112538630,10,15,120,275,5,155
-4.583328700121270,74,75,170,350,1,180
-4.583780405879080,84,85,140,400,1,260
-4.58415923783495,84,85,60,325,1,265
-4.584205938405320,74,75,50,425,1,375
-4.5844614994151300,10,15,170,250,5,80
-4.584818422214740,84,85,110,450,1,340
-4.585192118373670,10,15,160,375,5,215
-4.585251024278420,84,85,170,425,1,255
-4.585258217517070,10,15,140,350,5,210
-4.58571574920326,84,85,150,450,1,300
-4.585777456238000,84,85,60,425,1,365
-4.585854094057430,74,75,100,475,1,375
-4.586101194178780,74,75,160,425,1,265
-4.586229146046860,10,15,80,425,5,345
-4.586363859587650,84,85,50,450,1,400
-4.586521011485010,84,85,120,425,1,305
-4.586565824717760,84,85,70,500,1,430
-4.58656856547562,84,85,200,425,1,225
-4.58714198329312,22,25,50,125,3,75
-4.587571843584260,84,85,150,400,1,250
-4.587645357397040,8,15,80,125,7,45
-4.587786575590330,74,75,50,350,1,300
-4.588065566352890,74,75,90,250,1,160
-4.58842046678406,38,40,130,175,2,45
-4.588531131200890,74,75,170,475,1,305
-4.588531946157480,38,40,100,150,2,50
-4.589211075461090,84,85,130,475,1,345
-4.589816139794740,84,85,110,475,1,365
-4.590251967225390,10,15,190,400,5,210
-4.590525766141220,16,20,130,175,4,45
-4.590551177460880,74,75,90,475,1,385
-4.591627886925740,84,85,50,475,1,425
-4.591697973119630,38,40,50,125,2,75
-4.592504804974570,84,85,70,475,1,405
-4.592594622429930,84,85,180,450,1,270
-4.592716145155180,74,75,160,475,1,315
-4.592782576975560,10,15,110,275,5,165
-4.5927884163594900,74,75,190,450,1,260
-4.592995338706070,10,15,190,375,5,185
-4.593109488007540,74,75,130,225,1,95
-4.593169867927120,84,85,170,375,1,205
-4.593221233982740,10,15,140,300,5,160
-4.593249024712470,84,85,60,350,1,290
-4.593382799042580,10,15,60,450,5,390
-4.593402631034000,94,95,190,225,1,35
-4.593625144139300,10,15,70,400,5,330
-4.593898339659610,84,85,190,400,1,210
-4.59391686500443,22,25,80,150,3,70
-4.593954452493230,10,15,160,275,5,115
-4.59405512375481,84,85,50,500,1,450
-4.594271865175540,10,15,140,475,5,335
-4.594494848616630,74,75,140,500,1,360
-4.594779351411810,84,85,90,450,1,360
-4.594910572440190,10,15,80,400,5,320
-4.594938579572410,94,95,70,150,1,80
-4.5952222006009800,74,75,70,225,1,155
-4.595456090061730,84,85,80,250,1,170
-4.595481394881000,84,85,100,425,1,325
-4.595579265135630,84,85,200,400,1,200
-4.595785004081400,74,75,110,500,1,390
-4.595975883010790,84,85,70,225,1,155
-4.5961095156448700,84,85,150,475,1,325
-4.596155565819320,84,85,140,375,1,235
-4.59641403751233,22,25,100,150,3,50
-4.5964190036432100,84,85,170,450,1,280
-4.596439223852400,84,85,130,375,1,245
-4.596683281924820,84,85,60,400,1,340
-4.597334552792030,74,75,50,450,1,400
-4.597370087650120,10,15,140,375,5,235
-4.5977437679641500,10,15,200,375,5,175
-4.597925677473940,74,75,50,500,1,450
-4.598382219471380,74,75,120,500,1,380
-4.598566656725100,84,85,180,375,1,195
-4.598717669094310,74,75,130,500,1,370
-4.598825784263870,10,15,110,350,5,240
-4.598890932166830,10,15,160,450,5,290
-4.598975112354060,94,95,200,250,1,50
-4.598976895154960,84,85,160,325,1,165
-4.599267793261690,94,95,170,200,1,30
-4.599771531442480,10,15,150,250,5,100
-4.60005894575468,84,85,180,400,1,220
-4.600606746191950,10,15,80,325,5,245
-4.600628543609550,84,85,130,425,1,295
-4.600846236384040,10,15,200,350,5,150
-4.601071873715080,84,85,90,400,1,310
-4.601553883306950,84,85,130,250,1,120
-4.6016953190563700,74,75,170,325,1,155
-4.601907741687340,38,40,140,175,2,35
-4.602299379618910,74,75,200,400,1,200
-4.602435508254550,38,40,200,225,2,25
-4.602437428449740,74,75,120,475,1,355
-4.602725901977440,74,75,170,375,1,205
-4.6027348054807200,74,75,80,250,1,170
-4.603064419516930,84,85,140,425,1,285
-4.6033513878857800,84,85,80,475,1,395
-4.603766296674380,74,75,180,425,1,245
-4.604528234454780,84,85,190,350,1,160
-4.604652654415720,84,85,70,375,1,305
-4.605132475473520,74,75,60,375,1,315
-4.605227104887170,74,75,150,400,1,250
-4.605449224637320,10,15,190,300,5,110
-4.605600685612030,74,75,120,425,1,305
-4.605648734950020,84,85,120,400,1,280
-4.606197840079400,74,75,180,450,1,270
-4.606228601949060,16,20,120,150,4,30
-4.606245706023640,84,85,60,375,1,315
-4.606545691272330,74,75,190,425,1,235
-4.606696620849960,74,75,70,500,1,430
-4.606756231637030,84,85,140,450,1,310
-4.606989590579890,74,75,130,400,1,270
-4.607040309918630,84,85,150,325,1,175
-4.60796917478295,74,75,170,450,1,280
-4.608049226864330,84,85,200,300,1,100
-4.608352769616250,84,85,140,475,1,335
-4.608460865309220,38,40,90,150,2,60
-4.608527335080330,74,75,170,425,1,255
-4.608707772832880,16,20,110,150,4,40
-4.60909680313503,74,75,190,400,1,210
-4.609162423213390,74,75,160,350,1,190
-4.609360441905860,84,85,110,425,1,315
-4.609459021988140,74,75,60,325,1,265
-4.609533176783890,84,85,190,425,1,235
-4.609611116920310,74,75,60,350,1,290
-4.609668439614750,10,15,100,375,5,275
-4.609673891876190,84,85,190,375,1,185
-4.609720388367040,74,75,130,450,1,320
-4.61042944581478,74,75,50,475,1,425
-4.6104553008307900,74,75,200,425,1,225
-4.6104831344925900,84,85,130,225,1,95
-4.6104861985685900,84,85,170,300,1,130
-4.610500194227500,74,75,160,300,1,140
-4.610555454742850,74,75,130,475,1,345
-4.610706648779530,74,75,150,475,1,325
-4.610958476987330,58,60,170,175,2,5
-4.6112342003190600,74,75,120,400,1,280
-4.611497346765700,10,15,150,200,5,50
-4.612060374051360,32,35,140,150,3,10
-4.612437503984880,10,15,80,300,5,220
-4.6124393516829600,10,15,60,200,5,140
-4.61258143674338,22,25,90,150,3,60
-4.612678098036200,74,75,140,450,1,310
-4.613275894467720,10,15,120,350,5,230
-4.613292045207340,84,85,150,350,1,200
-4.613344809604830,74,75,70,375,1,305
-4.613587122575390,74,75,160,325,1,165
-4.613801073447780,84,85,80,500,1,420
-4.613978741791860,84,85,60,500,1,440
-4.614398959203040,94,95,80,150,1,70
-4.614454581809470,10,15,110,300,5,190
-4.614501000396950,10,15,110,375,5,265
-4.614542533947260,74,75,90,400,1,310
-4.614568092693180,84,85,180,350,1,170
-4.6145745255858700,10,15,150,375,5,225
-4.614830099195130,84,85,100,225,1,125
-4.614959377434490,10,15,100,350,5,250
-4.615158865975000,6,15,90,100,9,10
-4.615328683234720,74,75,130,250,1,120
-4.615404658368600,10,15,130,350,5,220
-4.6155376729165000,84,85,200,350,1,150
-4.61589967406658,8,15,90,125,7,35
-4.616193126901220,74,75,160,400,1,240
-4.617024392635220,22,25,180,200,3,20
-4.617053779746100,84,85,180,325,1,145
-4.617324599481320,74,75,200,300,1,100
-4.6173444658875600,74,75,60,425,1,365
-4.6174331584226600,84,85,70,450,1,380
-4.617474535031230,94,95,120,175,1,55
-4.617732449446200,74,75,90,350,1,260
-4.618095314523880,74,75,110,475,1,365
-4.618428082327610,22,25,140,175,3,35
-4.6186887758971800,10,15,110,400,5,290
-4.61874045747471,10,15,110,325,5,215
-4.618891455672870,74,75,180,400,1,220
-4.619283321062240,10,15,150,300,5,150
-4.619432876268050,84,85,80,450,1,370
-4.619628758959530,84,85,200,325,1,125
-4.619688236872470,10,15,120,375,5,255
-4.619787910832210,74,75,140,400,1,260
-4.6198215472541300,74,75,130,425,1,295
-4.6198824189013600,84,85,140,250,1,110
-4.619919717959970,74,75,120,225,1,105
-4.619970138338150,10,15,160,250,5,90
-4.620100673941930,84,85,140,350,1,210
-4.621616721937630,84,85,160,450,1,290
-4.621779011459440,84,85,140,275,1,135
-4.622108958204050,84,85,160,300,1,140
-4.622321946824550,74,75,70,475,1,405
-4.6225076778229900,74,75,180,375,1,195
-4.622681828698990,74,75,90,450,1,360
-4.622734177833560,74,75,140,425,1,285
-4.623081606871960,74,75,150,325,1,175
-4.623446827345670,84,85,80,375,1,295
-4.623820510848470,84,85,160,375,1,215
-4.624083718032230,10,15,150,275,5,125
-4.624318205864130,74,75,80,450,1,370
-4.624511340509310,74,75,100,400,1,300
-4.624679220515980,4,10,90,125,6,35
-4.62484850160836,84,85,100,400,1,300
-4.6250662594249000,84,85,200,375,1,175
-4.625390785997370,84,85,70,425,1,355
-4.62548625177805,74,75,150,450,1,300
-4.625740264642270,84,85,80,425,1,345
-4.6261988214632400,84,85,110,250,1,140
-4.6262976792342100,84,85,60,475,1,415
-4.626303732791830,74,75,110,450,1,340
-4.626865051763300,74,75,90,275,1,185
-4.627415750568410,74,75,190,350,1,160
-4.627463458907470,84,85,50,275,1,225
-4.627681221790460,84,85,80,350,1,270
-4.628081721162030,74,75,150,350,1,200
-4.628378752946330,10,15,170,225,5,55
-4.628727908045620,84,85,90,350,1,260
-4.628827677125190,22,25,130,175,3,45
-4.629034627022470,16,20,150,175,4,25
-4.629327207856100,84,85,90,425,1,335
-4.630095547525830,84,85,110,350,1,240
-4.630208852627630,74,75,130,375,1,245
-4.63070706374627,74,75,150,425,1,275
-4.630805284437770,84,85,180,300,1,120
-4.631004600783210,74,75,50,275,1,225
-4.631463123300130,84,85,70,275,1,205
-4.631478641774770,74,75,180,350,1,170
-4.631648811699800,28,30,200,500,2,300
-4.632122840400330,74,75,160,450,1,290
-4.632356842248160,84,85,60,300,1,240
-4.632427313940490,74,75,140,250,1,110
-4.632555684278640,84,85,100,250,1,150
-4.632668844719650,74,75,140,475,1,335
-4.632674124948690,28,30,200,475,2,275
-4.632734506065340,84,85,50,300,1,250
-4.633286761398140,84,85,110,400,1,290
-4.633295891374190,74,75,80,475,1,395
-4.633387859708120,74,75,150,225,1,75
-4.63354640872049,74,75,60,400,1,340
-4.633617738947320,74,75,140,225,1,85
-4.6349347210264800,74,75,100,225,1,125
-4.635186641334930,84,85,90,225,1,135
-4.635375745627550,84,85,190,325,1,135
-4.635792407518380,8,15,60,100,7,40
-4.6358042299183500,6,15,140,150,9,10
-4.6367884802472900,84,85,70,250,1,180
-4.636813796017330,84,85,90,375,1,285
-4.636963322476740,84,85,70,350,1,280
-4.637020499837910,84,85,90,300,1,210
-4.6373022588525200,74,75,70,450,1,380
-4.6373608327637700,74,75,80,225,1,145
-4.6375045601576400,84,85,120,350,1,230
-4.637551046740450,84,85,120,375,1,255
-4.637658192687920,74,75,170,300,1,130
-4.637867924154620,74,75,200,375,1,175
-4.637892904811380,84,85,80,225,1,145
-4.638531723939150,28,30,190,500,2,310
-4.638739424211130,84,85,190,300,1,110
-4.639163415200420,84,85,150,375,1,225
-4.639284998005730,74,75,90,425,1,335
-4.639533700336600,74,75,80,500,1,420
-4.639651432026680,10,15,130,300,5,170
-4.639834131776710,84,85,90,275,1,185
-4.640267751910690,74,75,80,375,1,295
-4.6404498709897200,74,75,60,500,1,440
-4.640557099205020,74,75,180,325,1,145
-4.640802806937320,84,85,80,275,1,195
-4.641128655584780,74,75,60,475,1,415
-4.641178929402430,84,85,130,350,1,220
-4.641411714375880,84,85,140,225,1,85
-4.641428330711110,10,15,50,175,5,125
-4.641923273968460,22,25,110,150,3,40
-4.642111192986700,74,75,80,350,1,270
-4.642146580027750,84,85,120,250,1,130
-4.642168186195170,84,85,120,275,1,155
-4.642212947513480,84,85,80,400,1,320
-4.642718094024050,74,75,120,250,1,130
-4.642785062109900,84,85,110,375,1,265
-4.643068880774290,84,85,60,450,1,390
-4.643082489093670,74,75,60,300,1,240
-4.643611596519960,84,85,150,225,1,75
-4.6437857362310400,84,85,100,350,1,250
-4.643905230688680,84,85,100,275,1,175
-4.644081820948850,74,75,140,275,1,135
-4.644213989769800,74,75,190,375,1,185
-4.644316156320380,74,75,140,375,1,235
-4.644385281328100,84,85,110,275,1,165
-4.644761380902610,84,85,100,325,1,225
-4.645449778098910,74,75,110,400,1,290
-4.645814983003200,74,75,140,350,1,210
-4.645945847666590,74,75,70,425,1,355
-4.645984884268600,84,85,70,400,1,330
-4.64619682921376,84,85,90,325,1,235
-4.64628792738485,84,85,60,250,1,190
-4.646394958479170,74,75,100,250,1,150
-4.64684387393182,74,75,90,225,1,135
-4.647233775765500,74,75,160,375,1,215
-4.647418406134130,74,75,90,300,1,210
-4.648095562090860,74,75,120,375,1,255
-4.648400748304470,74,75,70,250,1,180
-4.649329055747210,74,75,200,350,1,150
-4.649507887238610,74,75,80,275,1,195
-4.6495844205037000,10,15,180,225,5,45
-4.6497837131771500,74,75,60,450,1,390
-4.650269903454800,74,75,90,375,1,285
-4.65077278672859,84,85,110,300,1,190
-4.650973860269400,74,75,80,425,1,345
-4.651070829710840,52,55,120,125,3,5
-4.651772867624460,28,30,180,500,2,320
-4.651785144798000,10,15,160,200,5,40
-4.651918111959140,28,30,190,475,2,285
-4.652114324220710,74,75,100,275,1,175
-4.652180020972560,84,85,60,225,1,165
-4.652208802047560,74,75,50,300,1,250
-4.6522661629138700,84,85,100,375,1,275
-4.652569913354200,10,15,50,200,5,150
-4.652908424853610,74,75,100,350,1,250
-4.653332055520260,38,40,180,200,2,20
-4.653349394805040,74,75,110,425,1,315
-4.653567156222660,74,75,190,325,1,135
-4.6535772520222900,74,75,200,325,1,125
-4.653644299294980,74,75,120,350,1,230
-4.653668714906430,74,75,70,275,1,205
-4.654301035606910,10,15,130,275,5,145
-4.6547449644109000,84,85,50,325,1,275
-4.655425279284720,84,85,150,300,1,150
-4.655958661304070,38,40,110,150,2,40
-4.656130244615970,10,15,80,200,5,120
-4.656174425619340,84,85,70,325,1,255
-4.657145642410710,84,85,160,275,1,115
-4.657207057553190,74,75,150,300,1,150
-4.657221057438800,74,75,120,275,1,155
-4.657361583277950,84,85,70,300,1,230
-4.657971393305850,74,75,70,350,1,280
-4.658213664081650,16,20,50,100,4,50
-4.658459798625530,48,50,110,125,2,15
-4.658504002438870,84,85,50,225,1,175
-4.658988232971370,74,75,80,400,1,320
-4.660189311379420,84,85,100,300,1,200
-4.6610275164507500,84,85,140,325,1,185
-4.6611472868527300,74,75,50,225,1,175
-4.661222715177890,84,85,140,300,1,160
-4.66131154935235,74,75,180,300,1,120
-4.6614318521411300,74,75,100,375,1,275
-4.661820279169150,94,95,50,125,1,75
-4.6624925829229200,74,75,110,375,1,265
-4.66249925861881,22,25,60,125,3,65
-4.662544815457410,84,85,170,250,1,80
-4.663183942885320,74,75,70,400,1,330
-4.663583590083320,74,75,90,325,1,235
-4.6637617524226900,74,75,110,250,1,140
-4.6645124590214300,84,85,50,250,1,200
-4.665340482931620,84,85,70,200,1,130
-4.665618744654420,84,85,80,325,1,245
-4.665822637563980,84,85,150,275,1,125
-4.666677002580000,16,20,60,125,4,65
-4.666695503067840,74,75,140,300,1,160
-4.6667430056590900,88,90,120,125,2,5
-4.6668068652954000,16,20,70,125,4,55
-4.667025477820930,74,75,100,300,1,200
-4.667058243150130,94,95,100,150,1,50
-4.667296054034080,74,75,150,375,1,225
-4.668004333333020,74,75,190,300,1,110
-4.668012547212740,74,75,110,350,1,240
-4.668236814699440,84,85,150,250,1,100
-4.669261920058250,74,75,100,325,1,225
-4.669338086067170,84,85,130,275,1,145
-4.669500436664940,84,85,160,250,1,90
-4.670261297637020,28,30,120,450,2,330
-4.670290009694470,38,40,120,150,2,30
-4.670314886397640,10,15,170,275,5,105
-4.670415600804420,74,75,60,225,1,165
-4.67062530801467,84,85,60,275,1,215
-4.670708861779910,74,75,130,350,1,220
-4.67080242710404,74,75,110,300,1,190
-4.6708112102483,84,85,110,225,1,115
-4.671217145990840,74,75,160,275,1,115
-4.6714462402945000,48,50,80,100,2,20
-4.671582374851000,84,85,110,325,1,215
-4.671748708089010,10,15,180,275,5,95
-4.673205697553600,74,75,60,250,1,190
-4.673771292426290,84,85,120,325,1,205
-4.674115779798200,74,75,70,325,1,255
-4.674350879646370,28,30,70,225,2,155
-4.6743526820615100,10,15,140,325,5,185
-4.674722438132480,84,85,130,300,1,170
-4.675217862174090,84,85,170,275,1,105
-4.675804494232530,10,15,110,200,5,90
-4.676082345908500,28,30,160,500,2,340
-4.676123308959460,10,15,120,325,5,205
-4.676197074577460,94,95,90,150,1,60
-4.676752583761210,94,95,200,225,1,25
-4.677062504413000,28,30,50,375,2,325
-4.6773524338457500,28,30,90,500,2,410
-4.6775044462165300,84,85,80,300,1,220
-4.677810469990960,74,75,110,225,1,115
-4.678115492284580,74,75,130,275,1,145
-4.678236000817950,74,75,50,325,1,275
-4.678548917883400,94,95,130,175,1,45
-4.678628129225040,74,75,110,275,1,165
-4.6789732796418400,10,15,130,325,5,195
-4.679355608148160,10,15,120,300,5,180
-4.679383468876410,28,30,50,425,2,375
-4.679439336095180,32,35,90,100,3,10
-4.680939276766560,74,75,70,300,1,230
-4.6817775741296100,10,15,180,250,5,70
-4.682770847185890,94,95,140,175,1,35
-4.68398920017246,84,85,160,225,1,65
-4.6843540595537800,38,40,70,125,2,55
-4.684600074071030,74,75,80,325,1,245
-4.685932978911860,4,10,80,125,6,45
-4.68621018730802,84,85,130,325,1,195
-4.6862521804337500,16,20,160,175,4,15
-4.686542219465210,22,25,120,150,3,30
-4.686692376185860,28,30,100,450,2,350
-4.68686259901517,28,30,100,500,2,400
-4.686970689576750,28,30,200,450,2,250
-4.687568320207460,28,30,170,400,2,230
-4.687795959669650,28,30,90,250,2,160
-4.687982509454490,84,85,120,300,1,180
-4.68912819081088,74,75,120,325,1,205
-4.689838273867270,74,75,130,300,1,170
-4.689925620689290,74,75,50,250,1,200
-4.69001804184777,28,30,90,475,2,385
-4.690382808496980,74,75,160,225,1,65
-4.690394478139000,74,75,60,275,1,215
-4.690491280337640,10,15,140,200,5,60
-4.6916954572372,28,30,170,350,2,180
-4.693392815208770,10,15,200,275,5,75
-4.693588758243900,28,30,60,325,2,265
-4.69384773162441,74,75,160,250,1,90
-4.694394952587870,74,75,150,250,1,100
-4.6947476909398200,28,30,170,500,2,330
-4.694811642701540,28,30,130,225,2,95
-4.695739221805530,74,75,150,275,1,125
-4.6962082689269600,28,30,50,400,2,350
-4.696985033385400,10,15,70,175,5,105
-4.697336804359550,74,75,70,200,1,130
-4.697383634138170,10,15,60,175,5,115
-4.697529936205990,28,30,170,475,2,305
-4.697660525214350,74,75,170,250,1,80
-4.697718607398590,10,15,130,200,5,70
-4.69790030889235,28,30,150,500,2,350
-4.697934352020790,10,15,170,200,5,30
-4.698149255603170,4,10,70,100,6,30
-4.698411033937530,22,25,70,125,3,55
-4.699196425073750,28,30,160,425,2,265
-4.699216185077400,74,75,170,275,1,105
-4.699236607129480,28,30,50,450,2,400
-4.699331978744300,74,75,130,325,1,195
-4.699425972141510,10,15,120,200,5,80
-4.699505072253360,38,40,150,175,2,25
-4.700971813805570,84,85,180,275,1,95
-4.700973477656830,28,30,50,350,2,300
-4.701087620517100,74,75,140,325,1,185
-4.703385205453870,32,35,170,175,3,5
-4.703817936742510,74,75,80,300,1,220
-4.705439230956140,84,85,170,225,1,55
-4.705645155925800,28,30,110,500,2,390
-4.7057119277975500,8,15,100,125,7,25
-4.705741825024760,28,30,60,350,2,290
-4.705778017240510,28,30,120,500,2,380
-4.7057935310761400,28,30,80,250,2,170
-4.706013921395990,28,30,60,425,2,365
-4.706368428481870,74,75,110,325,1,215
-4.706457085518620,28,30,170,325,2,155
-4.706460625298340,28,30,50,500,2,450
-4.7064992506179900,28,30,100,475,2,375
-4.7068681457032300,28,30,120,225,2,105
-4.707040065198330,28,30,180,475,2,295
-4.707807955298830,10,15,90,200,5,110
-4.707917597615710,28,30,60,375,2,315
-4.708179148539190,28,30,50,475,2,425
-4.708823563408470,10,15,100,200,5,100
-4.709815881026600,28,30,70,375,2,305
-4.71003380178442,28,30,160,400,2,240
-4.710229552109970,8,15,70,100,7,30
-4.711148400413340,10,15,110,175,5,65
-4.711349767297220,28,30,70,500,2,430
-4.712788867160080,84,85,80,200,1,120
-4.713283204454080,28,30,90,350,2,260
-4.713307871573560,84,85,180,225,1,45
-4.713862325457100,28,30,190,450,2,260
-4.7141910595405200,28,30,160,350,2,190
-4.714673084420300,28,30,170,375,2,205
-4.714730212290010,28,30,170,425,2,255
-4.7148382976555200,28,30,130,500,2,370
-4.714854230732020,38,40,60,125,2,65
-4.715311060751230,84,85,60,200,1,140
-4.717145702848530,28,30,110,475,2,365
-4.7179600829142300,84,85,90,200,1,110
-4.718958629636300,28,30,180,425,2,245
-4.719183558279290,28,30,70,475,2,405
-4.719925791954550,28,30,150,225,2,75
-4.720193045096050,94,95,180,200,1,20
-4.720228200703640,28,30,120,475,2,355
-4.7205827003007100,28,30,140,500,2,360
-4.720993019329280,28,30,60,300,2,240
-4.721397990941390,28,30,100,425,2,325
-4.7219713687066900,28,30,60,400,2,340
-4.722279460696180,28,30,100,225,2,125
-4.722412453469440,74,75,120,300,1,180
-4.72250084550448,28,30,80,375,2,295
-4.7233679357450300,28,30,130,475,2,345
-4.724390461513400,74,75,150,200,1,50
-4.724535384874250,28,30,130,450,2,320
-4.72486377706265,74,75,180,275,1,95
-4.724992176858070,74,75,180,250,1,70
-4.725010103938770,74,75,170,225,1,55
-4.725230828622800,28,30,150,350,2,200
-4.725278930376040,28,30,180,450,2,270
-4.725912844181610,84,85,50,200,1,150
-4.726165062526780,28,30,50,275,2,225
-4.72639199213749,28,30,130,250,2,120
-4.726703113430060,84,85,200,275,1,75
-4.728093097239200,84,85,180,250,1,70
-4.72817199512451,28,30,110,450,2,340
-4.728557425900710,22,25,150,175,3,25
-4.728994971248020,74,75,50,200,1,150
-4.72916332248043,10,15,190,275,5,85
-4.729413296408780,74,75,80,200,1,120
-4.729493838158900,28,30,160,325,2,165
-4.729706018783680,28,30,80,475,2,395
-4.729825896220430,84,85,110,200,1,90
-4.729831473015890,84,85,190,275,1,85
-4.730448649335190,28,30,200,400,2,200
-4.730494940778220,28,30,130,425,2,295
-4.730541590661680,74,75,50,175,1,125
-4.730727814838250,28,30,80,450,2,370
-4.730821439052020,28,30,160,300,2,140
-4.730983938880390,28,30,170,300,2,130
-4.731023667145400,28,30,150,475,2,325
-4.731208553137140,28,30,90,400,2,310
-4.731849357086280,28,30,150,400,2,250
-4.732839081109050,28,30,100,400,2,300
-4.73301832900129,28,30,130,400,2,270
-4.7331636791066700,28,30,160,475,2,315
-4.733389833989630,12,20,120,125,8,5
-4.733768392338780,22,25,50,100,3,50
-4.735067872429480,28,30,170,450,2,280
-4.735885578786530,28,30,120,400,2,280
-4.73630516081466,28,30,140,450,2,310
-4.7363489242415,74,75,180,225,1,45
-4.736366696800990,94,95,110,150,1,40
-4.736577516606790,28,30,200,300,2,100
-4.737133560955630,28,30,130,375,2,245
-4.73723516793369,94,95,60,125,1,65
-4.737329506657180,28,30,80,350,2,270
-4.737567805146410,28,30,120,425,2,305
-4.737714356285740,28,30,100,275,2,175
-4.7385304898677500,28,30,140,275,2,135
-4.738661193466720,74,75,200,275,1,75
-4.738864930204780,28,30,90,225,2,135
-4.738929251149610,84,85,100,200,1,100
-4.739982718501960,28,30,60,500,2,440
-4.740370315158360,84,85,150,200,1,50
-4.740824106595280,28,30,200,350,2,150
-4.740845072693380,28,30,150,450,2,300
-4.741036814045830,74,75,60,200,1,140
-4.742164299172320,16,20,90,125,4,35
-4.7422788573552900,28,30,70,450,2,380
-4.743551044933440,28,30,90,375,2,285
-4.743721912872560,28,30,140,225,2,85
-4.743778903097960,28,30,70,425,2,355
-4.744043910557290,28,30,200,425,2,225
-4.744045258832430,28,30,90,450,2,360
-4.744253998874140,28,30,200,325,2,125
-4.744337233775830,10,15,50,150,5,100
-4.74456104004121,28,30,70,275,2,205
-4.744598591649620,84,85,130,200,1,70
-4.745068666070480,28,30,190,425,2,235
-4.745080703551430,28,30,100,250,2,150
-4.7457141129699900,28,30,190,350,2,160
-4.746504870170980,28,30,140,250,2,110
-4.74662087396255,28,30,150,425,2,275
-4.746844356302300,28,30,110,425,2,315
-4.747040576239240,28,30,80,500,2,420
-4.747519684254690,28,30,80,225,2,145
-4.748037895171190,28,30,180,375,2,195
-4.748645307633200,74,75,110,200,1,90
-4.748916100711440,28,30,140,400,2,260
-4.750194620657170,28,30,90,275,2,185
-4.750886156878580,84,85,50,175,1,125
-4.751066449784520,28,30,110,250,2,140
-4.751477654154670,74,75,90,200,1,110
-4.751926630834570,28,30,150,325,2,175
-4.752046956448640,28,30,70,250,2,180
-4.752343171458490,16,20,130,150,4,20
-4.752733150171060,28,30,120,250,2,130
-4.752949669164370,22,25,160,175,3,15
-4.753019448598740,28,30,180,400,2,220
-4.753180140401760,28,30,50,300,2,250
-4.754154883002910,28,30,160,375,2,215
-4.754683251687300,28,30,190,325,2,135
-4.755185084064340,28,30,60,475,2,415
-4.756310157759050,28,30,190,400,2,210
-4.756520196022570,38,40,50,100,2,50
-4.756710749247180,28,30,90,325,2,235
-4.757009672563800,10,15,80,175,5,95
-4.757713833637900,28,30,180,350,2,170
-4.758910015241710,48,50,140,150,2,10
-4.759118087286140,28,30,190,375,2,185
-4.759278335551000,84,85,120,200,1,80
-4.759338741392090,4,10,100,125,6,25
-4.759386553765580,10,15,90,175,5,85
-4.75993833338209,28,30,140,425,2,285
-4.759947858318590,28,30,70,325,2,255
-4.760129509947710,28,30,60,250,2,190
-4.761346481546360,16,20,80,125,4,45
-4.761471443047190,28,30,80,275,2,195
-4.761883608670530,28,30,50,325,2,275
-4.761986748676570,94,95,70,125,1,55
-4.763244548939400,28,30,140,350,2,210
-4.763459973092110,28,30,90,300,2,210
-4.763848371905600,28,30,90,425,2,335
-4.763866511564800,28,30,110,225,2,115
-4.76450937876903,28,30,80,425,2,345
-4.7647080216122600,38,40,80,125,2,45
-4.764870656312380,74,75,100,200,1,100
-4.764981450929490,28,30,160,450,2,290
-4.765462002565800,28,30,60,225,2,165
-4.765526527189830,84,85,60,175,1,115
-4.7662183574194400,28,30,60,450,2,390
-4.766290845713050,28,30,140,375,2,235
-4.766505265921470,94,95,120,150,1,30
-4.767138342785220,28,30,70,350,2,280
-4.767449580693190,74,75,190,275,1,85
-4.767955776671830,28,30,110,350,2,240
-4.7698163144368500,28,30,100,325,2,225
-4.770119403375380,10,15,190,250,5,60
-4.770265664791520,28,30,80,400,2,320
-4.77113085641335,28,30,100,300,2,200
-4.77254981057683,28,30,70,200,2,130
-4.773272993774500,28,30,140,475,2,335
-4.7732829855589900,28,30,50,225,2,175
-4.775109333175780,28,30,200,375,2,175
-4.77534871157765,74,75,120,200,1,80
-4.775558072117820,84,85,110,175,1,65
-4.775901908123070,84,85,160,200,1,40
-4.775914859275710,78,80,120,125,2,5
-4.776648862877520,28,30,180,300,2,120
-4.776963904140980,84,85,70,175,1,105
-4.777872487658090,28,30,120,350,2,230
-4.779875070244340,28,30,130,350,2,220
-4.779948573111110,28,30,70,400,2,330
-4.780064997755520,38,40,160,175,2,15
-4.780809837931840,22,25,130,150,3,20
-4.780851990112020,10,15,190,225,5,35
-4.7812831896389500,74,75,160,200,1,40
-4.781841438727130,74,75,130,200,1,70
-4.782746864141010,28,30,180,325,2,145
-4.782773635123060,28,30,120,275,2,155
-4.783325920659040,28,30,100,350,2,250
-4.783491006912640,28,30,110,400,2,290
-4.783891094662850,28,30,100,375,2,275
-4.7841883752710900,28,30,70,300,2,230
-4.784381303706620,84,85,140,200,1,60
-4.785282826397900,28,30,110,275,2,165
-4.78569450940736,94,95,150,175,1,25
-4.786281790626140,28,30,160,275,2,115
-4.786764780779650,94,95,80,125,1,45
-4.786927597417740,74,75,60,175,1,115
-4.788540131018370,28,30,60,275,2,215
-4.788836292037230,28,30,190,300,2,110
-4.789399878144740,28,30,120,375,2,255
-4.79035636581975,38,40,130,150,2,20
-4.792207788025440,38,40,90,125,2,35
-4.79250297184825,84,85,50,150,1,100
-4.792639107771860,28,30,110,375,2,265
-4.792963947114140,10,15,100,175,5,75
-4.793469836151980,84,85,80,175,1,95
-4.793671901453440,22,25,80,125,3,45
-4.793913233906740,28,30,50,250,2,200
-4.794126456579140,16,20,60,100,4,40
-4.795287656984460,28,30,160,225,2,65
-4.795378001763680,74,75,140,200,1,60
-4.795926836205010,28,30,150,250,2,100
-4.796777616775850,84,85,190,250,1,60
-4.798337778715730,28,30,150,300,2,150
-4.7995245174150800,74,75,50,150,1,100
-4.799548779229370,84,85,60,150,1,90
-4.7997936305866800,28,30,110,300,2,190
-4.800546013796700,84,85,90,175,1,85
-4.80121433057208,10,15,60,150,5,90
-4.801537220783700,84,85,100,175,1,75
-4.801558875406190,28,30,160,250,2,90
-4.802433839873080,28,30,170,225,2,55
-4.802833683546390,28,30,130,275,2,145
-4.803095335583580,28,30,170,250,2,80
-4.803107706239690,74,75,110,175,1,65
-4.803625734374930,84,85,170,200,1,30
-4.806282448998800,28,30,150,375,2,225
-4.807356021621760,28,30,80,325,2,245
-4.807548713442880,16,20,190,200,4,10
-4.8087671169087000,74,75,190,250,1,60
-4.808991605398340,28,30,80,300,2,220
-4.809366723777260,28,30,140,300,2,160
-4.809523137436870,94,95,50,100,1,50
-4.811307408634420,28,30,130,300,2,170
-4.8131308083731,28,30,150,275,2,125
-4.813239605800340,8,15,110,125,7,15
-4.813266764350220,74,75,70,175,1,105
-4.814716039937500,42,45,120,125,3,5
-4.814852447970220,64,65,200,475,1,275
-4.817731161326070,28,30,150,200,2,50
-4.820657594237210,4,10,110,125,6,15
-4.821336276789520,74,75,80,175,1,95
-4.82285698171248,28,30,110,325,2,215
-4.825418514530660,10,15,120,175,5,55
-4.825581392563820,22,25,90,125,3,35
-4.827242761588310,22,25,60,100,3,40
-4.8272752519044700,28,30,130,325,2,195
-4.827391188489090,74,75,90,175,1,85
-4.8274338568826100,28,30,120,325,2,205
-4.828702554794330,22,25,190,200,3,10
-4.8291837723919,64,65,200,500,1,300
-4.833784040791880,10,15,200,250,5,50
-4.834031784095090,28,30,140,325,2,185
-4.835530734609000,28,30,80,200,2,120
-4.83570389536404,84,85,200,250,1,50
-4.8371836185933000,38,40,190,200,2,10
-4.8376893016649900,4,10,90,100,6,10
-4.840463579488030,74,75,190,225,1,35
-4.842003127623880,8,15,80,100,7,20
-4.842214844123250,10,15,70,150,5,80
-4.842484796584930,28,30,60,200,2,140
-4.842644633663920,48,50,90,100,2,10
-4.843360270034260,28,30,120,300,2,180
-4.8433849582574600,28,30,50,200,2,150
-4.8434163678712400,84,85,120,175,1,55
-4.846035736198890,64,65,190,500,1,310
-4.84610523673172,28,30,180,250,2,70
-4.846577725981180,64,65,180,500,1,320
-4.847224469494220,28,30,180,275,2,95
-4.84747348452453,64,65,190,475,1,285
-4.848377197192780,84,85,190,225,1,35
-4.848805882975640,28,30,110,200,2,90
-4.8498111058794,28,30,180,225,2,45
-4.8509222240755400,74,75,170,200,1,30
-4.851735325844700,74,75,60,150,1,90
-4.853485621375300,28,30,160,200,2,40
-4.853576913335940,64,65,100,500,1,400
-4.8537352172903900,28,30,170,275,2,105
-4.853996439452390,74,75,100,175,1,75
-4.854128126978450,94,95,90,125,1,35
-4.856614243433970,64,65,170,400,1,230
-4.856626074255490,38,40,60,100,2,40
-4.856676783305480,28,30,50,175,2,125
-4.858095210742420,16,20,70,100,4,30
-4.8598581449679000,10,15,200,225,5,25
-4.860041838527410,64,65,160,500,1,340
-4.860895737229200,84,85,70,150,1,80
-4.861337300615210,16,20,100,125,4,25
-4.864258550307460,64,65,90,500,1,410
-4.865447605403250,64,65,50,425,1,375
-4.866022037358170,64,65,170,500,1,330
-4.8664394123315100,94,95,90,100,1,10
-4.866788550987360,64,65,90,475,1,385
-4.867133082206500,64,65,120,450,1,330
-4.868831422636750,64,65,170,350,1,180
-4.869792470811990,64,65,100,450,1,350
-4.872000621738450,74,75,120,175,1,55
-4.8729810983302200,74,75,200,250,1,50
-4.874596424148480,28,30,190,275,2,85
-4.875063704060670,28,30,200,275,2,75
-4.875934951617900,28,30,120,200,2,80
-4.8770816789383500,64,65,160,350,1,190
-4.8774862599600100,10,15,50,125,5,75
-4.877796466219960,64,65,160,400,1,240
-4.878858250222500,64,65,130,225,1,95
-4.878907160697850,64,65,200,450,1,250
-4.879706945856430,64,65,50,350,1,300
-4.881051132640440,64,65,190,450,1,260
-4.881456901968020,64,65,50,375,1,325
-4.881465510697920,94,95,160,175,1,15
-4.88165477882135,10,15,100,150,5,50
-4.882254521089750,64,65,170,325,1,155
-4.882261366730080,64,65,90,400,1,310
-4.882412799131120,64,65,50,475,1,425
-4.882625580735910,64,65,150,500,1,350
-4.883516211371020,28,30,70,175,2,105
-4.884050082330730,64,65,90,250,1,160
-4.8842968091295100,64,65,120,225,1,105
-4.885402753807490,64,65,50,450,1,400
-4.886367425083240,64,65,170,375,1,205
-4.886725833639480,64,65,170,475,1,305
-4.887178113142420,28,30,130,200,2,70
-4.887832309033870,28,30,90,200,2,110
-4.888287114369660,64,65,120,425,1,305
-4.8885400227348300,64,65,130,500,1,370
-4.88872114643411,64,65,100,475,1,375
-4.888877312401610,64,65,130,475,1,345
-4.888897959211110,64,65,130,450,1,320
-4.890017241953830,74,75,50,125,1,75
-4.890110095249800,64,65,180,475,1,295
-4.89036768511706,28,30,60,175,2,115
-4.890639291452080,64,65,120,500,1,380
-4.890795254899010,10,15,140,175,5,35
-4.891224383244750,64,65,160,425,1,265
-4.89137450521299,64,65,50,400,1,350
-4.891681127564760,64,65,70,225,1,155
-4.892072937299910,64,65,90,450,1,360
-4.89233357590669,64,65,140,500,1,360
-4.8924400264152100,64,65,110,500,1,390
-4.894408753980900,10,15,80,150,5,70
-4.894843111046140,38,40,100,125,2,25
-4.895178360835250,64,65,140,400,1,260
-4.896033855367230,74,75,80,150,1,70
-4.896131205898000,94,95,130,150,1,20
-4.896860328488070,28,30,100,200,2,100
-4.896995624846630,64,65,160,475,1,315
-4.897209011878400,64,65,50,500,1,450
-4.899697468290030,64,65,160,325,1,165
-4.900208893562650,64,65,60,350,1,290
-4.900609442938780,64,65,100,425,1,325
-4.90117288913339,64,65,60,325,1,265
-4.901778672395190,64,65,60,425,1,365
-4.9022122897027800,28,30,140,200,2,60
-4.902306511054440,64,65,120,400,1,280
-4.902425589574230,64,65,80,250,1,170
-4.9025936489008200,64,65,70,500,1,430
-4.902879258946460,64,65,180,450,1,270
-4.903477204876380,64,65,110,475,1,365
-4.903488323917880,64,65,170,425,1,255
-4.904426032134290,64,65,200,400,1,200
-4.904951544078730,64,65,120,475,1,355
-4.905819644961770,4,10,140,150,6,10
-4.906301525909040,64,65,150,400,1,250
-4.906527900001130,64,65,130,400,1,270
-4.906571180755630,64,65,120,250,1,130
-4.9067231686850600,84,85,80,150,1,70
-4.907318045359770,64,65,180,425,1,245
-4.907496728505550,84,85,100,150,1,50
-4.90757049602893,64,65,70,475,1,405
-4.907752169427770,64,65,150,425,1,275
-4.907926460208890,64,65,160,300,1,140
-4.908170355341790,64,65,130,425,1,295
-4.908175462455440,64,65,60,375,1,315
-4.9095144826760800,74,75,70,150,1,80
-4.909575447262330,74,75,90,150,1,60
-4.90983184026879,10,15,90,150,5,60
-4.910336752176960,84,85,50,125,1,75
-4.911592591658220,10,15,180,200,5,20
-4.912482104076140,64,65,80,450,1,370
-4.913182140044990,64,65,200,300,1,100
-4.9134071365372,64,65,200,425,1,225
-4.913468252173180,64,65,180,375,1,195
-4.914078023943820,22,25,70,100,3,30
-4.914231451000350,64,65,140,250,1,110
-4.915128696172590,64,65,150,350,1,200
-4.91561428011136,10,15,130,175,5,45
-4.916609438421920,22,25,100,125,3,25
-4.916639740306110,64,65,70,450,1,380
-4.917106352873720,64,65,60,400,1,340
-4.91744727990769,64,65,140,375,1,235
-4.918195817882730,64,65,110,425,1,315
-4.9181962877302200,64,65,150,450,1,300
-4.918498661478250,84,85,90,150,1,60
-4.918552954875170,64,65,130,250,1,120
-4.91919666715179,64,65,150,325,1,175
-4.919425160800750,28,30,80,175,2,95
-4.920583081434780,48,50,170,175,2,5
-4.921025001745360,64,65,110,450,1,340
-4.921854782127600,64,65,80,475,1,395
-4.922343408637050,64,65,90,225,1,135
-4.922715774332290,64,65,170,450,1,280
-4.922803998121080,64,65,70,375,1,305
-4.923607012403980,64,65,90,350,1,260
-4.923645803350410,64,65,170,300,1,130
-4.9237761382146500,64,65,70,250,1,180
-4.9239659991464100,64,65,50,275,1,225
-4.924164578672310,64,65,150,475,1,325
-4.924191624283540,20,25,120,125,5,5
-4.924355584613470,64,65,100,225,1,125
-4.924849103742320,94,95,60,100,1,40
-4.925541561929190,64,65,130,375,1,245
-4.926801945700520,64,65,100,250,1,150
-4.927031784380000,64,65,180,400,1,220
-4.927428387235790,64,65,100,400,1,300
-4.92756131942752,64,65,140,450,1,310
-4.927584678844070,64,65,90,375,1,285
-4.928193369852900,64,65,60,500,1,440
-4.928233782208940,38,40,70,100,2,30
-4.92872568960474,64,65,190,425,1,235
-4.929155768433020,64,65,60,475,1,415
-4.929226171034320,64,65,150,225,1,75
-4.929379325162130,64,65,140,275,1,135
-4.9298117176429300,64,65,60,300,1,240
-4.930123142521970,94,95,190,200,1,10
-4.9301243922048200,28,30,170,200,2,30
-4.9303225262141400,64,65,180,325,1,145
-4.931597460653160,64,65,190,350,1,160
-4.931796992921250,64,65,90,425,1,335
-4.931985978229530,8,15,170,175,7,5
-4.932182192871740,64,65,80,225,1,145
-4.93234771032043,64,65,80,500,1,420
-4.933197600064430,8,15,140,150,7,10
-4.93344020131094,64,65,80,275,1,195
-4.9336396254460900,64,65,100,375,1,275
-4.933653832132590,64,65,180,350,1,170
-4.933986046885880,28,30,110,175,2,65
-4.934904426996810,64,65,190,400,1,210
-4.934977655218420,84,85,200,225,1,25
-4.9351653448325500,64,65,90,300,1,210
-4.935375893424590,64,65,140,425,1,285
-4.935709898027140,64,65,70,350,1,280
-4.935794747343860,64,65,70,425,1,355
-4.935863209596470,64,65,160,375,1,215
-4.936033350792480,84,85,140,175,1,35
-4.936629227787440,74,75,100,150,1,50
-4.93727981684227,64,65,140,475,1,335
-4.937842808378500,64,65,180,300,1,120
-4.938328600915730,4,10,80,100,6,20
-4.938497736822350,64,65,110,400,1,290
-4.939220029101800,84,85,130,175,1,45
-4.940181523101480,28,30,190,250,2,60
-4.940230480145390,64,65,200,350,1,150
-4.94032842102502,64,65,100,275,1,175
-4.940947050208930,10,15,110,150,5,40
-4.940992145247280,64,65,80,425,1,345
-4.941156063643770,68,70,120,125,2,5
-4.942786723405480,64,65,90,325,1,235
-4.942866066117900,94,95,100,125,1,25
-4.943028506796310,64,65,80,350,1,270
-4.943101434786320,64,65,120,375,1,255
-4.943195124679080,64,65,190,375,1,185
-4.943237531386320,64,65,60,450,1,390
-4.943517227011090,84,85,60,125,1,65
-4.944101921199300,28,30,50,150,2,100
-4.9451046692733200,64,65,160,450,1,290
-4.945491996855000,64,65,110,250,1,140
-4.947071194610380,64,65,80,375,1,295
-4.947577218818190,64,65,200,325,1,125
-4.947867347956220,64,65,190,325,1,135
-4.94823214987237,26,30,120,125,4,5
-4.948622217546760,64,65,140,350,1,210
-4.948794044300460,64,65,140,225,1,85
-4.949068407530140,64,65,70,275,1,205
-4.9506349941356500,64,65,90,275,1,185
-4.950825623567940,64,65,120,350,1,230
-4.95282709464923,64,65,50,225,1,175
-4.953092793668780,64,65,200,375,1,175
-4.95674175520811,64,65,150,300,1,150
-4.9575196324796300,64,65,70,200,1,130
-4.9580404300011100,84,85,110,150,1,40
-4.958373450509010,74,75,140,175,1,35
-4.959515456004890,64,65,50,325,1,275
-4.959793270557730,64,65,50,300,1,250
-4.959822889702010,64,65,100,325,1,225
-4.960238172921280,74,75,200,225,1,25
-4.960460177469680,64,65,190,300,1,110
-4.96059988925528,64,65,110,275,1,165
-4.960699579324060,64,65,60,225,1,165
-4.9607669599771500,64,65,80,400,1,320
-4.960978825460100,64,65,110,350,1,240
-4.961012051984190,28,30,90,175,2,85
-4.961343861536060,74,75,130,175,1,45
-4.96214305974773,28,30,100,175,2,75
-4.9624793854839900,64,65,70,325,1,255
-4.962515495260640,64,65,120,275,1,155
-4.964111792990870,64,65,100,300,1,200
-4.964250191470950,94,95,70,100,1,30
-4.964841517793460,64,65,110,375,1,265
-4.964955581344140,10,15,120,150,5,30
-4.965415836174040,64,65,160,275,1,115
-4.9669356760341500,64,65,70,300,1,230
-4.967602689858860,64,65,70,400,1,330
-4.968996055350850,64,65,110,225,1,115
-4.969045992669250,28,30,60,150,2,90
-4.969385306265990,64,65,150,375,1,225
-4.971389436883420,64,65,130,350,1,220
-4.971935942468520,64,65,140,300,1,160
-4.972077998511380,10,15,150,175,5,25
-4.972943817091230,28,30,190,225,2,35
-4.9730459878824400,64,65,100,350,1,250
-4.973512441675150,64,65,60,275,1,215
-4.974600451072800,8,15,90,100,7,10
-4.975068744949690,74,75,110,150,1,40
-4.975773312461980,64,65,50,250,1,200
-4.980369627941370,64,65,130,275,1,145
-4.981270613817580,64,65,170,225,1,55
-4.981708594954720,64,65,170,250,1,80
-4.9828877309457900,94,95,80,100,1,20
-4.984943714734110,64,65,80,325,1,245
-4.985230758842500,64,65,160,225,1,65
-4.987755260738600,64,65,60,250,1,190
-4.988112590926510,64,65,110,300,1,190
-4.988732054324880,84,85,150,175,1,25
-4.990760962985680,64,65,120,325,1,205
-4.992021139721760,64,65,80,300,1,220
-4.993290617931560,64,65,150,275,1,125
-4.9942402176012900,64,65,160,250,1,90
-4.995674273314470,10,15,60,125,5,65
-4.997715952813230,84,85,180,200,1,20
-4.999217903804980,74,75,180,200,1,20
-4.999380242852280,28,30,70,150,2,80
-5.000473899976290,64,65,110,325,1,215
-5.000646076412470,64,65,150,250,1,100
-5.0024471535907400,28,30,120,175,2,55
-5.004645084142390,84,85,120,150,1,30
-5.005888618984120,64,65,130,300,1,170
-5.006742598824230,64,65,130,325,1,195
-5.006799830331960,74,75,60,125,1,65
-5.009435024841790,38,40,80,100,2,20
-5.009596537060590,10,15,50,100,5,50
-5.009886733838300,64,65,170,275,1,105
-5.011193519130600,64,65,140,325,1,185
-5.011771878873560,84,85,70,125,1,55
-5.012411584756000,28,30,200,250,2,50
-5.014722625083590,16,20,110,125,4,15
-5.015888430069480,64,65,150,200,1,50
-5.021442668078350,74,75,120,150,1,30
-5.024057438163530,64,65,180,225,1,45
-5.026339168063450,64,65,160,200,1,40
-5.026819561781570,58,60,120,125,2,5
-5.0271026802128500,10,15,160,175,5,15
-5.027906534099960,16,20,80,100,4,20
-5.028342702117630,64,65,80,200,1,120
-5.029012119873570,74,75,50,100,1,50
-5.029472560928400,64,65,200,275,1,75
-5.030132359545700,10,15,70,125,5,55
-5.03234648617206,22,25,110,125,3,15
-5.033667533049570,28,30,80,150,2,70
-5.034105552906960,64,65,60,200,1,140
-5.035250302691710,64,65,120,300,1,180
-5.038674763092700,14,20,120,125,6,5
-5.0395240431508200,28,30,100,150,2,50
-5.039703512040100,64,65,50,200,1,150
-5.042606542781510,38,40,110,125,2,15
-5.043811471222690,64,65,180,250,1,70
-5.045539108203040,64,65,180,275,1,95
-5.047497761283630,74,75,150,175,1,25
-5.053092344171280,64,65,190,275,1,85
-5.057908038529710,64,65,100,200,1,100
-5.060000244785500,64,65,50,175,1,125
-5.061234049862110,64,65,110,200,1,90
-5.062979988805130,84,85,50,100,1,50
-5.064179740036560,74,75,70,125,1,55
-5.0644716835325800,28,30,140,175,2,35
-5.065141519320180,22,25,80,100,3,20
-5.065219645987490,64,65,120,200,1,80
-5.066718388275210,10,15,130,150,5,20
-5.067542617945210,74,75,60,100,1,40
-5.068067069133740,64,65,90,200,1,110
-5.070330081770160,28,30,50,125,2,75
-5.070601251655550,28,30,200,225,2,25
-5.0730348198895900,94,95,110,125,1,15
-5.074146524564490,64,65,70,175,1,105
-5.077276472266070,64,65,60,175,1,115
-5.078798495786960,64,65,140,200,1,60
-5.08273719980112,28,30,90,150,2,60
-5.082894956404460,64,65,130,200,1,70
-5.083488893446620,84,85,80,125,1,45
-5.094127338733790,16,20,140,150,4,10
-5.095111317210070,10,15,90,125,5,35
-5.0966172469211400,84,85,60,100,1,40
-5.09883617987268,84,85,160,175,1,15
-5.099058691845280,28,30,130,175,2,45
-5.099725446475900,64,65,110,175,1,65
-5.103108028765590,10,15,80,125,5,45
-5.10425356329219,84,85,130,150,1,20
-5.105096084511040,84,85,90,125,1,35
-5.106444234016030,10,15,190,200,5,10
-5.10935759666091,28,30,180,200,2,20
-5.110116957104510,28,30,110,150,2,40
-5.110967868794890,74,75,130,150,1,20
-5.112326886669270,22,25,140,150,3,10
-5.118790240145160,74,75,160,175,1,15
-5.119040516839760,64,65,50,150,1,100
-5.119262228808210,84,85,70,100,1,30
-5.120297459981000,64,65,170,200,1,30
-5.120628341476240,64,65,80,175,1,95
-5.121807443595330,74,75,80,125,1,45
-5.123492731722540,64,65,90,175,1,85
-5.123553141028470,38,40,140,150,2,10
-5.126595869214960,10,15,60,100,5,40
-5.133515033510240,6,15,120,125,9,5
-5.1413663424390300,64,65,190,250,1,60
-5.142906229871260,12,15,50,350,3,300
-5.143487984230950,28,30,120,150,2,30
-5.1437227672170200,12,15,200,500,3,300
-5.145251747190500,74,75,90,125,1,35
-5.147056574139540,16,20,90,100,4,10
-5.148292725451400,28,30,150,175,2,25
-5.14850621934198,32,35,120,125,3,5
-5.149443674964980,64,65,100,175,1,75
-5.153936121547740,28,30,60,125,2,65
-5.158638836159140,16,20,170,175,4,5
-5.161989291588880,64,65,200,250,1,50
-5.163105220859890,12,15,200,475,3,275
-5.163457906971750,64,65,120,175,1,55
-5.163997996896520,84,85,190,200,1,10
-5.165534292610370,64,65,190,225,1,35
-5.168434645536320,12,15,50,375,3,325
-5.170987193129080,12,15,130,225,3,95
-5.175731377524790,28,30,70,125,2,55
-5.17655780816629,12,15,70,225,3,155
-5.176924991416880,64,65,70,150,1,80
-5.177637716113270,64,65,60,150,1,90
-5.17767651292981,12,15,190,500,3,310
-5.178326185579140,54,55,190,500,1,310
-5.180076701701200,38,40,90,100,2,10
-5.180875863987500,12,15,80,250,3,170
-5.181260666874150,12,15,50,425,3,375
-5.1815011102207000,54,55,200,500,1,300
-5.1817510781388200,12,15,190,475,3,285
-5.184253809070200,12,15,50,400,3,350
-5.187852039496370,12,15,90,250,3,160
-5.190726426812530,84,85,100,125,1,25
-5.191572706800780,94,95,140,150,1,10
-5.191866277607810,74,75,190,200,1,10
-5.192795469738520,12,15,50,500,3,450
-5.193625432841950,12,15,60,350,3,290
-5.194073367915840,74,75,100,125,1,25
-5.1964208336227700,12,15,180,500,3,320
-5.197624938090790,12,15,60,325,3,265
-5.1979324744350800,12,15,90,500,3,410
-5.197938730032430,12,15,50,275,3,225
-5.199968665142380,12,15,120,225,3,105
-5.2002098772742100,54,55,200,475,1,275
-5.201871231797420,6,10,70,225,4,155
-5.202061624567980,12,15,100,500,3,400
-5.202171337436940,10,15,100,125,5,25
-5.207810325379450,64,65,80,150,1,70
-5.207955935222610,12,15,150,225,3,75
-5.208017978537240,54,55,190,475,1,285
-5.208155914973550,54,55,180,500,1,320
-5.21136865798176,22,25,90,100,3,10
-5.211423267041760,6,10,50,375,4,325
-5.211609999357750,12,15,60,375,3,315
-5.212567195602470,12,15,120,450,3,330
-5.213408976177750,12,15,90,475,3,385
-5.2134978282436,12,15,60,425,3,365
-5.216292902237560,12,15,160,500,3,340
-5.2174674662556100,22,25,170,175,3,5
-5.217784451506240,28,30,50,100,2,50
-5.21883036937707,12,15,50,450,3,400
-5.2194383484354700,12,15,200,450,3,250
-5.219960822478660,12,15,170,400,3,230
-5.220119815153410,6,10,50,350,4,300
-5.2201975151938500,12,15,70,375,3,305
-5.220403939774130,54,55,100,500,1,400
-5.221502049017730,54,55,90,475,1,385
-5.222352265398900,54,55,50,375,1,325
-5.222357221319870,54,55,190,450,1,260
-5.223441598923190,12,15,90,225,3,135
-5.22382015480997,12,15,70,500,3,430
-5.225188973200910,54,55,90,500,1,410
-5.225390407761260,12,15,190,450,3,260
-5.2264469357040700,54,55,160,500,1,340
-5.2270904438508500,54,55,90,250,1,160
-5.227195189198640,12,15,170,500,3,330
-5.227244778965020,12,15,170,350,3,180
-5.227303551142840,6,10,50,275,4,225
-5.227338427024120,12,15,50,475,3,425
-5.227341165995510,64,65,50,125,1,75
-5.227827522615470,12,15,150,500,3,350
-5.229583017082150,54,55,80,250,1,170
-5.229708550592150,12,15,160,425,3,265
-5.2302710568881300,6,10,150,225,4,75
-5.230271896397880,54,55,170,400,1,230
-5.230657593223110,12,15,160,325,3,165
-5.231053667642970,12,15,100,450,3,350
-5.233183657818860,12,15,140,500,3,360
-5.233738810436780,12,15,80,225,3,145
-5.234476300248160,12,15,50,225,3,175
-5.2345617494666800,54,55,160,475,1,315
-5.235861443452910,12,15,70,250,3,180
-5.235899950091620,6,10,130,225,4,95
-5.236118113501690,12,15,90,450,3,360
-5.236606849606560,54,55,120,450,1,330
-5.237432534959010,54,55,150,500,1,350
-5.23760124827987,54,55,170,500,1,330
-5.237899987659950,54,55,50,500,1,450
-5.238643909536010,54,55,170,350,1,180
-5.238887547654010,6,10,60,325,4,265
-5.239089820052160,12,15,180,475,3,295
-5.239283662105850,54,55,200,450,1,250
-5.239347562606530,12,15,60,300,3,240
-5.239812289812740,12,15,170,325,3,155
-5.239954656189750,12,15,50,250,3,200
-5.240328034836240,12,15,100,475,3,375
-5.240647293723720,12,15,100,225,3,125
-5.240947344592620,64,65,90,150,1,60
-5.241204154496430,28,30,90,125,2,35
-5.241722634570080,54,55,120,500,1,380
-5.24227974448101,54,55,130,475,1,345
-5.242283219069460,64,65,200,225,1,25
-5.242854260435620,12,15,130,250,3,120
-5.2428821888692400,12,15,170,425,3,255
-5.244435612358770,12,15,160,400,3,240
-5.245041936855970,64,65,100,150,1,50
-5.245103787680970,54,55,100,450,1,350
-5.245145942420630,12,15,110,500,3,390
-5.245173836613630,54,55,110,500,1,390
-5.245284223495370,54,55,180,475,1,295
-5.245444640638190,12,15,160,350,3,190
-5.24547408656285,10,15,70,100,5,30
-5.245815402557900,12,15,140,225,3,85
-5.246041305080840,54,55,170,475,1,305
-5.246205685216020,6,10,50,400,4,350
-5.2462952933277800,12,15,60,400,3,340
-5.246942645101230,12,15,90,300,3,210
-5.247211678787670,12,15,170,375,3,205
-5.247625771880750,54,55,160,425,1,265
-5.2478298817869600,54,55,50,425,1,375
-5.2483112100833800,54,55,130,500,1,370
-5.248536992883760,28,30,160,175,2,15
-5.248881423695900,54,55,50,350,1,300
-5.248903096964240,74,75,70,100,1,30
-5.248930048314710,6,10,200,500,4,300
-5.249196605057960,12,15,100,250,3,150
-5.249732223859740,12,15,120,500,3,380
-5.250187748946240,54,55,90,350,1,260
-5.250349892711970,54,55,170,375,1,205
-5.2509260057098100,54,55,50,400,1,350
-5.2509292250380800,54,55,100,475,1,375
-5.251144650430230,54,55,70,225,1,155
-5.25148345856781,12,15,80,275,3,195
-5.252059547967550,64,65,140,175,1,35
-5.2522203447365400,12,15,160,300,3,140
-5.2523048157629800,12,15,70,450,3,380
-5.252628923095560,12,15,90,400,3,310
-5.25283292173455,38,40,170,175,2,5
-5.252865329111940,12,15,60,225,3,165
-5.252906599270400,12,15,170,475,3,305
-5.2534477543304800,54,55,70,375,1,305
-5.25412740341399,54,55,140,500,1,360
-5.254146766962760,12,15,200,300,3,100
-5.25502062071158,64,65,130,175,1,45
-5.255566007587700,28,30,80,125,2,45
-5.255574633244520,12,15,180,425,3,245
-5.255834513097350,12,15,90,275,3,185
-5.256442891125540,12,15,70,275,3,205
-5.256546373676180,54,55,160,350,1,190
-5.256634878763070,54,55,130,225,1,95
-5.256810388754340,12,15,170,300,3,130
-5.257008271995950,12,15,100,425,3,325
-5.257130947194670,54,55,120,425,1,305
-5.257215348134370,54,55,70,500,1,430
-5.257328142592940,54,55,60,425,1,365
-5.257559758988210,12,15,120,250,3,130
-5.257740220927510,54,55,100,425,1,325
-5.2579557327663500,12,15,50,300,3,250
-5.258686763047690,84,85,80,100,1,20
-5.258883435356820,12,15,90,350,3,260
-5.259415435980960,54,55,50,450,1,400
-5.259513615079190,12,15,130,400,3,270
-5.259610038511480,54,55,110,475,1,365
-5.26047147187293,54,55,130,400,1,270
-5.260516260095540,54,55,50,475,1,425
-5.260839700920820,12,15,60,275,3,215
-5.260939505672320,54,55,170,325,1,155
-5.261242654093210,6,10,50,225,4,175
-5.261904334317580,12,15,130,450,3,320
-5.262860107567580,54,55,180,400,1,220
-5.263461050682890,12,15,150,350,3,200
-5.263904030940560,6,10,80,250,4,170
-5.264276498596720,54,55,170,425,1,255
-5.264834696267910,54,55,160,325,1,165
-5.264860152590280,6,10,90,250,4,160
-5.2648933361899000,12,15,160,475,3,315
-5.264936101987970,54,55,60,350,1,290
-5.265450975670950,12,15,140,275,3,135
-5.265661856942640,54,55,130,425,1,295
-5.26577169026627,54,55,160,300,1,140
-5.2659509886156100,12,15,180,400,3,220
-5.266200589417890,12,15,80,450,3,370
-5.266421872485180,12,15,100,300,3,200
-5.266908063712170,12,15,120,400,3,280
-5.266942829320830,12,15,120,475,3,355
-5.267373733307600,12,15,140,250,3,110
-5.267374961754450,12,15,110,475,3,365
-5.2676353108935200,54,55,180,425,1,245
-5.268300340462680,54,55,60,325,1,265
-5.268573863450510,54,55,60,375,1,315
-5.2685838969505200,54,55,140,450,1,310
-5.268588475208150,54,55,200,300,1,100
-5.268594241794180,6,10,50,425,4,375
-5.268945614393660,54,55,150,400,1,250
-5.269183012251410,12,15,200,400,3,200
-5.269464416540710,12,15,130,500,3,370
-5.269510768924110,12,15,180,325,3,145
-5.269681309494600,12,15,130,475,3,345
-5.269862295670850,54,55,160,400,1,240
-5.2700998751603100,12,15,60,250,3,190
-5.270805042737400,12,15,70,475,3,405
-5.271473182587570,54,55,120,225,1,105
-5.271848558297730,54,55,120,475,1,355
-5.272910064457080,54,55,120,400,1,280
-5.273339670263960,54,55,150,450,1,300
-5.273660917961910,12,15,110,450,3,340
-5.2738067667373,6,10,120,225,4,105
-5.274136341758720,54,55,180,450,1,270
-5.274445412544140,12,15,80,375,3,295
-5.274503026540460,12,15,70,350,3,280
-5.274514171354900,54,55,200,425,1,225
-5.274758459296610,54,55,150,475,1,325
-5.2751901927976900,12,15,80,500,3,420
-5.275421546969480,12,15,50,325,3,275
-5.2754330867174000,54,55,190,350,1,160
-5.275634238718810,12,15,80,350,3,270
-5.275817266252060,54,55,90,450,1,360
-5.2771344020022200,54,55,110,425,1,315
-5.27720842081054,12,15,140,400,3,260
-5.277347383487170,54,55,130,450,1,320
-5.277721797647650,54,55,110,450,1,340
-5.277988445142970,12,15,70,425,3,355
-5.278284860930380,54,55,200,400,1,200
-5.2786223057679700,12,15,150,450,3,300
-5.278734464631380,12,15,180,450,3,270
-5.278775742429820,54,55,70,425,1,355
-5.278788309131060,64,65,110,150,1,40
-5.2789888198820000,54,55,90,275,1,185
-5.279003833736440,54,55,170,300,1,130
-5.279250326136230,54,55,90,400,1,310
-5.279306056493650,54,55,80,450,1,370
-5.279444666876800,54,55,180,350,1,170
-5.2795296605944900,28,30,130,150,2,20
-5.2796799949533900,54,55,60,400,1,340
-5.279845794746860,54,55,90,225,1,135
-5.280037670139690,54,55,130,375,1,245
-5.280486211072890,12,15,150,325,3,175
-5.280658655720190,54,55,80,500,1,420
-5.28097104585323,12,15,150,400,3,250
-5.281560641338980,54,55,140,400,1,260
-5.28176382919562,6,10,60,375,4,315
-5.281793868386220,54,55,130,250,1,120
-5.281828176650140,12,15,60,475,3,415
-5.281966374671710,6,10,60,350,4,290
-5.2824859771942900,12,15,110,250,3,140
-5.28259632479101,54,55,180,375,1,195
-5.282635761075640,12,15,180,300,3,120
-5.282646436754710,12,15,200,425,3,225
-5.282650130095050,54,55,140,425,1,285
-5.282657632879610,12,15,130,375,3,245
-5.282751950870400,12,15,100,325,3,225
-5.283469903403470,12,15,110,225,3,115
-5.283986248773860,54,55,100,400,1,300
-5.2841071964436300,54,55,70,450,1,380
-5.284220371117790,12,15,200,325,3,125
-5.284313813830950,12,15,70,200,3,130
-5.284393524625980,12,15,170,450,3,280
-5.284440286832400,54,55,100,225,1,125
-5.284635435354120,54,55,190,375,1,185
-5.28511773002171,54,55,70,475,1,405
-5.285617200934550,12,15,60,500,3,440
-5.285638088087680,64,65,50,100,1,50
-5.285966877586190,54,55,170,450,1,280
-5.286137886061660,12,15,70,325,3,255
-5.286157660643300,12,15,160,225,3,65
-5.286396681489730,54,55,140,375,1,235
-5.286619321955890,12,15,140,450,3,310
-5.286664652632180,54,55,80,475,1,395
-5.286954320569510,12,15,80,475,3,395
-5.287185657666320,54,55,80,275,1,195
-5.28731816917016,12,15,140,425,3,285
-5.287361378262320,54,55,160,375,1,215
-5.287880021258150,12,15,150,425,3,275
-5.288423759990500,54,55,190,425,1,235
-5.288730290015200,54,55,90,425,1,335
-5.288754584757890,54,55,140,475,1,335
-5.289016756154710,54,55,140,250,1,110
-5.28924355856188,54,55,90,375,1,285
-5.289337904623040,12,15,90,375,3,285
-5.289361949742490,54,55,110,400,1,290
-5.289530465915460,54,55,200,350,1,150
-5.290034557245050,12,15,120,275,3,155
-5.290395339172760,12,15,180,375,3,195
-5.290437357689410,6,10,60,300,4,240
-5.290447809045110,54,55,80,225,1,145
-5.290525448473440,54,55,80,350,1,270
-5.290853301924630,12,15,190,350,3,160
-5.2908829114233100,12,15,120,425,3,305
-5.290981448204220,12,15,160,375,3,215
-5.291587935247820,54,55,150,350,1,200
-5.29266415867,54,55,150,425,1,275
-5.293008301143460,54,55,70,275,1,205
-5.293203952108660,54,55,190,400,1,210
-5.29374451457667,6,10,200,475,4,275
-5.294081382661200,64,65,120,150,1,30
-5.294315945820750,54,55,80,425,1,345
-5.294620558897530,12,15,190,425,3,235
-5.294728869014260,54,55,150,325,1,175
-5.295276082176450,54,55,60,500,1,440
-5.295326932458560,28,30,190,200,2,10
-5.295594729316870,54,55,50,275,1,225
-5.296704452738800,6,10,70,250,4,180
-5.297000883823090,12,15,70,300,3,230
-5.297366017603730,54,55,190,325,1,135
-5.297379122328230,54,55,140,225,1,85
-5.298349415397000,54,55,200,375,1,175
-5.2985102652991100,12,15,130,425,3,295
-5.2989853872804900,54,55,140,275,1,135
-5.29899749704858,64,65,180,200,1,20
-5.299345389541410,54,55,120,250,1,130
-5.29969558763127,12,15,80,325,3,245
-5.300003899559270,54,55,60,300,1,240
-5.300251207561390,54,55,180,325,1,145
-5.300478310476580,54,55,160,450,1,290
-5.30048571715295,54,55,90,325,1,235
-5.300576402093190,12,15,190,400,3,210
-5.301020505351420,54,55,80,375,1,295
-5.301157270524620,54,55,100,375,1,275
-5.301171678996190,12,15,110,425,3,315
-5.301246625269880,54,55,90,300,1,210
-5.301268224478800,12,15,100,275,3,175
-5.301352015991720,12,15,150,475,3,325
-5.3016889967411700,6,10,140,225,4,85
-5.301804850053340,12,15,190,325,3,135
-5.302020153339710,54,55,60,475,1,415
-5.302710733864440,54,55,150,225,1,75
-5.303228386427360,12,15,100,400,3,300
-5.303840373544350,12,15,110,275,3,165
-5.304768374435100,12,15,60,450,3,390
-5.304885938331170,12,15,180,350,3,170
-5.305076018063050,54,55,180,300,1,120
-5.306082983682490,54,55,70,350,1,280
-5.306362877652440,6,10,190,475,4,285
-5.306366311043040,12,15,150,200,3,50
-5.306736389652240,12,15,70,400,3,330
-5.307051601745880,12,15,90,425,3,335
-5.307468493896750,6,10,90,225,4,135
-5.308185121518880,54,55,80,400,1,320
-5.308316063172530,54,55,100,325,1,225
-5.3085961280478000,54,55,100,250,1,150
-5.3087282912733300,12,15,100,350,3,250
-5.308896773161230,54,55,60,225,1,165
-5.309298073236950,54,55,70,250,1,180
-5.310053444932860,48,50,120,125,2,5
-5.310707448337520,54,55,100,275,1,175
-5.310926904437650,6,10,50,500,4,450
-5.310970113178980,12,15,160,275,3,115
-5.311302343747450,54,55,200,325,1,125
-5.311395007507810,12,15,140,375,3,235
-5.311845399429360,12,15,80,425,3,345
-5.311845670981110,54,55,140,350,1,210
-5.3122721858054200,12,15,90,325,3,235
-5.312362413745530,6,10,190,500,4,310
-5.312771651680710,12,15,200,350,3,150
-5.3129005924113300,54,55,60,450,1,390
-5.314000601719210,12,15,110,300,3,190
-5.315906248452740,54,55,190,300,1,110
-5.316455793735420,54,55,160,225,1,65
-5.317500296007070,54,55,50,225,1,175
-5.317602907809310,54,55,120,350,1,230
-5.318035705845970,54,55,110,225,1,115
-5.318095880888440,54,55,70,400,1,330
-5.318462564906330,12,15,170,225,3,55
-5.318980037400650,6,10,70,200,4,130
-5.319275407793400,12,15,190,300,3,110
-5.319398720505770,6,10,60,425,4,365
-5.319454816173150,54,55,80,325,1,245
-5.3201844631676400,28,30,60,100,2,40
-5.320454031226830,54,55,120,275,1,155
-5.32050584627451,6,10,150,200,4,50
-5.321035188728050,54,55,150,300,1,150
-5.321291761953510,12,15,140,350,3,210
-5.321608404024960,12,15,160,450,3,290
-5.321831809980520,54,55,110,350,1,240
-5.321949721631070,54,55,70,325,1,255
-5.32292174502112,12,15,140,475,3,335
-5.323363191888660,12,15,130,350,3,220
-5.324453320977740,54,55,110,250,1,140
-5.324696369634380,12,15,170,250,3,80
-5.325094297257380,6,10,50,250,4,200
-5.325444335461130,6,10,70,275,4,205
-5.3254908045078100,12,15,120,350,3,230
-5.326386416794820,54,55,120,375,1,255
-5.326541585082610,12,15,80,400,3,320
-5.3266147227968500,54,55,100,350,1,250
-5.326738044255160,12,15,150,300,3,150
-5.326944843774380,12,15,150,250,3,100
-5.326976144303400,12,15,110,350,3,240
-5.327191165646560,12,15,60,200,3,140
-5.327550276936410,54,55,50,300,1,250
-5.327580533560290,54,55,100,300,1,200
-5.327836545609200,54,55,110,275,1,165
-5.328198013607650,10,15,110,125,5,15
-5.328509820160670,12,15,160,200,3,40
-5.328524414518130,6,10,50,450,4,400
-5.328690947829590,54,55,130,350,1,220
-5.330792212082160,12,15,110,400,3,290
-5.331737555096700,12,15,190,375,3,185
-5.331796127651660,54,55,150,375,1,225
-5.332607700128530,12,15,120,375,3,255
-5.332784121116900,12,15,80,300,3,220
-5.332840791179830,54,55,160,275,1,115
-5.333088940067840,6,10,120,450,4,330
-5.3331251633930900,6,10,80,275,4,195
-5.333311046535720,64,65,60,125,1,65
-5.333380053229130,6,10,100,225,4,125
-5.333661620757040,54,55,150,250,1,100
-5.334063037421050,54,55,50,325,1,275
-5.334112842644200,6,10,50,475,4,425
-5.334286818502460,6,10,50,300,4,250
-5.335474955714370,12,15,100,375,3,275
-5.335709742374780,54,55,70,200,1,130
-5.336189341115010,54,55,80,300,1,220
-5.3362716207817900,54,55,140,300,1,160
-5.3369534422360100,12,15,50,200,3,150
-5.337343425881990,54,55,150,275,1,125
-5.3374863394560600,84,85,110,125,1,15
-5.337700658474560,6,10,170,350,4,180
-5.337777385511040,54,55,130,275,1,145
-5.337843852744480,64,65,150,175,1,25
-5.338442153527660,6,10,80,225,4,145
-5.34022617296066,54,55,110,300,1,190
-5.340551356949900,6,10,60,225,4,165
-5.340590943658500,12,15,140,300,3,160
-5.340625010664290,54,55,110,375,1,265
-5.340854266283790,54,55,50,250,1,200
-5.341704779077020,54,55,60,275,1,215
-5.3422969053414800,6,10,170,325,4,155
-5.3425389802034900,12,15,200,375,3,175
-5.34318767316661,12,15,110,375,3,265
-5.34329819000237,12,15,50,175,3,125
-5.3433439627531100,6,10,180,500,4,320
-5.3439897909659900,12,15,180,225,3,45
-5.3447139185299600,54,55,70,300,1,230
-5.345785276931270,54,55,130,300,1,170
-5.345937220800760,64,65,70,125,1,55
-5.346557992328160,6,10,100,500,4,400
-5.346704069215980,6,10,50,325,4,275
-5.3471933048054500,54,55,160,250,1,90
-5.347618448605250,12,15,150,275,3,125
-5.347775796409380,12,15,150,375,3,225
-5.347826169079570,74,75,110,125,1,15
-5.348526627034690,10,15,80,100,5,20
-5.348879448796300,12,15,80,200,3,120
-5.348916726822420,54,55,170,250,1,80
-5.3501897749573900,12,15,130,275,3,145
-5.350214550620750,6,10,170,400,4,230
-5.350335263770230,54,55,60,250,1,190
-5.350551156173640,12,15,110,325,3,215
-5.351206036317120,12,15,160,250,3,90
-5.351530827555280,54,55,140,325,1,185
-5.352161585204710,94,95,170,175,1,5
-5.3538911757431000,54,55,110,325,1,215
-5.354010996251720,74,75,80,100,1,20
-5.354716858154980,6,10,90,475,4,385
-5.355829015542290,6,10,60,250,4,190
-5.3558780027220500,6,10,100,450,4,350
-5.357151452337170,6,10,90,300,4,210
-5.358959666739880,6,10,90,500,4,410
-5.359436894420330,54,55,80,200,1,120
-5.35958173125896,54,55,130,325,1,195
-5.362851062956900,6,10,60,400,4,340
-5.363329402578680,6,10,160,500,4,340
-5.363873790951110,54,55,150,200,1,50
-5.364516459101190,6,10,130,250,4,120
-5.364663197925840,6,10,160,325,4,165
-5.365288666633680,12,15,120,325,3,205
-5.365548892839510,54,55,170,275,1,105
-5.367241723832670,6,10,100,250,4,150
-5.368033967719440,6,10,120,250,4,130
-5.36832043990084,6,10,60,275,4,215
-5.368350296456860,12,15,110,200,3,90
-5.37007549513288,28,30,100,125,2,25
-5.3705741860130900,6,10,70,375,4,305
-5.371250214121400,54,55,180,275,1,95
-5.371398507318980,54,55,120,325,1,205
-5.3716350608084,12,15,140,325,3,185
-5.371842849934860,6,10,160,350,4,190
-5.3723914729855200,54,55,120,300,1,180
-5.373312753431310,6,10,200,450,4,250
-5.37511588598519,12,15,170,275,3,105
-5.375394164676020,6,10,160,300,4,140
-5.3756494179034000,6,10,160,425,4,265
-5.377083911445820,6,10,170,225,4,55
-5.378029935421580,6,10,90,275,4,185
-5.378191197418800,6,10,90,350,4,260
-5.37856720527877,6,10,200,300,4,100
-5.381620750072150,6,10,70,350,4,280
-5.382223416449000,12,15,130,300,3,170
-5.382880247494390,54,55,170,225,1,55
-5.38294976320312,6,10,70,500,4,430
-5.38363651343942,6,10,170,500,4,330
-5.384128435827920,6,10,120,500,4,380
-5.38534766614865,6,10,100,475,4,375
-5.386007064680330,6,10,90,450,4,360
-5.386222340228180,6,10,130,400,4,270
-5.386312845580830,6,10,140,250,4,110
-5.386543600925950,12,15,180,275,3,95
-5.3879952957622500,6,10,70,475,4,405
-5.388185145102570,54,55,190,275,1,85
-5.388281538516340,6,10,150,500,4,350
-5.388926818194060,6,10,160,225,4,65
-5.390992014068530,54,55,110,200,1,90
-5.392041576772350,12,15,130,325,3,195
-5.392596275259080,12,15,60,175,3,115
-5.392993598781450,6,10,150,350,4,200
-5.393428461694380,6,10,90,400,4,310
-5.393442930286430,6,10,170,300,4,130
-5.397880666675540,54,55,60,200,1,140
-5.39811373609124,54,55,50,200,1,150
-5.399490205572400,6,10,80,350,4,270
-5.4023153735390900,12,15,120,300,3,180
-5.402979626683440,54,55,200,275,1,75
-5.403271272370190,6,10,180,475,4,295
-5.403782008368150,6,10,170,475,4,305
-5.404432770269850,54,55,180,225,1,45
-5.404631054517320,12,15,140,200,3,60
-5.404845897011230,54,55,160,200,1,40
-5.405530505208000,54,55,100,200,1,100
-5.407212498639200,64,65,80,125,1,45
-5.407532518378770,6,10,160,200,4,40
-5.409884988845230,6,10,140,275,4,135
-5.410099975118830,12,15,200,275,3,75
-5.410219577237420,54,55,90,200,1,110
-5.410438039973290,54,55,130,200,1,70
-5.410494373091020,6,10,190,450,4,260
-5.410633587090080,6,10,160,400,4,240
-5.411865992565640,6,10,170,375,4,205
-5.413019942755020,6,10,110,500,4,390
-5.413324516205520,28,30,70,100,2,30
-5.414081229141730,12,15,170,200,3,30
-5.416846495614140,54,55,180,250,1,70
-5.4169436505688100,6,10,50,175,4,125
-5.418077048321990,6,10,170,425,4,255
-5.41911678280009,6,10,100,425,4,325
-5.419675007959150,64,65,130,150,1,20
-5.420912173411540,6,10,70,425,4,355
-5.42107198040698,6,10,60,500,4,440
-5.421073137545870,64,65,90,125,1,35
-5.421490109186180,6,10,120,475,4,355
-5.421748808161370,12,15,180,250,3,70
-5.421760962581950,6,10,170,200,4,30
-5.422416602069750,6,10,60,200,4,140
-5.422864592258980,6,10,110,225,4,115
-5.424201568575470,12,15,90,200,3,110
-5.424501429980850,12,15,130,200,3,70
-5.424501493422100,6,10,120,400,4,280
-5.425787995598050,6,10,100,300,4,200
-5.425987463309160,54,55,120,200,1,80
-5.426455964349930,12,15,120,200,3,80
-5.426530633203370,6,10,150,400,4,250
-5.426732677622020,6,10,90,325,4,235
-5.426928065947240,6,10,180,225,4,45
-5.427387272283360,6,10,80,375,4,295
-5.427854271839180,12,15,50,150,3,100
-5.4285723329150000,12,15,100,200,3,100
-5.429825595972920,6,10,50,200,4,150
-5.430472193635130,6,10,70,450,4,380
-5.430552393970630,84,85,140,150,1,10
-5.4305632108461100,6,10,140,500,4,360
-5.434606553958110,6,10,90,375,4,285
-5.435139214567830,6,10,70,325,4,255
-5.435425991461060,54,55,50,175,1,125
-5.4358866883341400,54,55,60,175,1,115
-5.436637681073150,6,10,110,250,4,140
-5.436705707077350,6,10,120,425,4,305
-5.4369362137611800,12,15,190,275,3,85
-5.4372517972394400,12,15,70,175,3,105
-5.437754705518760,6,10,100,275,4,175
-5.438004668548900,6,10,60,475,4,415
-5.438633396141380,6,10,70,300,4,230
-5.44034026453655,6,10,180,425,4,245
-5.440932784334390,6,10,130,500,4,370
-5.442509338602580,6,10,120,275,4,155
-5.443130480667340,6,10,150,325,4,175
-5.443570607526180,64,65,160,175,1,15
-5.443825664676780,6,10,80,450,4,370
-5.443950929304820,54,55,140,200,1,60
-5.445203558746980,12,15,110,175,3,65
-5.445830190991030,6,10,190,325,4,135
-5.447598700429360,54,55,80,175,1,95
-5.448026129063860,6,10,130,450,4,320
-5.448766182338220,64,65,60,100,1,40
-5.449158760809770,6,10,100,325,4,225
-5.449475309154390,10,15,140,150,5,10
-5.450709886999650,6,10,160,475,4,315
-5.451395095916700,6,10,140,400,4,260
-5.4518031862980400,6,10,110,475,4,365
-5.451858377589880,84,85,90,100,1,10
-5.452792632266530,6,10,200,400,4,200
-5.453170148772200,4,10,120,125,6,5
-5.453179697380220,6,10,130,425,4,295
-5.454933198497820,12,15,80,175,3,95
-5.455383599468520,6,10,130,375,4,245
-5.455869951409840,6,10,110,450,4,340
-5.456384793450620,6,10,80,500,4,420
-5.457684905092970,6,10,100,400,4,300
-5.458594414186100,6,10,80,300,4,220
-5.459258697010870,6,10,170,250,4,80
-5.460156640461190,6,10,180,325,4,145
-5.460225277763800,6,10,180,300,4,120
-5.460912492913560,10,15,170,175,5,5
-5.464062999566540,6,10,200,325,4,125
-5.46457382480728,54,55,70,175,1,105
-5.465640264708980,6,10,170,450,4,280
-5.467059276260700,6,10,130,475,4,345
-5.468399836238300,6,10,140,450,4,310
-5.469139708239930,54,55,110,175,1,65
-5.469194668832720,10,15,90,100,5,10
-5.469281043539660,6,10,150,450,4,300
-5.471384194675950,6,10,180,350,4,170
-5.471990390412240,6,10,180,400,4,220
-5.472750385451320,6,10,200,425,4,225
-5.473332290806330,6,10,80,400,4,320
-5.473408560137530,12,15,190,250,3,60
-5.474742574570120,8,15,120,125,7,5
-5.47545075187509,6,10,150,475,4,325
-5.475829251307300,6,10,110,275,4,165
-5.476378555251610,6,10,190,425,4,235
-5.477407871288340,12,15,190,225,3,35
-5.477989457007730,6,10,160,275,4,115
-5.478196636505200,6,10,180,450,4,270
-5.4788641808864000,6,10,150,250,4,100
-5.478887559365370,6,10,80,425,4,345
-5.479781194081310,12,15,60,150,3,90
-5.480166273549220,6,10,150,300,4,150
-5.481326180688820,54,55,190,250,1,60
-5.481501502069270,6,10,190,350,4,160
-5.481711412581090,74,75,140,150,1,10
-5.482508552464460,6,10,80,475,4,395
-5.483655248408930,12,15,100,175,3,75
-5.48382111060058,6,10,150,425,4,275
-5.484224413471280,6,10,180,375,4,195
-5.484655126852440,6,10,90,425,4,335
-5.485123793625000,54,55,100,175,1,75
-5.487006711242450,6,10,70,400,4,330
-5.487175843097500,6,10,80,325,4,245
-5.488660427267610,6,10,160,250,4,90
-5.488883310219810,6,10,140,375,4,235
-5.489576642174670,12,15,90,175,3,85
-5.489880587783020,64,65,190,200,1,10
-5.491015398385840,6,10,140,425,4,285
-5.491358736912260,6,10,160,375,4,215
-5.492089455386410,54,55,90,175,1,85
-5.493434262558730,6,10,110,425,4,315
-5.493945604002380,6,10,60,175,4,115
-5.494138616036830,6,10,140,300,4,160
-5.496006608509270,6,10,140,350,4,210
-5.49621663458667,6,10,190,300,4,110
-5.4976443426213300,6,10,200,350,4,150
-5.498126046933460,6,10,120,350,4,230
-5.50089707997359,28,30,110,125,2,15
-5.501313722783340,6,10,100,375,4,275
-5.503508679210150,6,10,190,400,4,210
-5.503701675465680,6,10,80,200,4,120
-5.504131312141560,6,10,60,450,4,390
-5.5059898900348000,6,10,100,350,4,250
-5.506007068434050,54,55,170,200,1,30
-5.509192518289650,54,55,50,150,1,100
-5.509885837898030,18,20,200,500,2,300
-5.50993044943735,6,10,110,350,4,240
-5.51079444855527,6,10,110,300,4,190
-5.513372499828580,6,10,140,475,4,335
-5.51342694629272,54,55,190,225,1,35
-5.51455829683699,64,65,70,100,1,30
-5.515161080209850,6,10,110,400,4,290
-5.515541942733030,6,10,150,275,4,125
-5.517896362086160,54,55,200,250,1,50
-5.518810840743470,74,75,90,100,1,10
-5.518869771654710,6,10,130,350,4,220
-5.523497489245060,6,10,110,325,4,215
-5.523869478868270,6,10,160,450,4,290
-5.524225684175460,6,10,190,375,4,185
-5.528978603398820,18,20,190,475,2,285
-5.531980573793810,6,10,110,200,4,90
-5.533410979822890,28,30,80,100,2,20
-5.535185148505110,54,55,120,175,1,55
-5.536854403067600,6,10,200,375,4,175
-5.537974390935580,54,55,70,150,1,80
-5.538143384579290,18,20,50,375,2,325
-5.540326976263090,6,10,110,175,4,65
-5.541138878454170,18,20,50,350,2,300
-5.542102094975580,12,15,120,175,3,55
-5.543311118902420,54,55,60,150,1,90
-5.543585499193910,18,20,200,475,2,275
-5.544149597327190,64,65,100,125,1,25
-5.544451492836010,6,10,70,175,4,105
-5.544805225359430,6,10,140,200,4,60
-5.548679596912620,6,10,130,275,4,145
-5.549065903766530,6,10,110,375,4,265
-5.550568279560530,6,10,120,375,4,255
-5.553710187970120,6,10,130,200,4,70
-5.554497980691820,18,20,70,225,2,155
-5.556054638579860,12,15,200,250,3,50
-5.557773242891160,6,10,50,150,4,100
-5.557783228766550,18,20,50,500,2,450
-5.559103775808370,54,55,100,150,1,50
-5.559684140293740,18,20,180,500,2,320
-5.562346360939680,18,20,190,500,2,310
-5.563514777618370,18,20,80,250,2,170
-5.568237248842000,12,15,70,150,3,80
-5.570125716479260,18,20,90,250,2,160
-5.571050135023490,44,45,200,500,1,300
-5.573207792354080,18,20,160,500,2,340
-5.573351163030330,6,10,150,375,4,225
-5.573533567411430,6,10,120,200,4,80
-5.57369924604726,18,20,50,425,2,375
-5.573890349864450,18,20,130,225,2,95
-5.5744248268307600,6,10,100,200,4,100
-5.575137360714990,6,10,130,300,4,170
-5.576080637133000,18,20,60,375,2,315
-5.576268116206450,12,15,50,125,3,75
-5.577438727589100,54,55,80,150,1,70
-5.579174916161560,18,20,50,400,2,350
-5.579511791721530,54,55,200,225,1,25
-5.579589686743650,6,10,180,250,4,70
-5.580272224419280,18,20,60,425,2,365
-5.580855249918680,18,20,60,350,2,290
-5.582062327948800,28,30,140,150,2,10
-5.582414356573280,18,20,60,325,2,265
-5.583500420763370,18,20,90,475,2,385
-5.583522199672750,18,20,150,500,2,350
-5.583898074018140,18,20,50,275,2,225
-5.584129724802480,18,20,200,450,2,250
-5.584309056152840,18,20,100,500,2,400
-5.586008063909190,18,20,120,450,2,330
-5.586336804098090,6,10,120,325,4,205
-5.586359973965870,18,20,50,450,2,400
-5.586845519228080,18,20,170,350,2,180
-5.58791062840939,6,10,170,275,4,105
-5.588410773808180,18,20,90,500,2,410
-5.5930853657989400,18,20,50,475,2,425
-5.5936087158380200,18,20,120,225,2,105
-5.594154125104840,6,10,120,300,4,180
-5.594428462628910,18,20,160,350,2,190
-5.594505044956810,18,20,100,450,2,350
-5.594881122486260,18,20,70,375,2,305
-5.596349747608600,18,20,170,500,2,330
-5.597111270911180,6,10,180,275,4,95
-5.597172581412880,12,15,100,150,3,50
-5.597223258965880,18,20,170,400,2,230
-5.598026479265480,12,15,80,150,3,70
-5.598514176701530,6,10,200,275,4,75
-5.599659608719380,44,45,190,475,1,285
-5.600332641967760,18,20,60,300,2,240
-5.600613607101360,18,20,130,250,2,120
-5.600617158011820,12,15,200,225,3,25
-5.600979547850330,18,20,90,225,2,135
-5.602379840486040,18,20,160,425,2,265
-5.60453674545929,54,55,50,125,1,75
-5.604863352399890,6,10,90,200,4,110
-5.60545716462096,6,10,140,325,4,185
-5.607239280649270,16,20,120,125,4,5
-5.607588119856580,18,20,170,475,2,305
-5.608408617886570,18,20,120,500,2,380
-5.6091032587451500,18,20,60,400,2,340
-5.609225073148710,54,55,130,175,1,45
-5.609492198684380,18,20,100,475,2,375
-5.609509660822910,18,20,180,475,2,295
-5.609870879976720,74,75,170,175,1,5
-5.610140829429020,18,20,160,300,2,140
-5.610169132512260,18,20,150,225,2,75
-5.6103714239392700,18,20,160,400,2,240
-5.610741899912900,12,15,140,175,3,35
-5.611818636214470,44,45,200,475,1,275
-5.612195739734880,44,45,160,500,1,340
-5.61233943798258,18,20,70,500,2,430
-5.612949251063340,84,85,170,175,1,5
-5.613232567924560,18,20,90,350,2,260
-5.614000174048860,44,45,190,500,1,310
-5.614090081780170,18,20,160,475,2,315
-5.6142170175820700,12,15,180,200,3,20
-5.614298183251050,18,20,90,450,2,360
-5.6149646370877900,18,20,80,275,2,195
-5.615049843332510,18,20,140,500,2,360
-5.615284327903520,18,20,170,325,2,155
-5.615559194762000,54,55,140,175,1,35
-5.615755621040230,6,10,130,325,4,195
-5.61599000152556,18,20,190,450,2,260
-5.616230764809740,6,10,90,175,4,85
-5.616890858550900,18,20,80,225,2,145
-5.617016414092260,6,10,60,150,4,90
-5.617027397461100,18,20,170,375,2,205
-5.617647591514950,18,20,70,250,2,180
-5.619321850781360,18,20,130,500,2,370
-5.620233149970980,18,20,140,225,2,85
-5.620692228139950,6,10,80,175,4,95
-5.621081083728270,18,20,160,325,2,165
-5.621298966744340,18,20,110,500,2,390
-5.621759014175880,18,20,100,425,2,325
-5.6220602984947600,44,45,100,500,1,400
-5.6227404830284800,54,55,90,150,1,60
-5.623862278328440,54,55,110,150,1,40
-5.624292004302220,44,45,120,450,1,330
-5.624907086046040,18,20,70,350,2,280
-5.625936518823730,18,20,80,350,2,270
-5.62700314329304,18,20,130,450,2,320
-5.627507188570960,18,20,140,275,2,135
-5.627655660125130,18,20,90,400,2,310
-5.627678887540360,18,20,170,300,2,130
-5.627838496598530,44,45,180,500,1,320
-5.6284996903354000,6,10,190,225,4,35
-5.628811918259920,18,20,50,225,2,175
-5.628928328875310,18,20,80,450,2,370
-5.629222728152580,18,20,120,475,2,355
-5.629720585956990,54,55,180,200,1,20
-5.630069642885940,18,20,140,250,2,110
-5.630333883467010,18,20,170,425,2,255
-5.630450207096280,18,20,150,350,2,200
-5.630628640603430,18,20,200,425,2,225
-5.6308202372108400,44,45,90,500,1,410
-5.6309543421023300,18,20,100,225,2,125
-5.632173166888010,18,20,150,400,2,250
-5.6322517163188500,18,20,60,225,2,165
-5.632775914318660,18,20,90,300,2,210
-5.63281202121674,18,20,70,275,2,205
-5.632917616518570,18,20,170,450,2,280
-5.633379662375590,44,45,170,500,1,330
-5.634251782760020,18,20,110,475,2,365
-5.634329915769450,44,45,170,350,1,180
-5.635108776861790,18,20,70,475,2,405
-5.635189289083200,18,20,200,300,2,100
-5.63521485215153,18,20,60,500,2,440
-5.6353005174904500,12,15,90,150,3,60
-5.635497416607710,18,20,130,400,2,270
-5.636062463945700,18,20,180,425,2,245
-5.636794260787570,18,20,200,400,2,200
-5.636965551422340,44,45,200,450,1,250
-5.637253154786490,18,20,70,425,2,355
-5.6372542448174800,6,10,190,275,4,85
-5.637722761451440,28,30,90,100,2,10
-5.637896264257810,44,45,170,400,1,230
-5.637949705140330,18,20,140,400,2,260
-5.637985522249030,18,20,50,300,2,250
-5.6380378805546800,18,20,60,250,2,190
-5.639455722886910,38,40,120,125,2,5
-5.6397944503482400,18,20,150,200,2,50
-5.640274348251150,18,20,90,275,2,185
-5.640414054461280,18,20,120,250,2,130
-5.640744296925970,44,45,100,450,1,350
-5.640929410385910,18,20,120,425,2,305
-5.64096710991416,64,65,80,100,1,20
-5.641055488789510,18,20,150,450,2,300
-5.641133247585360,44,45,90,475,1,385
-5.64179848275314,44,45,170,475,1,305
-5.642951600024690,12,15,110,150,3,40
-5.643100398563610,44,45,50,425,1,375
-5.643207492850620,18,20,180,450,2,270
-5.643487131301100,18,20,180,400,2,220
-5.64361847775257,18,20,110,450,2,340
-5.644008028734140,44,45,50,400,1,350
-5.644726933178970,18,20,130,475,2,345
-5.645582895245110,18,20,80,475,2,395
-5.646581521792150,44,45,90,250,1,160
-5.646845745390420,18,20,140,450,2,310
-5.646911538437460,18,20,100,400,2,300
-5.647898029691710,12,15,130,175,3,45
-5.648211402698600,18,20,120,400,2,280
-5.6482388521121400,44,45,160,350,1,190
-5.64847258643405,18,20,70,450,2,380
-5.64947713466488,18,20,110,425,2,315
-5.649744467248190,18,20,90,375,2,285
-5.650607770564340,44,45,100,475,1,375
-5.650609352688490,18,20,150,475,2,325
-5.650720650013180,18,20,190,325,2,135
-5.650813823512190,18,20,50,250,2,200
-5.651074725724350,44,45,180,475,1,295
-5.6513177227854800,44,45,150,500,1,350
-5.6515738203709000,18,20,80,375,2,295
-5.651692318312720,18,20,150,425,2,275
-5.651747221572310,18,20,130,375,2,245
-5.651947105428110,18,20,140,425,2,285
-5.6520679893035900,44,45,140,500,1,360
-5.652341113071940,44,45,70,225,1,155
-5.652463308488850,18,20,100,325,2,225
-5.652883494496680,18,20,70,400,2,330
-5.6528845609742500,44,45,70,500,1,430
-5.653168569883080,18,20,190,400,2,210
-5.653527047636790,44,45,120,500,1,380
-5.65406518494982,44,45,130,225,1,95
-5.654677643640710,18,20,50,325,2,275
-5.655404974237230,44,45,100,425,1,325
-5.655672178501340,44,45,120,475,1,355
-5.655706287591640,18,20,130,425,2,295
-5.656097668416030,44,45,190,450,1,260
-5.656407844940140,44,45,160,475,1,315
-5.65646856910199,18,20,180,375,2,195
-5.656875231503560,44,45,90,400,1,310
-5.656958507993990,18,20,60,475,2,415
-5.657348823565010,44,45,50,375,1,325
-5.6576362311967000,18,20,70,200,2,130
-5.657655305162000,18,20,150,325,2,175
-5.657663044652240,18,20,100,275,2,175
-5.65782318070564,18,20,90,425,2,335
-5.65807643200165,44,45,170,425,1,255
-5.65818669617157,22,25,120,125,3,5
-5.658848938247770,18,20,80,500,2,420
-5.659305038240250,44,45,160,425,1,265
-5.659700668027660,18,20,160,375,2,215
-5.659904591748540,44,45,50,350,1,300
-5.659981648544070,18,20,190,425,2,235
-5.660804991085180,44,45,60,425,1,365
-5.6610960858705100,18,20,200,350,2,150
-5.662206707652520,44,45,130,500,1,370
-5.662420996271230,44,45,160,325,1,165
-5.66269518352855,44,45,120,400,1,280
-5.662736831613020,18,20,100,250,2,150
-5.662962910372420,44,45,110,500,1,390
-5.66331928958262,18,20,120,350,2,230
-5.6634361672575900,44,45,160,300,1,140
-5.66436005235261,18,20,190,350,2,160
-5.6653262011407100,18,20,70,325,2,255
-5.66540591466099,18,20,60,450,2,390
-5.665580797769910,18,20,200,325,2,125
-5.665700873459670,18,20,110,250,2,140
-5.665887624487380,18,20,60,275,2,215
-5.666188333791560,44,45,130,400,1,270
-5.666700591149550,44,45,180,400,1,220
-5.667401738641480,18,20,180,325,2,145
-5.668601562214200,44,45,170,325,1,155
-5.6691068441118100,44,45,60,400,1,340
-5.669305883863530,18,20,80,425,2,345
-5.670402533319080,44,45,80,500,1,420
-5.670754418828890,18,20,90,325,2,235
-5.670865219306380,18,20,70,300,2,230
-5.670941486705240,44,45,120,225,1,105
-5.671040268991620,64,65,110,125,1,15
-5.671319835607220,18,20,110,275,2,165
-5.671529756902170,44,45,160,400,1,240
-5.6721151381982100,44,45,170,375,1,205
-5.672702142284100,44,45,90,300,1,210
-5.672792712857530,44,45,50,450,1,400
-5.673202841035930,18,20,180,300,2,120
-5.673235888212230,44,45,50,500,1,450
-5.673460833741080,44,45,180,425,1,245
-5.673514393420800,44,45,90,450,1,360
-5.673780456419260,44,45,170,450,1,280
-5.674112741427650,44,45,60,350,1,290
-5.674172147385220,44,45,130,475,1,345
-5.6744957726944100,44,45,70,425,1,355
-5.6746902754613900,44,45,170,300,1,130
-5.674760701577150,54,55,150,175,1,25
-5.674904512387580,44,45,70,375,1,305
-5.675451947317990,44,45,110,475,1,365
-5.675729505489310,44,45,90,350,1,260
-5.676306147174500,18,20,180,350,2,170
-5.676842957583230,18,20,120,275,2,155
-5.677042744304910,44,45,80,250,1,170
-5.6771338248122500,44,45,150,450,1,300
-5.677288741864620,18,20,140,375,2,235
-5.677309477551980,44,45,150,350,1,200
-5.677773331650340,44,45,60,375,1,315
-5.678260258633970,18,20,160,450,2,290
-5.678462580811060,18,20,190,300,2,110
-5.679771508362960,44,45,70,450,1,380
-5.680003954292930,18,20,160,250,2,90
-5.680083397522600,44,45,100,225,1,125
-5.680092938348570,18,20,160,275,2,115
-5.680126723370400,44,45,200,400,1,200
-5.680468323183960,44,45,150,325,1,175
-5.680669601335500,44,45,150,400,1,250
-5.681116503781190,18,20,110,300,2,190
-5.6811761164453100,44,45,130,450,1,320
-5.681340195200160,44,45,140,400,1,260
-5.681480050941980,44,45,60,325,1,265
-5.682118400105660,18,20,140,475,2,335
-5.682355191143920,44,45,100,250,1,150
-5.68240790219602,18,20,190,375,2,185
-5.682484954689470,18,20,80,400,2,320
-5.682705241563900,18,20,110,400,2,290
-5.683512450600420,54,55,60,125,1,65
-5.683538902274040,18,20,170,250,2,80
-5.683635834933310,18,20,140,350,2,210
-5.6837982090437700,12,15,120,150,3,30
-5.683865353501770,44,45,130,375,1,245
-5.683961131690600,44,45,180,450,1,270
-5.684309759614880,44,45,140,375,1,235
-5.684350908802110,44,45,200,300,1,100
-5.684467417148400,44,45,80,475,1,395
-5.6846035338857500,44,45,90,275,1,185
-5.684674451726750,44,45,80,375,1,295
-5.684863824986810,44,45,140,225,1,85
-5.684923803582600,44,45,120,425,1,305
-5.684957416287360,18,20,100,375,2,275
-5.685175582249060,18,20,170,225,2,55
-5.685498672828270,44,45,200,350,1,150
-5.685513108264500,44,45,130,425,1,295
-5.685518666040490,44,45,110,450,1,340
-5.685764676912380,54,55,120,150,1,30
-5.686128019620190,44,45,150,225,1,75
-5.68633701610112,18,20,100,350,2,250
-5.686416715180950,44,45,200,425,1,225
-5.686500189069080,44,45,140,425,1,285
-5.686508496422480,44,45,180,375,1,195
-5.686621793629090,44,45,150,475,1,325
-5.686952858795380,44,45,90,375,1,285
-5.687105368710700,18,20,110,350,2,240
-5.6875795740543100,18,20,150,300,2,150
-5.688186341964440,12,15,150,175,3,25
-5.689095046279110,44,45,190,400,1,210
-5.689302407865270,18,20,110,225,2,115
-5.689351838537470,44,45,180,350,1,170
-5.689745653183890,44,45,100,400,1,300
-5.68994971385313,44,45,80,225,1,145
-5.690076184432400,44,45,180,325,1,145
-5.690117463990470,18,20,80,325,2,245
-5.690569659152470,18,20,100,300,2,200
-5.690772621850430,44,45,70,475,1,405
-5.691030427903370,44,45,80,450,1,370
-5.6912464313109200,44,45,60,300,1,240
-5.6913365747269600,44,45,90,225,1,135
-5.69137669745115,44,45,190,350,1,160
-5.691535667010490,44,45,130,250,1,120
-5.691744450854610,18,20,160,225,2,65
-5.691877019559840,44,45,50,475,1,425
-5.692295998932930,44,45,190,425,1,235
-5.692485100020180,44,45,90,425,1,335
-5.692500728077220,18,20,150,375,2,225
-5.692759085120800,44,45,70,250,1,180
-5.692882931972990,18,20,80,300,2,220
-5.6928904004768100,18,20,200,375,2,175
-5.693213080451390,18,20,120,375,2,255
-5.694070776822690,18,20,150,250,2,100
-5.694096637409460,44,45,80,350,1,270
-5.694450353774630,44,45,140,450,1,310
-5.6966515422840600,44,45,160,275,1,115
-5.696889029070770,18,20,110,375,2,265
-5.6980444773107800,44,45,80,425,1,345
-5.698108718120850,6,10,180,200,4,20
-5.698372459969670,44,45,160,450,1,290
-5.698647243458320,44,45,190,375,1,185
-5.699005641077580,44,45,110,425,1,315
-5.700587372145960,44,45,50,275,1,225
-5.7007542159353700,44,45,140,275,1,135
-5.701069936585290,18,20,50,200,2,150
-5.701704793956990,44,45,140,350,1,210
-5.702236266601450,18,20,150,275,2,125
-5.70226639167916,44,45,120,275,1,155
-5.702536463128690,44,45,150,425,1,275
-5.702714451596560,44,45,80,275,1,195
-5.702763077681560,44,45,140,250,1,110
-5.7036074330699900,44,45,70,350,1,280
-5.704338334694030,44,45,200,375,1,175
-5.705013010599590,44,45,120,250,1,130
-5.705201266413650,44,45,160,375,1,215
-5.70849867035996,44,45,130,350,1,220
-5.708901601815360,44,45,180,300,1,120
-5.70912568085784,12,15,50,100,3,50
-5.709239176979320,54,55,50,100,1,50
-5.709242944325060,44,45,190,325,1,135
-5.709257365704590,44,45,110,400,1,290
-5.70988154166103,44,45,190,300,1,110
-5.71048758805806,44,45,100,275,1,175
-5.710669891787980,6,10,190,250,4,60
-5.710735856396090,44,45,140,475,1,335
-5.710986184393600,54,55,70,125,1,55
-5.711805619620040,12,15,160,175,3,15
-5.712237047498120,44,45,110,250,1,140
-5.7129919048259,44,45,100,375,1,275
-5.713901975735540,18,20,140,300,2,160
-5.7139595251897700,18,20,130,350,2,220
-5.714449832335760,44,45,100,350,1,250
-5.714639589629730,44,45,60,450,1,390
-5.715569469278260,44,45,120,350,1,230
-5.716010194877980,44,45,100,325,1,225
-5.717505606231620,44,45,70,325,1,255
-5.717690528392420,44,45,60,475,1,415
-5.717976490055730,44,45,80,400,1,320
-5.718579184142280,44,45,110,375,1,265
-5.719222743868250,44,45,100,300,1,200
-5.719715507997470,6,10,100,175,4,75
-5.720162980802530,44,45,60,225,1,165
-5.720377316044310,18,20,160,200,2,40
-5.72095867406956,44,45,60,500,1,440
-5.721163423204990,44,45,200,325,1,125
-5.722482685341120,44,45,70,275,1,205
-5.722722907087010,18,20,130,300,2,170
-5.72331394603449,44,45,50,325,1,275
-5.723774393658480,44,45,70,400,1,330
-5.723911138202610,28,30,170,175,2,5
-5.724176639286690,44,45,90,325,1,235
-5.72576883230603,18,20,130,275,2,145
-5.725796711826010,44,45,110,350,1,240
-5.727460562938020,18,20,50,175,2,125
-5.728374363682070,44,45,120,375,1,255
-5.728595036930390,6,10,100,150,4,50
-5.729194532612580,44,45,80,325,1,245
-5.7304490727758400,44,45,50,225,1,175
-5.731380886124370,6,10,70,150,4,80
-5.732910174198060,18,20,120,325,2,205
-5.7331879914354000,6,10,120,175,4,55
-5.7336492367909900,44,45,110,275,1,165
-5.734059009833110,6,10,50,125,4,75
-5.734144277548510,18,20,110,325,2,215
-5.735075727628710,44,45,60,275,1,215
-5.736084593074360,44,45,140,300,1,160
-5.736505054768090,6,10,200,225,4,25
-5.737517340198790,12,15,60,125,3,65
-5.737752270693960,18,20,110,200,2,90
-5.737884808997610,18,20,60,200,2,140
-5.738057505265900,44,45,110,300,1,190
-5.7387860810998000,18,20,180,225,2,45
-5.738851115869440,94,95,120,125,1,5
-5.739061906576500,44,45,70,200,1,130
-5.739790564315760,44,45,150,375,1,225
-5.739823966073480,44,45,130,300,1,170
-5.7404337230798,18,20,170,275,2,105
-5.740874078660440,44,45,150,300,1,150
-5.7410202848126100,18,20,180,250,2,70
-5.74273705195238,44,45,50,300,1,250
-5.742963374775800,18,20,60,175,2,115
-5.743749663191050,44,45,130,275,1,145
-5.744326148360030,18,20,140,325,2,185
-5.744616549115420,44,45,170,250,1,80
-5.74523697255914,44,45,150,275,1,125
-5.745366468998420,64,65,140,150,1,10
-5.745435932777790,18,20,80,200,2,120
-5.745874790995630,44,45,80,300,1,220
-5.747698218064130,44,45,60,250,1,190
-5.747826855355050,6,10,140,175,4,35
-5.747965801718280,44,45,50,250,1,200
-5.74829045520761,44,45,70,300,1,230
-5.749261412119300,18,20,120,300,2,180
-5.751628438697500,44,45,150,250,1,100
-5.751806031465320,44,45,110,225,1,115
-5.75199039974103,18,20,130,325,2,195
-5.75341650176672,44,45,150,200,1,50
-5.7570516612529400,54,55,160,175,1,15
-5.759524504197580,44,45,140,325,1,185
-5.7615425145209300,54,55,80,125,1,45
-5.761920089328880,12,15,70,125,3,55
-5.764457809061190,6,10,120,150,4,30
-5.765510933224610,44,45,170,275,1,105
-5.765806258266540,44,45,110,325,1,215
-5.765973847804920,18,20,180,275,2,95
-5.766389207790480,44,45,120,300,1,180
-5.767116883147650,44,45,160,250,1,90
-5.7680809177037800,44,45,160,225,1,65
-5.768497695308620,18,20,90,200,2,110
-5.769583054172260,44,45,130,325,1,195
-5.7715420012363800,18,20,200,275,2,75
-5.773029056131360,18,20,130,200,2,70
-5.773457886589760,44,45,120,325,1,205
-5.774855855524550,18,20,70,175,2,105
-5.77596238293043,18,20,140,200,2,60
-5.777734281953880,18,20,100,200,2,100
-5.780089258917230,18,20,110,175,2,65
-5.7824429357813200,44,45,170,225,1,55
-5.7839911343457500,12,15,80,125,3,45
-5.784719321575140,44,45,180,250,1,70
-5.785186336959390,44,45,180,275,1,95
-5.785640573552180,12,15,130,150,3,20
-5.786951646155550,18,20,170,200,2,30
-5.790964907223360,44,45,200,275,1,75
-5.792281637014970,54,55,90,125,1,35
-5.793208099884490,44,45,80,200,1,120
-5.793653038995010,18,20,120,200,2,80
-5.794453841728220,6,10,200,250,4,50
-5.7945714820490500,6,10,150,175,4,25
-5.795709392179180,18,20,190,275,2,85
-5.795827659902250,12,15,190,200,3,10
-5.796790558023000,12,15,90,125,3,35
-5.802248645093260,44,45,190,275,1,85
-5.802453287605870,6,10,80,150,4,70
-5.805419173222040,54,55,130,150,1,20
-5.808136603453350,44,45,90,200,1,110
-5.808837998448460,44,45,110,200,1,90
-5.812007661407940,44,45,180,225,1,45
-5.814165049618680,6,10,50,100,4,50
-5.814752781944600,6,10,160,175,4,15
-5.816406613740590,44,45,160,200,1,40
-5.817188922479480,44,45,60,200,1,140
-5.819256169679280,44,45,50,200,1,150
-5.821425061312850,44,45,100,200,1,100
-5.827778967368550,64,65,90,100,1,10
-5.8293657422237100,6,10,90,150,4,60
-5.8299334005100700,64,65,170,175,1,5
-5.8353788021268400,18,20,80,175,2,95
-5.838378365097380,44,45,130,200,1,70
-5.838820220862670,18,20,50,150,2,100
-5.839751257105220,44,45,140,200,1,60
-5.842488520915460,44,45,50,175,1,125
-5.84392285999532,44,45,120,200,1,80
-5.8447681758926800,18,20,90,175,2,85
-5.84524063214645,44,45,60,175,1,115
-5.848909916968880,44,45,110,175,1,65
-5.850243611751310,18,20,190,250,2,60
-5.851494474231290,6,10,110,150,4,40
-5.852686370158550,54,55,190,200,1,10
-5.852920288718290,18,20,190,225,2,35
-5.853515794295210,54,55,60,100,1,40
-5.856166329437430,44,45,70,175,1,105
-5.861935012750540,6,10,130,175,4,45
-5.866138894566140,18,20,60,150,2,90
-5.870951004580240,12,15,60,100,3,40
-5.871481429466970,44,45,80,175,1,95
-5.874773730600680,18,20,100,175,2,75
-5.8753856901433200,44,45,190,250,1,60
-5.879495054255780,44,45,170,200,1,30
-5.882040323518230,44,45,90,175,1,85
-5.888010664980980,54,55,100,125,1,25
-5.889330083855950,54,55,70,100,1,30
-5.897168654233560,6,10,190,200,4,10
-5.900208344418750,44,45,50,150,1,100
-5.9010908457072500,18,20,120,175,2,55
-5.903021235975590,44,45,190,225,1,35
-5.906264334488200,6,10,130,150,4,20
-5.917125125566030,44,45,100,175,1,75
-5.918455424454350,18,20,200,250,2,50
-5.924747112894560,12,15,100,125,3,25
-5.927292740605910,6,10,70,125,4,55
-5.927316312978310,18,20,100,150,2,50
-5.928037994293560,44,45,200,250,1,50
-5.9289841344753,6,10,60,125,4,65
-5.9298072064439000,18,20,70,150,2,80
-5.938956072229160,12,15,70,100,3,30
-5.941082006296590,18,20,50,125,2,75
-5.95058605857847,84,85,120,125,1,5
-5.95081775473524,18,20,200,225,2,25
-5.951252215038190,44,45,120,175,1,55
-5.952555595049680,44,45,60,150,1,90
-5.952560672605660,18,20,80,150,2,70
-5.957160235919930,44,45,70,150,1,80
-5.964735867866130,18,20,140,175,2,35
-5.967082527534290,44,45,100,150,1,50
-5.969174014187830,6,10,60,100,4,40
-5.975167875861180,44,45,80,150,1,70
-5.977949003224280,18,20,180,200,2,20
-5.979876624858950,54,55,80,100,1,20
-5.986695859902560,18,20,90,150,2,60
-5.9907940000938100,54,55,110,125,1,15
-5.991585383333350,44,45,140,175,1,35
-6.00041846548172,74,75,120,125,1,5
-6.0012528200385100,44,45,200,225,1,25
-6.001390851503520,44,45,130,175,1,45
-6.002809665149890,44,45,90,150,1,60
-6.005690890357980,18,20,130,175,2,45
-6.009057067966480,34,35,200,500,1,300
-6.013613156655660,12,15,110,125,3,15
-6.016485966158770,6,10,90,125,4,35
-6.016562953197490,10,15,120,125,5,5
-6.020811377933980,18,20,120,150,2,30
-6.028855506476280,18,20,110,150,2,40
-6.0297523978547000,44,45,50,125,1,75
-6.033836160282020,44,45,110,150,1,40
-6.041396178733520,18,20,150,175,2,25
-6.046156712981460,34,35,200,475,1,275
-6.047985328699620,12,15,80,100,3,20
-6.0491751733510900,18,20,60,125,2,65
-6.053320708698750,34,35,190,475,1,285
-6.055158154174470,44,45,150,175,1,25
-6.057015069028040,44,45,180,200,1,20
-6.058025056723030,34,35,190,500,1,310
-6.068637765690720,34,35,50,350,1,300
-6.0692768505077900,6,10,80,125,4,45
-6.072429669765690,34,35,50,375,1,325
-6.0738690720343600,34,35,120,450,1,330
-6.075620804049270,34,35,160,500,1,340
-6.077249843463730,34,35,180,500,1,320
-6.077557392530880,44,45,120,150,1,30
-6.083522466231290,34,35,70,225,1,155
-6.084249692974680,6,10,170,175,4,5
-6.084559759406170,34,35,200,450,1,250
-6.085070785613710,34,35,90,500,1,410
-6.085216342470120,44,45,60,125,1,65
-6.087377020767920,34,35,170,350,1,180
-6.089730840313030,34,35,90,475,1,385
-6.090531650718120,34,35,100,500,1,400
-6.091139736154280,34,35,170,400,1,230
-6.0912443733115700,34,35,90,250,1,160
-6.091955217814130,34,35,120,225,1,105
-6.092885848383560,34,35,50,425,1,375
-6.093110106283000,34,35,60,325,1,265
-6.094028503281300,34,35,50,500,1,450
-6.09563276432126,34,35,50,400,1,350
-6.09686341037774,34,35,160,425,1,265
-6.0971653711748900,34,35,80,250,1,170
-6.097384941172290,34,35,60,350,1,290
-6.0977041074459200,34,35,160,400,1,240
-6.097887456434510,34,35,130,225,1,95
-6.098570559144420,18,20,160,175,2,15
-6.099189027216000,18,20,50,100,2,50
-6.10015730479908,34,35,100,475,1,375
-6.101160192549440,34,35,170,475,1,305
-6.101410245344060,34,35,120,500,1,380
-6.101562333580100,34,35,150,500,1,350
-6.1024236598083600,34,35,170,375,1,205
-6.102496702754950,34,35,130,500,1,370
-6.103044216944340,34,35,70,500,1,430
-6.104484134452330,6,10,100,125,4,25
-6.105528531221190,34,35,190,450,1,260
-6.105569799124530,34,35,60,375,1,315
-6.105663916890790,34,35,60,425,1,365
-6.105807749520180,34,35,50,475,1,425
-6.106352668499650,34,35,170,500,1,330
-6.107133113572810,34,35,130,475,1,345
-6.1073129897856400,34,35,110,500,1,390
-6.109934752057640,34,35,110,450,1,340
-6.110328395964340,34,35,100,450,1,350
-6.110968196046710,34,35,90,400,1,310
-6.111428969340500,18,20,70,125,2,55
-6.112233890085940,34,35,90,225,1,135
-6.114667063633990,34,35,180,475,1,295
-6.114853108046360,34,35,50,450,1,400
-6.116132176370260,34,35,170,325,1,155
-6.118510933420630,34,35,170,425,1,255
-6.11861361934148,34,35,80,450,1,370
-6.119675759023320,34,35,70,375,1,305
-6.120865730996240,34,35,160,475,1,315
-6.1216102602011900,34,35,50,275,1,225
-6.122155209926050,6,10,70,100,4,30
-6.122697941350260,44,45,70,125,1,55
-6.12275720851887,34,35,180,425,1,245
-6.12330824092889,34,35,120,425,1,305
-6.123954888559470,34,35,160,350,1,190
-6.124872983559370,34,35,110,475,1,365
-6.125131444407330,34,35,100,425,1,325
-6.125861404786850,34,35,90,450,1,360
-6.126318876480330,34,35,140,500,1,360
-6.127872640285010,34,35,200,425,1,225
-6.1289307370806600,34,35,90,350,1,260
-6.129817445780910,34,35,120,475,1,355
-6.130151154467700,34,35,70,450,1,380
-6.1302257758197000,34,35,130,450,1,320
-6.1306204949299300,34,35,150,450,1,300
-6.130887973237630,34,35,80,500,1,420
-6.131045471258370,12,15,140,150,3,10
-6.131178817746680,34,35,160,325,1,165
-6.131437141598790,34,35,70,250,1,180
-6.132040115614830,34,35,70,275,1,205
-6.132859323942940,34,35,170,450,1,280
-6.132872015573520,34,35,140,225,1,85
-6.134667343681350,18,20,90,125,2,35
-6.134926839116400,34,35,80,225,1,145
-6.135573100936230,34,35,190,350,1,160
-6.135619648841230,54,55,140,150,1,10
-6.136015099998120,34,35,150,325,1,175
-6.136758428799090,34,35,130,400,1,270
-6.137104328701750,28,30,120,125,2,5
-6.137697351642220,34,35,60,400,1,340
-6.137706743897190,34,35,120,400,1,280
-6.138051876340270,44,45,50,100,1,50
-6.138313273772310,34,35,130,425,1,295
-6.138499080698170,34,35,110,250,1,140
-6.138541158186860,34,35,100,400,1,300
-6.138808011085470,34,35,150,475,1,325
-6.138975494880640,34,35,90,300,1,210
-6.138979729224170,34,35,70,475,1,405
-6.139712108236310,34,35,90,425,1,335
-6.140208530796630,34,35,200,400,1,200
-6.140358629378010,34,35,80,375,1,295
-6.14050518823956,34,35,150,425,1,275
-6.140996580748390,34,35,150,225,1,75
-6.141786450398600,34,35,100,225,1,125
-6.142026808178900,34,35,140,275,1,135
-6.14213960654226,34,35,190,400,1,210
-6.142826589997390,34,35,160,300,1,140
-6.143011863153100,18,20,130,150,2,20
-6.143707417942590,34,35,130,250,1,120
-6.143796774696210,34,35,140,425,1,285
-6.145003689252170,34,35,80,275,1,195
-6.145058421427320,34,35,130,375,1,245
-6.145059762284140,34,35,180,450,1,270
-6.1453644706442100,34,35,90,375,1,285
-6.145643369060110,34,35,150,400,1,250
-6.146767901053720,34,35,140,400,1,260
-6.146966702156800,34,35,170,300,1,130
-6.147687537786920,34,35,70,425,1,355
-6.147825755859360,34,35,180,375,1,195
-6.148795691649160,34,35,180,400,1,220
-6.149033132307220,34,35,190,375,1,185
-6.149801575034970,34,35,90,275,1,185
-6.1498434943860800,34,35,140,250,1,110
-6.15011505967061,34,35,140,450,1,310
-6.150884995101600,34,35,190,425,1,235
-6.1522951796439500,34,35,140,375,1,235
-6.153627308709150,34,35,80,475,1,395
-6.1540860286498400,34,35,120,250,1,130
-6.154349185980020,34,35,200,300,1,100
-6.154488786754140,34,35,60,300,1,240
-6.154495498102420,34,35,80,425,1,345
-6.154683441756060,34,35,100,250,1,150
-6.154685838093790,34,35,110,425,1,315
-6.15483173095215,34,35,50,300,1,250
-6.155052622390050,34,35,60,475,1,415
-6.155146537535680,34,35,140,475,1,335
-6.155832655528080,34,35,60,500,1,440
-6.156258574185750,34,35,80,400,1,320
-6.157125643875430,34,35,150,350,1,200
-6.1579843039507000,34,35,120,350,1,230
-6.158551066181600,34,35,180,325,1,145
-6.159127098341950,34,35,80,350,1,270
-6.159599626397370,34,35,180,350,1,170
-6.1615485085083,34,35,150,250,1,100
-6.16205924879452,34,35,160,375,1,215
-6.16282403224356,34,35,60,225,1,165
-6.162862277020110,34,35,160,450,1,290
-6.163241322400750,34,35,100,350,1,250
-6.1640586817185700,34,35,200,325,1,125
-6.165580767895370,34,35,70,325,1,255
-6.16566416989944,18,20,80,125,2,45
-6.165982955360370,34,35,110,350,1,240
-6.166729593807220,34,35,200,350,1,150
-6.166969741290460,12,15,170,175,3,5
-6.169061926588180,34,35,200,375,1,175
-6.169442257759440,34,35,100,275,1,175
-6.169557889090410,34,35,100,325,1,225
-6.17052551202203,34,35,150,300,1,150
-6.170664812812230,34,35,100,300,1,200
-6.171320620333950,34,35,110,400,1,290
-6.171323230653810,44,45,160,175,1,15
-6.171885614913130,34,35,70,200,1,130
-6.172151217283710,34,35,60,450,1,390
-6.172952087936620,54,55,90,100,1,10
-6.173094049139350,34,35,110,275,1,165
-6.173623230606700,34,35,60,250,1,190
-6.173972524199710,34,35,70,400,1,330
-6.1748644070969200,34,35,70,350,1,280
-6.1758151210721900,34,35,100,375,1,275
-6.1764167472162600,18,20,190,200,2,10
-6.177413689047890,34,35,140,350,1,210
-6.177743523785600,34,35,50,325,1,275
-6.178554390508490,34,35,190,325,1,135
-6.178597395701050,34,35,180,300,1,120
-6.180509273066290,34,35,120,275,1,155
-6.180768040866420,34,35,150,200,1,50
-6.181252948029180,44,45,130,150,1,20
-6.181369512428410,34,35,50,250,1,200
-6.181436062124900,44,45,80,125,1,45
-6.18290932503071,34,35,170,250,1,80
-6.183286349911760,34,35,110,225,1,115
-6.184368731042740,44,45,90,125,1,35
-6.18460911928755,34,35,90,325,1,235
-6.1846131591906300,34,35,160,225,1,65
-6.184809896855810,12,15,90,100,3,10
-6.187440923252970,34,35,120,375,1,255
-6.1886761806303000,34,35,110,375,1,265
-6.190011560628960,34,35,60,275,1,215
-6.190577378525420,34,35,50,225,1,175
-6.192063136532500,34,35,130,350,1,220
-6.192334611295420,34,35,150,375,1,225
-6.19292416070644,34,35,190,300,1,110
-6.193307393995100,34,35,80,325,1,245
-6.1949561922407500,34,35,150,275,1,125
-6.1953172716811700,34,35,140,300,1,160
-6.19577255913336,34,35,70,300,1,230
-6.198215886538700,34,35,160,275,1,115
-6.2067208535080000,18,20,60,100,2,40
-6.209632781395340,34,35,110,300,1,190
-6.214695743138060,34,35,80,300,1,220
-6.2158297986431300,34,35,170,275,1,105
-6.219580834604210,34,35,120,325,1,205
-6.221232194774550,34,35,80,200,1,120
-6.221972125699890,34,35,60,200,1,140
-6.224602181591360,34,35,130,275,1,145
-6.226706832558430,34,35,110,325,1,215
-6.229176789363240,54,55,170,175,1,5
-6.229188834735660,34,35,160,250,1,90
-6.229775867712510,34,35,170,225,1,55
-6.232878986894130,34,35,50,200,1,150
-6.233364748072940,34,35,130,325,1,195
-6.235297853178990,34,35,130,300,1,170
-6.236591627420920,34,35,160,200,1,40
-6.238295924668490,34,35,140,325,1,185
-6.246035371509890,6,10,110,125,4,15
-6.247464924126500,34,35,180,275,1,95
-6.251345369970030,34,35,120,300,1,180
-6.2517213039269200,34,35,180,250,1,70
-6.253026300606460,34,35,180,225,1,45
-6.253087007362690,34,35,200,275,1,75
-6.261890377982190,44,45,100,125,1,25
-6.266422870544720,34,35,110,200,1,90
-6.266895593405400,44,45,60,100,1,40
-6.2706609942871700,34,35,130,200,1,70
-6.272166575466830,34,35,50,175,1,125
-6.272939412349540,64,65,120,125,1,5
-6.274549402898980,18,20,70,100,2,30
-6.276552998349780,34,35,100,200,1,100
-6.276581605300380,34,35,190,275,1,85
-6.279397669822610,34,35,120,200,1,80
-6.279699575562670,34,35,90,200,1,110
-6.283938242739640,34,35,60,175,1,115
-6.284850059889460,18,20,100,125,2,25
-6.290107368425400,44,45,190,200,1,10
-6.291425613749380,6,10,80,100,4,20
-6.297189896559700,34,35,70,175,1,105
-6.297566051426510,34,35,140,200,1,60
-6.302738792377890,44,45,70,100,1,30
-6.305282925471150,6,10,90,100,4,10
-6.307256302636020,34,35,80,175,1,95
-6.311497936332270,34,35,110,175,1,65
-6.314928343505800,34,35,170,200,1,30
-6.319044833648010,6,10,140,150,4,10
-6.340108239350710,34,35,50,150,1,100
-6.340400002129560,34,35,190,225,1,35
-6.343997126226020,34,35,190,250,1,60
-6.346897322451400,34,35,90,175,1,85
-6.3540596033174200,34,35,100,175,1,75
-6.3667169182029300,34,35,60,150,1,90
-6.396216006282470,34,35,120,175,1,55
-6.397292364896050,34,35,70,150,1,80
-6.398431639479370,34,35,200,250,1,50
-6.402764743067700,44,45,110,125,1,15
-6.410932245456800,18,20,80,100,2,20
-6.414759471911480,18,20,110,125,2,15
-6.433740326132190,34,35,80,150,1,70
-6.435364938284120,34,35,100,150,1,50
-6.447767978780310,44,45,80,100,1,20
-6.450792851440780,34,35,90,150,1,60
-6.46288088828928,34,35,130,175,1,45
-6.464508695924090,34,35,180,200,1,20
-6.470005581502840,34,35,200,225,1,25
-6.4700099479339000,34,35,140,175,1,35
-6.470418964465120,34,35,50,125,1,75
-6.47407637110449,34,35,110,150,1,40
-6.505283688543120,44,45,140,150,1,10
-6.512959327839960,18,20,90,100,2,10
-6.522348951170310,18,20,140,150,2,10
-6.526171182913640,34,35,60,125,1,65
-6.547882843681510,34,35,150,175,1,25
-6.555101997819930,34,35,120,150,1,30
-6.557455442547440,18,20,170,175,2,5
-6.5799713953254500,34,35,70,125,1,55
-6.585846845341160,34,35,50,100,1,50
-6.590911748819360,44,45,90,100,1,10
-6.600089047935990,54,55,120,125,1,5
-6.601084988609960,44,45,170,175,1,5
-6.609783317044620,34,35,160,175,1,15
-6.6153968319520800,34,35,90,125,1,35
-6.6251426792830400,34,35,130,150,1,20
-6.653964423672610,34,35,80,125,1,45
-6.657273092943940,12,15,120,125,3,5
-6.662586897862490,34,35,190,200,1,10
-6.694020008352550,34,35,60,100,1,40
-6.713566530661010,34,35,70,100,1,30
-6.764233326717380,34,35,100,125,1,25
-6.819859432165550,6,10,120,125,4,5
-6.878135250685810,34,35,80,100,1,20
-6.910850479128180,34,35,110,125,1,15
-6.931817063308140,34,35,140,150,1,10
-6.970002422320060,34,35,90,100,1,10
-7.004368737591930,44,45,120,125,1,5
-7.012865312729890,18,20,120,125,2,5
-7.053145084058050,34,35,170,175,1,5
-7.126315266221640,24,25,200,500,1,300
-7.126341674016270,24,25,190,475,1,285
-7.131093088871690,24,25,200,475,1,275
-7.151456921856250,24,25,50,375,1,325
-7.1523292983603800,24,25,180,500,1,320
-7.162006718609330,24,25,170,350,1,180
-7.162133849694500,24,25,80,250,1,170
-7.163364557135560,24,25,50,350,1,300
-7.163379705234410,24,25,200,450,1,250
-7.166579675645320,24,25,160,500,1,340
-7.167904148203760,24,25,60,325,1,265
-7.168453894705910,24,25,120,450,1,330
-7.169133258005780,24,25,190,500,1,310
-7.169656829441780,24,25,50,425,1,375
-7.1702631737082100,24,25,150,225,1,75
-7.172195018432060,24,25,90,250,1,160
-7.1723841975196100,24,25,50,475,1,425
-7.173645109929010,24,25,90,500,1,410
-7.1762120964929900,24,25,60,425,1,365
-7.178755266424000,24,25,70,225,1,155
-7.179074630303080,24,25,130,225,1,95
-7.1791531946126,24,25,100,500,1,400
-7.180282550007280,24,25,60,375,1,315
-7.1805630006070100,24,25,50,400,1,350
-7.181913711924170,24,25,170,475,1,305
-7.182067200763800,24,25,60,350,1,290
-7.183261530451530,24,25,170,500,1,330
-7.184148481787860,24,25,90,475,1,385
-7.185396269513570,24,25,90,400,1,310
-7.186584079533880,24,25,100,225,1,125
-7.18789271761507,24,25,170,400,1,230
-7.188227714621450,24,25,60,400,1,340
-7.188263940847970,24,25,190,450,1,260
-7.190875034790570,24,25,100,450,1,350
-7.191086519173780,24,25,120,225,1,105
-7.191148915602700,24,25,90,225,1,135
-7.191601084313240,24,25,70,500,1,430
-7.192373284864290,24,25,150,500,1,350
-7.192655180255750,24,25,100,475,1,375
-7.192820389532140,24,25,50,500,1,450
-7.193441160502710,24,25,50,450,1,400
-7.194076924884430,24,25,70,375,1,305
-7.197425343541100,24,25,180,475,1,295
-7.197451413283370,24,25,160,475,1,315
-7.197920533571660,24,25,110,500,1,390
-7.198521238388820,24,25,160,350,1,190
-7.1986295279625500,24,25,50,275,1,225
-7.1991866046981400,24,25,160,300,1,140
-7.199919466326900,24,25,160,325,1,165
-7.200312906918930,24,25,160,400,1,240
-7.200960064902660,24,25,170,325,1,155
-7.202207870463600,24,25,90,450,1,360
-7.203102923058740,24,25,130,400,1,270
-7.204050812880850,24,25,120,500,1,380
-7.204852823826780,24,25,120,250,1,130
-7.205025312513820,24,25,170,425,1,255
-7.206836579497280,24,25,140,500,1,360
-7.207511426448000,24,25,160,425,1,265
-7.207683889668010,24,25,120,425,1,305
-7.207858214997500,24,25,90,300,1,210
-7.208902797097660,24,25,170,375,1,205
-7.209514967272860,24,25,100,425,1,325
-7.209626110356280,24,25,180,450,1,270
-7.212286592231070,24,25,110,450,1,340
-7.212646677550570,24,25,140,250,1,110
-7.213228426416390,24,25,110,475,1,365
-7.21349346680117,24,25,90,350,1,260
-7.213516934117220,24,25,50,225,1,175
-7.2135457789586700,24,25,80,350,1,270
-7.214256419666920,24,25,120,475,1,355
-7.21456080608251,24,25,130,250,1,120
-7.214594983065890,24,25,130,450,1,320
-7.215058611864040,24,25,130,500,1,370
-7.215240284205210,24,25,180,425,1,245
-7.217081597189350,24,25,70,200,1,130
-7.2172126374683500,24,25,60,300,1,240
-7.218304643266350,24,25,70,250,1,180
-7.218742900069220,24,25,200,400,1,200
-7.218866676755180,24,25,70,275,1,205
-7.220195345210220,24,25,180,375,1,195
-7.220372734761490,24,25,70,450,1,380
-7.220389073091250,24,25,140,450,1,310
-7.220930201786580,24,25,100,400,1,300
-7.221910487175460,24,25,150,400,1,250
-7.222693659246580,24,25,80,375,1,295
-7.222940341812510,24,25,150,450,1,300
-7.22299513975132,24,25,140,400,1,260
-7.223202342178910,24,25,130,375,1,245
-7.2233032008106400,24,25,170,300,1,130
-7.2238453294841,24,25,80,275,1,195
-7.224670938809040,24,25,150,425,1,275
-7.225243170469820,24,25,70,475,1,405
-7.225745972696010,24,25,80,475,1,395
-7.226350506815940,24,25,200,425,1,225
-7.226566057300150,24,25,130,425,1,295
-7.229226153188070,24,25,190,425,1,235
-7.229287500621470,24,25,80,500,1,420
-7.22930703077103,24,25,150,475,1,325
-7.229436450100940,24,25,130,475,1,345
-7.229960992371790,24,25,120,400,1,280
-7.231245576671230,24,25,180,400,1,220
-7.231333192369090,24,25,100,250,1,150
-7.231580986286600,24,25,60,225,1,165
-7.23198793219711,24,25,140,425,1,285
-7.232020093876150,24,25,140,225,1,85
-7.232547973680290,24,25,90,275,1,185
-7.233016125290340,24,25,200,300,1,100
-7.233396459865350,24,25,170,450,1,280
-7.2333979588527200,24,25,150,350,1,200
-7.23544380950928,24,25,50,300,1,250
-7.2357742134294600,24,25,80,225,1,145
-7.2359827638090900,24,25,190,350,1,160
-7.2362119100658000,24,25,60,500,1,440
-7.236919561386240,24,25,110,425,1,315
-7.237216454951980,24,25,190,325,1,135
-7.237669634266060,24,25,90,375,1,285
-7.238311723027240,24,25,190,400,1,210
-7.238865517511570,24,25,80,450,1,370
-7.239878123717290,24,25,70,425,1,355
-7.2413618395710700,24,25,70,350,1,280
-7.242084377203780,24,25,150,325,1,175
-7.242735315613330,24,25,140,275,1,135
-7.243349131231260,24,25,140,350,1,210
-7.244326434604680,24,25,160,375,1,215
-7.244337092420380,24,25,80,400,1,320
-7.24727915513758,24,25,190,375,1,185
-7.247327574050220,24,25,200,375,1,175
-7.247912303845800,24,25,180,350,1,170
-7.248152583864040,24,25,70,325,1,255
-7.249121110615490,24,25,110,250,1,140
-7.2508846979805500,24,25,90,325,1,235
-7.251576846831480,24,25,110,275,1,165
-7.252066138933960,24,25,70,400,1,330
-7.254633461272410,24,25,200,325,1,125
-7.255918525477560,24,25,90,425,1,335
-7.256172872619970,24,25,50,325,1,275
-7.256325337637180,24,25,140,375,1,235
-7.256341264803940,24,25,160,275,1,115
-7.258252191775480,24,25,60,450,1,390
-7.258281437808090,24,25,50,250,1,200
-7.258647686745770,24,25,80,425,1,345
-7.259350224189520,24,25,140,475,1,335
-7.260880123868830,24,25,60,275,1,215
-7.261136628620510,24,25,200,350,1,150
-7.26195904061959,24,25,110,225,1,115
-7.261986694027660,24,25,130,350,1,220
-7.262017007511130,24,25,100,275,1,175
-7.262651016887940,24,25,110,375,1,265
-7.2630513969336400,24,25,120,275,1,155
-7.263186742083520,24,25,180,325,1,145
-7.263252986088810,24,25,60,475,1,415
-7.26354734233303,24,25,110,400,1,290
-7.263666157443530,24,25,140,300,1,160
-7.26393769900724,24,25,100,375,1,275
-7.264736496534710,24,25,170,225,1,55
-7.265171564669530,24,25,150,275,1,125
-7.265270599709480,24,25,160,450,1,290
-7.26651123137573,24,25,70,300,1,230
-7.267407950262970,24,25,100,300,1,200
-7.2684196686988900,24,25,60,250,1,190
-7.269978800087520,24,25,150,250,1,100
-7.271122001891320,24,25,180,300,1,120
-7.271380083872890,24,25,100,350,1,250
-7.271918303649620,24,25,110,350,1,240
-7.271968088980010,24,25,120,350,1,230
-7.27218021273946,24,25,150,375,1,225
-7.272618115941270,24,25,150,300,1,150
-7.273462414952170,24,25,80,325,1,245
-7.277158087604680,24,25,190,300,1,110
-7.2778452604560000,24,25,150,200,1,50
-7.277914924855280,24,25,100,325,1,225
-7.27916859218707,24,25,170,250,1,80
-7.283263697028490,24,25,80,300,1,220
-7.283388931231880,24,25,120,375,1,255
-7.28750708696275,24,25,130,300,1,170
-7.293301974046690,24,25,130,325,1,195
-7.293519180824520,24,25,160,225,1,65
-7.294895710343780,24,25,60,200,1,140
-7.2955757762551200,24,25,160,250,1,90
-7.296034239167770,24,25,110,300,1,190
-7.301028720995680,24,25,110,325,1,215
-7.304845767522420,24,25,130,275,1,145
-7.307582770342790,24,25,120,325,1,205
-7.30973554528776,24,25,170,275,1,105
-7.3100762437945500,24,25,180,225,1,45
-7.312053760097720,24,25,140,325,1,185
-7.31352850783378,24,25,50,200,1,150
-7.321548929096040,8,10,70,225,2,155
-7.323395926711070,24,25,180,275,1,95
-7.323931634564230,24,25,160,200,1,40
-7.324203125700680,24,25,120,200,1,80
-7.329527825245030,24,25,120,300,1,180
-7.33454446139093,8,10,50,350,2,300
-7.335022971924050,24,25,110,200,1,90
-7.335887610575570,24,25,80,200,1,120
-7.339339120989230,24,25,200,275,1,75
-7.345938689218910,8,10,50,375,2,325
-7.346096238043980,24,25,180,250,1,70
-7.347030529619260,8,10,130,225,2,95
-7.347174225184040,24,25,130,200,1,70
-7.348829944111170,24,25,60,175,1,115
-7.349253679005050,24,25,100,200,1,100
-7.350247185769370,8,10,200,500,2,300
-7.351379810561590,8,10,150,225,2,75
-7.354865612771040,8,10,50,275,2,225
-7.35864107863065,24,25,170,200,1,30
-7.359932831690720,24,25,70,175,1,105
-7.360820595702550,24,25,50,175,1,125
-7.3616203255450800,8,10,60,325,2,265
-7.364504498600840,24,25,140,200,1,60
-7.368707377318390,8,10,50,400,2,350
-7.370669442334750,24,25,190,275,1,85
-7.372127301416040,24,25,90,200,1,110
-7.375821282285050,8,10,50,425,2,375
-7.376172948886660,8,10,90,225,2,135
-7.3789096605035200,8,10,50,225,2,175
-7.379184816661890,8,10,120,225,2,105
-7.38444009141922,24,25,110,175,1,65
-7.385414362628260,8,10,90,250,2,160
-7.389738730381070,8,10,60,375,2,315
-7.389849882632010,8,10,60,350,2,290
-7.391557315305800,8,10,80,250,2,170
-7.3930821075743400,8,10,200,475,2,275
-7.395465149893780,8,10,190,475,2,285
-7.404226174428340,8,10,190,500,2,310
-7.405929428743040,8,10,60,300,2,240
-7.410135685917690,8,10,50,500,2,450
-7.41491641013546,8,10,50,300,2,250
-7.415788359555430,24,25,80,175,1,95
-7.416369264761100,8,10,170,350,2,180
-7.417775265583840,8,10,50,475,2,425
-7.417901349790970,8,10,140,225,2,85
-7.419007072340880,24,25,190,225,1,35
-7.4196889435273200,8,10,50,450,2,400
-7.4200801263900600,24,25,190,250,1,60
-7.420324156027330,8,10,160,350,2,190
-7.423914308399870,8,10,170,400,2,230
-7.425009688792260,8,10,100,500,2,400
-7.42501549522596,8,10,70,275,2,205
-7.425425603212670,24,25,90,175,1,85
-7.426367216917310,24,25,50,150,1,100
-7.428660634789520,8,10,120,450,2,330
-7.429910588196670,8,10,70,250,2,180
-7.430206114776520,8,10,90,500,2,410
-7.430346597456880,8,10,60,425,2,365
-7.430882694515790,8,10,180,500,2,320
-7.435092356006770,8,10,100,225,2,125
-7.4354643848283700,8,10,50,325,2,275
-7.435826424170350,8,10,60,225,2,165
-7.4379512369065700,8,10,70,375,2,305
-7.439929634838180,8,10,50,250,2,200
-7.441348414907990,8,10,100,450,2,350
-7.441569949333990,8,10,140,275,2,135
-7.442246253455870,8,10,80,275,2,195
-7.442393031018490,8,10,80,225,2,145
-7.4424670821728300,24,25,100,175,1,75
-7.444180705407490,8,10,170,325,2,155
-7.446128957729160,8,10,70,500,2,430
-7.446726333629800,8,10,90,475,2,385
-7.447825864943320,8,10,70,200,2,130
-7.451779540303600,8,10,200,450,2,250
-7.451952147780260,8,10,90,350,2,260
-7.453022211605940,8,10,160,325,2,165
-7.45420495638537,8,10,60,400,2,340
-7.454239509720300,8,10,160,500,2,340
-7.454433684071100,8,10,130,250,2,120
-7.457876188374230,8,10,150,500,2,350
-7.458085093024600,8,10,160,425,2,265
-7.464250957501570,8,10,90,275,2,185
-7.464986956943560,8,10,90,300,2,210
-7.465093679278230,8,10,120,250,2,130
-7.465421333426140,24,25,60,150,1,90
-7.4677951641414800,8,10,170,300,2,130
-7.467824520963290,8,10,90,400,2,310
-7.469417754853720,8,10,140,250,2,110
-7.4703355822975400,24,25,200,250,1,50
-7.47044066911001,8,10,60,250,2,190
-7.470684270987760,8,10,160,300,2,140
-7.472397506663330,8,10,170,475,2,305
-7.473483798479010,8,10,170,500,2,330
-7.473741731704280,8,10,170,375,2,205
-7.4737962931749500,8,10,60,275,2,215
-7.4749566283427500,8,10,190,450,2,260
-7.475020900967210,8,10,200,300,2,100
-7.4763165813844000,8,10,100,475,2,375
-7.47732020928291,8,10,170,425,2,255
-7.479141529054290,8,10,150,200,2,50
-7.479879605457790,8,10,120,500,2,380
-7.48002553514444,8,10,100,275,2,175
-7.481188882260600,8,10,180,475,2,295
-7.482212278601370,8,10,130,400,2,270
-7.482309271294520,8,10,140,500,2,360
-7.483475000270240,8,10,70,350,2,280
-7.483548951690580,8,10,60,500,2,440
-7.48423103354813,8,10,100,250,2,150
-7.484834117409360,8,10,160,200,2,40
-7.486764619064330,24,25,120,175,1,55
-7.486839156201760,8,10,160,400,2,240
-7.487172512562170,8,10,110,250,2,140
-7.487628705959090,8,10,150,350,2,200
-7.489680577697410,24,25,70,150,1,80
-7.490474308896100,8,10,120,400,2,280
-7.490910425136710,8,10,110,500,2,390
-7.491575857074550,8,10,80,350,2,270
-7.492360196042440,8,10,170,225,2,55
-7.493397887980740,8,10,180,400,2,220
-7.494108200713460,8,10,110,225,2,115
-7.496424917978420,8,10,110,425,2,315
-7.496627569404880,8,10,120,425,2,305
-7.4973612095699700,34,35,120,125,1,5
-7.498669042652340,8,10,130,500,2,370
-7.499165643534140,8,10,100,425,2,325
-7.49982063653977,8,10,70,325,2,255
-7.499945430160520,24,25,100,150,1,50
-7.500369548352290,8,10,90,450,2,360
-7.500942081702490,8,10,160,225,2,65
-7.501069657539030,8,10,70,300,2,230
-7.502081656387910,8,10,120,475,2,355
-7.502736569735650,8,10,70,475,2,405
-7.504383507870330,8,10,80,375,2,295
-7.504705662341080,8,10,70,450,2,380
-7.505941955696780,8,10,180,325,2,145
-7.506722340455970,8,10,130,475,2,345
-7.506946828023040,8,10,100,300,2,200
-7.507209757301870,8,10,160,475,2,315
-7.507300700479660,8,10,90,375,2,285
-7.50769503176274,8,10,130,450,2,320
-7.508812760653200,8,10,150,325,2,175
-7.510172297808250,8,10,200,325,2,125
-7.510615606029720,8,10,150,400,2,250
-7.5127355091928300,8,10,180,450,2,270
-7.513870637033100,24,25,80,150,1,70
-7.5141779921124200,8,10,110,475,2,365
-7.514557701713150,8,10,120,275,2,155
-7.51458417792202,8,10,70,425,2,355
-7.514599502701560,8,10,180,425,2,245
-7.514795664645190,8,10,190,325,2,135
-7.5156300870431900,8,10,80,500,2,420
-7.516587890062610,24,25,50,125,1,75
-7.518084453482270,8,10,80,450,2,370
-7.518096168149820,8,10,140,400,2,260
-7.519461479173650,8,10,100,325,2,225
-7.521413571624000,8,10,160,275,2,115
-7.522271858863170,8,10,50,175,2,125
-7.522310157503250,8,10,100,400,2,300
-7.522455484890290,8,10,200,400,2,200
-7.522770087370740,24,25,200,225,1,25
-7.524336627648520,8,10,180,300,2,120
-7.5267538767276,8,10,130,375,2,245
-7.527454495020780,8,10,180,375,2,195
-7.527873432759160,8,10,200,425,2,225
-7.528542561480690,8,10,190,350,2,160
-7.52980476804474,8,10,110,275,2,165
-7.53022774927408,8,10,80,300,2,220
-7.530487240159270,8,10,180,350,2,170
-7.531790322501330,8,10,140,350,2,210
-7.532427617372570,8,10,150,475,2,325
-7.532908079920090,8,10,190,425,2,235
-7.533688950049500,8,10,170,250,2,80
-7.533870566495050,8,10,70,400,2,330
-7.533955774358900,8,10,150,425,2,275
-7.534733707121210,24,25,140,175,1,35
-7.535036844624950,8,10,60,475,2,415
-7.5353197814835100,8,10,140,375,2,235
-7.535634932646440,24,25,180,200,1,20
-7.535972028094530,8,10,190,300,2,110
-7.537044396243000,8,10,80,475,2,395
-7.537605803408880,8,10,110,450,2,340
-7.53783411744344,8,10,120,350,2,230
-7.539176494413150,8,10,50,200,2,150
-7.539415363279160,8,10,140,425,2,285
-7.5397508695367200,8,10,140,475,2,335
-7.541248775837510,8,10,170,200,2,30
-7.541328907866510,8,10,200,350,2,150
-7.543196750509530,8,10,150,450,2,300
-7.543206810339260,8,10,130,425,2,295
-7.543919069431500,8,10,110,300,2,190
-7.5450285938586100,8,10,150,300,2,150
-7.546288541281130,8,10,170,450,2,280
-7.54766736935585,8,10,140,450,2,310
-7.548731021929440,8,10,180,225,2,45
-7.550376585437410,8,10,80,325,2,245
-7.551757084649050,8,10,90,325,2,235
-7.552542230093470,8,10,160,375,2,215
-7.555026582833690,24,25,90,150,1,60
-7.556128318478880,8,10,60,200,2,140
-7.558255519074770,8,10,140,300,2,160
-7.559846584693990,8,10,150,250,2,100
-7.561082739823880,8,10,60,175,2,115
-7.561244351813840,8,10,90,425,2,335
-7.561904005841030,8,10,190,400,2,210
-7.562083636503480,8,10,60,450,2,390
-7.56426679842388,24,25,110,150,1,40
-7.5651246936897000,8,10,110,400,2,290
-7.5657963168950900,8,10,100,375,2,275
-7.565889559386540,8,10,80,425,2,345
-7.566816115998200,8,10,160,250,2,90
-7.567491024827270,8,10,80,400,2,320
-7.5687514591856600,8,10,100,350,2,250
-7.5692848291599200,8,10,160,450,2,290
-7.570584735922290,8,10,110,350,2,240
-7.57330421525041,8,10,130,350,2,220
-7.574425455561500,8,10,110,325,2,215
-7.578807407910930,8,10,110,375,2,265
-7.579529626449250,8,10,190,375,2,185
-7.584815757123970,8,10,150,375,2,225
-7.587018089073440,8,10,120,375,2,255
-7.587127435662930,24,25,130,175,1,45
-7.587167530510710,8,10,200,375,2,175
-7.587654160828000,8,10,80,200,2,120
-7.597629775901020,8,10,130,200,2,70
-7.59820205609797,8,10,150,275,2,125
-7.600262626435300,8,10,100,200,2,100
-7.603788981067910,8,10,130,275,2,145
-7.607920799839240,8,10,110,200,2,90
-7.613789268317070,8,10,70,175,2,105
-7.618278421274040,24,25,60,125,1,65
-7.619826631391950,24,25,70,125,1,55
-7.620028991952780,24,25,120,150,1,30
-7.62144714695229,8,10,130,300,2,170
-7.624491609443290,24,25,150,175,1,25
-7.626755547904840,8,10,140,200,2,60
-7.631970276368810,8,10,180,250,2,70
-7.638444944685390,8,10,130,325,2,195
-7.63875751426682,8,10,90,200,2,110
-7.64102006353956,8,10,170,275,2,105
-7.642403621782560,8,10,180,275,2,95
-7.6433648962008600,8,10,120,200,2,80
-7.646586908674320,8,10,50,150,2,100
-7.648851985319870,8,10,140,325,2,185
-7.650082488542090,8,10,110,175,2,65
-7.652131809593070,8,10,120,325,2,205
-7.657657684452420,8,10,120,300,2,180
-7.666013495704520,8,10,200,275,2,75
-7.672977586428560,24,25,160,175,1,15
-7.680293790285130,24,25,50,100,1,50
-7.682229569972080,24,25,130,150,1,20
-7.690260919117590,8,10,80,175,2,95
-7.692881218158480,8,10,190,275,2,85
-7.693495157222640,8,10,190,225,2,35
-7.701633434855660,24,25,80,125,1,45
-7.709647309676890,24,25,190,200,1,10
-7.715262729629410,24,25,90,125,1,35
-7.720145618585270,8,10,90,175,2,85
-7.7243290157265300,8,10,60,150,2,90
-7.74421522858934,8,10,190,250,2,60
-7.744656976838820,24,25,60,100,1,40
-7.745610846727750,8,10,100,175,2,75
-7.752847673946190,8,10,120,175,2,55
-7.774852274939920,8,10,200,225,2,25
-7.77923830648849,8,10,70,150,2,80
-7.783226816893290,8,10,180,200,2,20
-7.785790799506660,8,10,50,125,2,75
-7.786043560500730,8,10,140,175,2,35
-7.796690846354240,8,10,100,150,2,50
-7.807671562052580,8,10,200,250,2,50
-7.830062163699600,24,25,100,125,1,25
-7.8376502497333500,24,25,70,100,1,30
-7.849850858234610,8,10,120,150,2,30
-7.8571636908913400,8,10,50,100,2,50
-7.8612603879900600,8,10,80,150,2,70
-7.874719439508390,8,10,130,175,2,45
-7.876473041000460,8,10,90,150,2,60
-7.8837178808215400,8,10,110,150,2,40
-7.891045558953430,8,10,150,175,2,25
-7.914587112134170,8,10,160,175,2,15
-7.930829304475370,24,25,110,125,1,15
-7.943558850044040,8,10,130,150,2,20
-7.946965461261240,8,10,190,200,2,10
-7.954486512016690,8,10,60,125,2,65
-7.967730028229980,24,25,80,100,1,20
-7.968591178635690,24,25,140,150,1,10
-7.989573268306280,8,10,70,125,2,55
-8.036448663742180,8,10,80,125,2,45
-8.039570411544660,8,10,90,125,2,35
-8.056188055372210,24,25,90,100,1,10
-8.07639788511869,8,10,60,100,2,40
-8.104503158786900,24,25,170,175,1,5
-8.139781638985280,8,10,70,100,2,30
-8.14480456999594,8,10,100,125,2,25
-8.25306350043677,8,10,110,125,2,15
-8.258038464711020,8,10,80,100,2,20
-8.278063100761060,8,10,170,175,2,5
-8.29539685085558,8,10,140,150,2,10
-8.35551374426807,8,10,90,100,2,10
-8.491299190999340,24,25,120,125,1,5
-8.519866936657420,4,5,50,275,1,225
-8.525828486025280,4,5,70,225,1,155
-8.550556626598150,4,5,50,350,1,300
-8.584157294855890,4,5,50,375,1,325
-8.600278617457240,4,5,50,225,1,175
-8.602225632083040,4,5,150,225,1,75
-8.696186513590880,4,5,170,200,1,30
-8.729841236517570,4,5,50,400,1,350
-8.732820340372130,4,5,130,225,1,95
-8.759401449236540,4,5,60,325,1,265
-8.761378918620260,4,5,90,250,1,160
-8.76521666434068,4,5,80,250,1,170
-8.766578870018260,4,5,120,225,1,105
-8.768440835568380,4,5,160,200,1,40
-8.795364509154330,4,5,50,250,1,200
-8.804540734243210,4,5,60,350,1,290
-8.80621637911632,4,5,150,200,1,50
-8.807037904360230,4,5,50,425,1,375
-8.821481026643080,4,5,60,225,1,165
-8.838765398595420,8,10,120,125,2,5
-8.848155526627460,4,5,70,200,1,130
-8.8513111469589,4,5,60,375,1,315
-8.854500267769260,4,5,60,300,1,240
-8.857872880817700,4,5,140,225,1,85
-8.900745170311310,4,5,50,300,1,250
-8.9027641173194,4,5,70,250,1,180
-8.905536046666770,4,5,90,225,1,135
-8.939932936068340,4,5,50,175,1,125
-8.984376650835240,4,5,170,225,1,55
-8.984414603437820,4,5,50,500,1,450
-8.991236938908940,4,5,60,250,1,190
-8.996515150122820,4,5,50,325,1,275
-9.011136638456230,4,5,50,200,1,150
-9.012838094080030,4,5,200,500,1,300
-9.014869047080620,4,5,160,225,1,65
-9.016167161794820,4,5,60,275,1,215
-9.019668174898540,4,5,80,225,1,145
-9.029629231107270,4,5,50,450,1,400
-9.029703419269920,4,5,50,475,1,425
-9.034678294835510,4,5,100,225,1,125
-9.035322270506220,4,5,70,275,1,205
-9.048387110480550,4,5,90,300,1,210
-9.073843063590820,4,5,180,225,1,45
-9.07975850343664,4,5,80,275,1,195
-9.095606737784840,4,5,60,200,1,140
-9.098553292080540,4,5,60,425,1,365
-9.118105502859240,4,5,200,475,1,275
-9.129616247998920,14,15,200,500,1,300
-9.13716269025135,4,5,130,250,1,120
-9.141127734501170,14,15,50,350,1,300
-9.143426968789350,14,15,50,375,1,325
-9.146222461827780,14,15,120,225,1,105
-9.14987400747831,14,15,190,475,1,285
-9.152760219218120,14,15,100,500,1,400
-9.154640058255290,14,15,80,250,1,170
-9.155026525792470,14,15,190,500,1,310
-9.157392524499040,14,15,130,225,1,95
-9.164370957379230,14,15,50,400,1,350
-9.165774126627630,14,15,70,225,1,155
-9.167831585771100,14,15,200,475,1,275
-9.169150582025670,14,15,180,500,1,320
-9.171400324074120,14,15,60,425,1,365
-9.171798047732460,14,15,60,375,1,315
-9.172918783820860,14,15,160,500,1,340
-9.173074106627590,14,15,50,425,1,375
-9.173715745387550,4,5,60,400,1,340
-9.17520121203403,4,5,160,325,1,165
-9.175799930964640,14,15,200,450,1,250
-9.17707090987605,14,15,90,500,1,410
-9.17772047074446,4,5,170,325,1,155
-9.177985335982890,14,15,60,325,1,265
-9.178312827608680,14,15,150,225,1,75
-9.181951837666160,14,15,160,425,1,265
-9.184118931440680,14,15,50,450,1,400
-9.18454000752547,14,15,170,350,1,180
-9.185001445392700,14,15,90,250,1,160
-9.18516111850902,14,15,120,450,1,330
-9.185806265371140,14,15,90,475,1,385
-9.186647561560570,14,15,160,325,1,165
-9.187141175779900,14,15,60,350,1,290
-9.187356630776680,14,15,100,225,1,125
-9.187895252995180,14,15,140,225,1,85
-9.187946592250360,14,15,170,375,1,205
-9.188868446703750,14,15,100,475,1,375
-9.189120713081010,4,5,190,475,1,285
-9.191467840445620,14,15,160,350,1,190
-9.192564968934890,14,15,50,500,1,450
-9.192645191633380,14,15,170,400,1,230
-9.195690581347450,14,15,170,475,1,305
-9.195749724633770,14,15,90,225,1,135
-9.196541849708420,14,15,60,300,1,240
-9.19661997044143,4,5,60,175,1,115
-9.196849243303380,4,5,70,375,1,305
-9.1969393321484,14,15,50,475,1,425
-9.197734930587490,4,5,90,350,1,260
-9.1989820920523,14,15,50,225,1,175
-9.199121563992370,14,15,50,275,1,225
-9.199283238673120,14,15,160,400,1,240
-9.199558447646330,14,15,100,450,1,350
-9.200060775019460,14,15,190,450,1,260
-9.200136455909870,14,15,200,300,1,100
-9.200769498369420,14,15,70,375,1,305
-9.200771886767670,14,15,170,500,1,330
-9.200968501542980,14,15,70,500,1,430
-9.201217228987850,14,15,70,275,1,205
-9.201420165497150,14,15,180,475,1,295
-9.202320530841390,14,15,170,325,1,155
-9.202805915669960,14,15,150,500,1,350
-9.203925608436190,14,15,120,500,1,380
-9.20431832109211,14,15,110,475,1,365
-9.204760320394130,14,15,60,400,1,340
-9.2056748089698,4,5,190,500,1,310
-9.206647603930760,14,15,170,300,1,130
-9.20753550191137,14,15,130,450,1,320
-9.208463468947660,14,15,90,400,1,310
-9.211258230230870,14,15,70,450,1,380
-9.2125473069807,14,15,140,500,1,360
-9.213694975416080,14,15,140,250,1,110
-9.214513769814650,14,15,180,425,1,245
-9.214773340514330,14,15,130,500,1,370
-9.214945441439060,14,15,130,250,1,120
-9.215513127129800,14,15,160,475,1,315
-9.215750188591520,14,15,90,275,1,185
-9.217551945831400,4,5,90,275,1,185
-9.217595295354570,14,15,170,425,1,255
-9.217779142573200,14,15,150,350,1,200
-9.218454815082740,14,15,90,350,1,260
-9.218740917859970,14,15,130,425,1,295
-9.219306661478480,14,15,100,425,1,325
-9.220242512747160,14,15,110,500,1,390
-9.220688735674350,14,15,80,450,1,370
-9.221801539709060,14,15,160,300,1,140
-9.221956526802480,4,5,170,175,1,5
-9.222159583079620,14,15,140,400,1,260
-9.224564695854720,14,15,140,425,1,285
-9.224751488643000,14,15,120,400,1,280
-9.225118736125160,14,15,180,400,1,220
-9.225278455708550,14,15,190,425,1,235
-9.225801321809900,14,15,70,300,1,230
-9.225862541010410,14,15,120,250,1,130
-9.225884568080380,14,15,180,350,1,170
-9.226064272335760,14,15,70,475,1,405
-9.22653356750775,14,15,70,250,1,180
-9.226766501642050,14,15,90,300,1,210
-9.226802462278340,14,15,80,275,1,195
-9.227261689435860,4,5,140,250,1,110
-9.227651749937850,14,15,150,450,1,300
-9.227829823054850,14,15,80,500,1,420
-9.227863149727600,14,15,80,225,1,145
-9.227874482802580,14,15,70,325,1,255
-9.228148161700820,14,15,180,450,1,270
-9.22823441471598,14,15,180,325,1,145
-9.228427454207290,14,15,120,475,1,355
-9.228598115646360,14,15,110,450,1,340
-9.228868900054660,14,15,60,475,1,415
-9.228905782886830,14,15,60,225,1,165
-9.229061802974090,14,15,90,450,1,360
-9.229332593193450,14,15,50,300,1,250
-9.233185083914630,4,5,180,200,1,20
-9.233259933563810,14,15,200,425,1,225
-9.234050266323470,4,5,70,350,1,280
-9.234157728931400,14,15,130,400,1,270
-9.234609370125380,4,5,120,250,1,130
-9.234780886272300,14,15,150,400,1,250
-9.235438745727980,14,15,100,400,1,300
-9.235991363733520,14,15,70,200,1,130
-9.237512708030370,14,15,60,500,1,440
-9.237865146827370,14,15,190,350,1,160
-9.238105462167360,14,15,50,250,1,200
-9.23854457451182,14,15,90,375,1,285
-9.239034404653600,14,15,180,375,1,195
-9.240182001649390,14,15,130,375,1,245
-9.24055220918806,14,15,200,400,1,200
-9.241203562596950,14,15,100,250,1,150
-9.241215155666110,14,15,140,275,1,135
-9.241359602094720,14,15,70,425,1,355
-9.241829438461260,14,15,60,250,1,190
-9.241927335964870,14,15,120,275,1,155
-9.241947546486860,14,15,50,325,1,275
-9.243035660655340,14,15,180,300,1,120
-9.243820417342090,14,15,80,350,1,270
-9.243977716549970,14,15,120,425,1,305
-9.244260432414990,14,15,190,400,1,210
-9.246113394521740,14,15,100,325,1,225
-9.247781029096520,14,15,150,425,1,275
-9.24779114875888,14,15,150,325,1,175
-9.247875557948730,14,15,170,450,1,280
-9.249328898614740,14,15,110,300,1,190
-9.249666128510640,14,15,130,475,1,345
-9.25005491515006,14,15,200,325,1,125
-9.250232447759870,14,15,70,350,1,280
-9.250329428595850,14,15,80,475,1,395
-9.250462251497800,4,5,100,250,1,150
-9.251197741027550,14,15,140,450,1,310
-9.252365200894680,14,15,90,425,1,335
-9.252511469418490,14,15,110,250,1,140
-9.253743288496300,14,15,150,200,1,50
-9.254105339698030,14,15,140,475,1,335
-9.254542949186450,14,15,150,475,1,325
-9.25503485146253,14,15,80,375,1,295
-9.255639439528850,14,15,110,425,1,315
-9.255888088693240,14,15,100,275,1,175
-9.256216317408570,14,15,160,275,1,115
-9.256282602397400,14,15,160,450,1,290
-9.256736463563150,14,15,160,375,1,215
-9.256785513416420,14,15,60,275,1,215
-9.257428903543580,14,15,140,375,1,235
-9.258046639190180,14,15,100,300,1,200
-9.25835625094998,14,15,190,375,1,185
-9.25886466173125,14,15,190,325,1,135
-9.259768574822120,14,15,200,350,1,150
-9.261489622295690,14,15,60,450,1,390
-9.263472966497150,14,15,190,300,1,110
-9.26361251066151,14,15,80,325,1,245
-9.265282540174930,14,15,160,225,1,65
-9.268315537483320,14,15,70,400,1,330
-9.268624792689720,14,15,150,275,1,125
-9.268700131306580,14,15,150,375,1,225
-9.268920174229860,14,15,110,225,1,115
-9.2691784879574,14,15,110,350,1,240
-9.27021838473973,14,15,140,350,1,210
-9.270595546077750,14,15,140,300,1,160
-9.27202491927396,14,15,100,375,1,275
-9.272521243446980,14,15,110,400,1,290
-9.277289841523600,14,15,110,325,1,215
-9.277428871012370,4,5,70,300,1,230
-9.278616709671860,14,15,200,375,1,175
-9.278732504802210,4,5,120,450,1,330
-9.279161033713020,14,15,120,350,1,230
-9.279694345256130,4,5,180,500,1,320
-9.279919964466870,14,15,150,300,1,150
-9.280102202243410,14,15,80,400,1,320
-9.281066161043200,14,15,80,300,1,220
-9.281636574559840,14,15,170,225,1,55
-9.283313792980950,14,15,110,275,1,165
-9.283430160619780,14,15,100,350,1,250
-9.283474034666950,4,5,80,350,1,270
-9.28364729103062,4,5,70,325,1,255
-9.283724372373830,14,15,90,325,1,235
-9.284648805066930,14,15,80,425,1,345
-9.2847577858124,14,15,50,200,1,150
-9.285692378901170,14,15,130,300,1,170
-9.286284690617290,4,5,170,350,1,180
-9.288606994254880,14,15,170,250,1,80
-9.288703193925770,14,15,120,375,1,255
-9.289026235400310,14,15,130,275,1,145
-9.289830653444860,14,15,150,250,1,100
-9.293986602458480,4,5,140,275,1,135
-9.294716731311160,14,15,130,350,1,220
-9.299624769581170,14,15,160,250,1,90
-9.303486694064340,14,15,110,200,1,90
-9.3058531628043,4,5,100,450,1,350
-9.30859625032115,14,15,80,200,1,120
-9.3134562879636,14,15,160,200,1,40
-9.314752540604080,14,15,170,275,1,105
-9.315494931908710,4,5,90,400,1,310
-9.317220545558490,14,15,110,375,1,265
-9.317603462893300,14,15,120,325,1,205
-9.317978530675890,14,15,180,225,1,45
-9.320901687816310,14,15,120,300,1,180
-9.322660472117010,4,5,160,350,1,190
-9.324305301325570,4,5,90,500,1,410
-9.324741736006580,14,15,60,200,1,140
-9.325765699076040,4,5,110,225,1,115
-9.33071254939957,14,15,50,175,1,125
-9.331318782771890,14,15,140,200,1,60
-9.333001337930300,14,15,130,325,1,195
-9.336357373482420,14,15,180,275,1,95
-9.3369696085417,4,5,50,150,1,100
-9.34205585360643,14,15,170,200,1,30
-9.342627748682310,14,15,140,325,1,185
-9.344136633118980,4,5,170,300,1,130
-9.344818645616980,14,15,90,200,1,110
-9.345273640329360,4,5,160,300,1,140
-9.345358086356360,4,5,170,400,1,230
-9.345963583171440,14,15,200,275,1,75
-9.346149596218640,14,15,60,175,1,115
-9.350206813478300,4,5,100,300,1,200
-9.350274186047750,4,5,100,500,1,400
-9.350478759830340,4,5,200,300,1,100
-9.356298762682940,14,15,180,250,1,70
-9.357704878076890,4,5,110,175,1,65
-9.359705511387380,4,5,90,475,1,385
-9.360345990761470,14,15,130,200,1,70
-9.362855406471950,4,5,160,175,1,15
-9.363591427227210,4,5,170,250,1,80
-9.364093797162290,14,15,100,200,1,100
-9.365316168191550,4,5,110,250,1,140
-9.367694492726550,4,5,70,500,1,430
-9.370766759891500,14,15,50,150,1,100
-9.372065293484280,14,15,110,175,1,65
-9.376360023199390,14,15,70,175,1,105
-9.376407966939140,14,15,190,275,1,85
-9.38154130673739,14,15,90,175,1,85
-9.381861443719740,14,15,120,200,1,80
-9.382039442183110,4,5,160,500,1,340
-9.389067186997430,14,15,80,175,1,95
-9.397189724290160,4,5,70,175,1,105
-9.39850275707679,4,5,200,450,1,250
-9.399983221259080,4,5,160,425,1,265
-9.40079829751627,4,5,100,275,1,175
-9.410674570073070,4,5,100,475,1,375
-9.418429246446920,14,15,190,250,1,60
-9.423742285100340,4,5,80,375,1,295
-9.423751429956240,4,5,150,350,1,200
-9.423929891829610,14,15,100,175,1,75
-9.430510469481010,14,15,60,150,1,90
-9.43093842683345,4,5,100,325,1,225
-9.431300175380270,4,5,70,475,1,405
-9.43303410347499,4,5,90,450,1,360
-9.435079592035440,14,15,190,225,1,35
-9.44251901767534,4,5,140,200,1,60
-9.44639693851922,4,5,160,400,1,240
-9.450339903138310,14,15,80,150,1,70
-9.458499483363980,4,5,170,375,1,205
-9.460521919114420,4,5,90,325,1,235
-9.465152011225070,4,5,80,300,1,220
-9.465366874548310,4,5,90,375,1,285
-9.467229091011980,4,5,60,150,1,90
-9.468973772146030,4,5,170,500,1,330
-9.471492992056690,14,15,200,225,1,25
-9.476125573232960,4,5,70,450,1,380
-9.47627284860943,14,15,120,175,1,55
-9.477228178924790,14,15,70,150,1,80
-9.47772332615369,4,5,120,275,1,155
-9.482959449857790,4,5,110,200,1,90
-9.483528258948190,14,15,200,250,1,50
-9.484011847408390,4,5,130,400,1,270
-9.48503390796324,14,15,90,150,1,60
-9.493144530816020,4,5,190,325,1,135
-9.495984315589070,4,5,180,325,1,145
-9.497622952612300,4,5,50,100,1,50
-9.503645520918250,4,5,70,425,1,355
-9.506653950356350,4,5,200,325,1,125
-9.508029033832040,4,5,190,450,1,260
-9.509223399628950,4,5,180,475,1,295
-9.509569920090310,4,5,170,475,1,305
-9.509664009356980,4,5,100,425,1,325
-9.509812548507900,4,5,60,475,1,415
-9.510630920383990,4,5,120,500,1,380
-9.510943739560410,4,5,130,200,1,70
-9.512462213403160,4,5,80,200,1,120
-9.516258169436770,14,15,110,150,1,40
-9.518345497077800,4,5,120,475,1,355
-9.522675244978410,4,5,110,275,1,165
-9.525112697800340,4,5,190,200,1,10
-9.526445594459270,4,5,150,325,1,175
-9.526623405197360,4,5,60,500,1,440
-9.526697261908910,14,15,50,125,1,75
-9.52899785599167,4,5,190,225,1,35
-9.529324025799520,4,5,160,275,1,115
-9.530398699362400,4,5,110,500,1,390
-9.541407519048870,14,15,130,175,1,45
-9.548162901968870,14,15,100,150,1,50
-9.548177767712770,4,5,150,500,1,350
-9.549345727177020,4,5,110,450,1,340
-9.550091994306860,14,15,140,175,1,35
-9.550694880876780,4,5,80,450,1,370
-9.556043534520840,4,5,160,250,1,90
-9.55742949207516,4,5,120,425,1,305
-9.558364010242370,4,5,180,300,1,120
-9.566501715563950,14,15,180,200,1,20
-9.568212083861430,4,5,110,475,1,365
-9.570381077856480,14,15,120,150,1,30
-9.5738501602642,4,5,120,400,1,280
-9.576170448829160,4,5,170,425,1,255
-9.579340480528850,4,5,120,200,1,80
-9.580853622242280,4,5,130,450,1,320
-9.581233064176100,4,5,80,500,1,420
-9.581391110144160,4,5,150,250,1,100
-9.584000227010160,4,5,150,400,1,250
-9.587677206345880,4,5,80,325,1,245
-9.588396727195330,4,5,70,400,1,330
-9.590824027495200,14,15,50,100,1,50
-9.592827988742990,4,5,140,400,1,260
-9.598824369356650,4,5,130,375,1,245
-9.609569872661480,4,5,150,275,1,125
-9.613690879460500,4,5,180,425,1,245
-9.616379725672480,14,15,150,175,1,25
-9.616590464840900,4,5,100,400,1,300
-9.619136732821480,4,5,150,300,1,150
-9.628646552294460,4,5,140,500,1,360
-9.63047475951037,4,5,140,300,1,160
-9.631919289492260,4,5,130,500,1,370
-9.637097802598600,4,5,200,400,1,200
-9.641579075536710,4,5,60,450,1,390
-9.644384850976670,4,5,200,225,1,25
-9.646947482553940,4,5,160,475,1,315
-9.647895686267700,4,5,190,350,1,160
-9.64882493855423,14,15,60,125,1,65
-9.650356762186890,4,5,50,125,1,75
-9.65227658893457,4,5,110,300,1,190
-9.65456478151927,14,15,70,125,1,55
-9.657536958823300,4,5,180,400,1,220
-9.658054122355780,14,15,160,175,1,15
-9.663717584682490,4,5,180,350,1,170
-9.6697106463893,4,5,130,425,1,295
-9.67189049699809,4,5,190,425,1,235
-9.67683939526475,4,5,80,425,1,345
-9.678452985005550,14,15,190,200,1,10
-9.678688291381910,4,5,180,450,1,270
-9.681701058222610,4,5,130,475,1,345
-9.681886707482880,4,5,100,200,1,100
-9.685756973327640,4,5,80,475,1,395
-9.686375981183880,4,5,80,400,1,320
-9.690151877230260,14,15,90,125,1,35
-9.69080020761115,4,5,170,450,1,280
-9.69104234060562,4,5,100,375,1,275
-9.691401780244530,4,5,120,150,1,30
-9.69420269829485,14,15,130,150,1,20
-9.696216241221580,4,5,100,350,1,250
-9.702754916560470,4,5,90,425,1,335
-9.703033251122030,4,5,160,375,1,215
-9.703416881771480,4,5,190,300,1,110
-9.706263271118710,4,5,200,425,1,225
-9.706631657523110,14,15,80,125,1,45
-9.714797651636840,4,5,180,375,1,195
-9.716400346134660,4,5,130,275,1,145
-9.716992777231330,14,15,60,100,1,40
-9.71779431446766,4,5,140,425,1,285
-9.71949862522372,4,5,140,450,1,310
-9.727306661259960,4,5,110,425,1,315
-9.729108126762680,4,5,110,325,1,215
-9.737657089880830,4,5,150,425,1,275
-9.740912407811550,4,5,130,350,1,220
-9.741048720135980,4,5,150,450,1,300
-9.741426263497470,4,5,140,350,1,210
-9.745179095281080,4,5,110,350,1,240
-9.74820950942718,4,5,110,400,1,290
-9.753540565088640,4,5,80,175,1,95
-9.756920137783460,4,5,130,150,1,20
-9.757235535868470,4,5,120,350,1,230
-9.764449822577500,4,5,200,350,1,150
-9.767965107810980,4,5,140,375,1,235
-9.768323453827610,4,5,180,250,1,70
-9.78032158421026,4,5,150,475,1,325
-9.783472073729980,4,5,100,150,1,50
-9.783553755580420,14,15,100,125,1,25
-9.78441140674223,4,5,190,400,1,210
-9.789681925507770,4,5,90,200,1,110
-9.79380654011381,4,5,90,175,1,85
-9.822561439446090,14,15,70,100,1,30
-9.846298939708940,4,5,140,175,1,35
-9.861260328825330,14,15,110,125,1,15
-9.870848592093480,4,5,140,475,1,335
-9.871132950788270,4,5,190,375,1,185
-9.871445559622740,4,5,110,375,1,265
-9.872083166907660,4,5,130,300,1,170
-9.87868498029848,4,5,100,175,1,75
-9.883679014972620,4,5,70,150,1,80
-9.887757155333410,4,5,110,150,1,40
-9.889590316306440,4,5,170,275,1,105
-9.894016519567450,4,5,160,450,1,290
-9.899484979185610,4,5,200,275,1,75
-9.901333519911600,4,5,120,375,1,255
-9.906484863580530,4,5,200,375,1,175
-9.911021153101100,4,5,180,275,1,95
-9.917844189910860,4,5,120,175,1,55
-9.924745674789320,4,5,150,175,1,25
-9.936440002891520,14,15,80,100,1,20
-9.945512959064760,14,15,90,100,1,10
-9.947049574177540,4,5,120,300,1,180
-9.963994263164980,4,5,130,325,1,195
-9.984160939765700,4,5,150,375,1,225
-9.9891680801177,4,5,120,325,1,205
-10.000481190561400,14,15,140,150,1,10
-10.010210119274000,4,5,140,325,1,185
-10.081916173129200,14,15,170,175,1,5
-10.097958428497900,4,5,190,275,1,85
-10.098858097643100,4,5,60,100,1,40
-10.108948083130500,4,5,90,150,1,60
-10.124088836449600,4,5,190,250,1,60
-10.151241759342100,4,5,80,150,1,70
-10.228515511440800,4,5,90,100,1,10
-10.274319628623700,4,5,130,175,1,45
-10.289691037848200,4,5,60,125,1,65
-10.300681721614700,4,5,70,125,1,55
-10.308804850284200,4,5,90,125,1,35
-10.311502493383600,4,5,200,250,1,50
-10.383249683423500,4,5,110,125,1,15
-10.413900692506200,4,5,70,100,1,30
-10.445270205959600,14,15,120,125,1,5
-10.511910739827700,4,5,140,150,1,10
-10.534717020077000,4,5,100,125,1,25
-10.572888131223800,4,5,80,125,1,45
-10.850373327075900,4,5,80,100,1,20
-11.06278676367920,4,5,120,125,1,5